Header1,Header2,By,Region,Village,(1) 宋楚瑜 余湘,(2) 韓國瑜 張善政,(3) 蔡英文 賴清德,有效票數A A=1+2+...+N,無效票數B,投票數C C=A+B,已領未投票數 D D=E-C,發出票數E E=C+D,用餘票數F,選舉人數G G=E+F,投票率H H=C÷G
第15任總統副總統,在苗栗縣各村(里),苗栗縣,　苗栗市,中苗里,37,467,304,808,16,824,0,824,260,1084,76.0148
第15任總統副總統,在苗栗縣各村(里),苗栗縣,　苗栗市,青苗里,35,416,275,726,7,733,0,733,263,996,73.5944
第15任總統副總統,在苗栗縣各村(里),苗栗縣,　苗栗市,維祥里,108,1424,840,2372,18,2390,0,2390,832,3222,74.1775
第15任總統副總統,在苗栗縣各村(里),苗栗縣,　苗栗市,維新里,125,1557,968,2650,22,2672,0,2672,890,3562,75.0140
第15任總統副總統,在苗栗縣各村(里),苗栗縣,　苗栗市,玉清里,72,985,581,1638,16,1654,0,1654,509,2163,76.4679
第15任總統副總統,在苗栗縣各村(里),苗栗縣,　苗栗市,玉華里,130,1621,928,2679,30,2709,0,2709,845,3554,76.2240
第15任總統副總統,在苗栗縣各村(里),苗栗縣,　苗栗市,綠苗里,23,363,234,620,8,628,0,628,201,829,75.7539
第15任總統副總統,在苗栗縣各村(里),苗栗縣,　苗栗市,高苗里,94,1275,859,2228,21,2249,0,2249,857,3106,72.4082
第15任總統副總統,在苗栗縣各村(里),苗栗縣,　苗栗市,新苗里,43,335,264,642,4,646,0,646,206,852,75.8216
第15任總統副總統,在苗栗縣各村(里),苗栗縣,　苗栗市,玉苗里,21,352,268,641,5,646,0,646,225,871,74.1676
第15任總統副總統,在苗栗縣各村(里),苗栗縣,　苗栗市,大同里,20,217,143,380,7,387,0,387,122,509,76.0314
第15任總統副總統,在苗栗縣各村(里),苗栗縣,　苗栗市,恭敬里,43,549,404,996,13,1009,0,1009,317,1326,76.0935
第15任總統副總統,在苗栗縣各村(里),苗栗縣,　苗栗市,水源里,68,1010,700,1778,18,1796,0,1796,619,2415,74.3685
第15任總統副總統,在苗栗縣各村(里),苗栗縣,　苗栗市,勝利里,109,1597,1159,2865,18,2883,0,2883,924,3807,75.7289
第15任總統副總統,在苗栗縣各村(里),苗栗縣,　苗栗市,清華里,100,1275,918,2293,26,2319,0,2319,741,3060,75.7843
第15任總統副總統,在苗栗縣各村(里),苗栗縣,　苗栗市,上苗里,50,606,494,1150,10,1160,0,1160,369,1529,75.8666
第15任總統副總統,在苗栗縣各村(里),苗栗縣,　苗栗市,北苗里,154,2082,1444,3680,47,3727,0,3727,1211,4938,75.4759
第15任總統副總統,在苗栗縣各村(里),苗栗縣,　苗栗市,嘉盛里,130,1419,930,2479,31,2510,0,2510,859,3369,74.5028
第15任總統副總統,在苗栗縣各村(里),苗栗縣,　苗栗市,福星里,126,1624,1168,2918,35,2953,0,2953,1071,4024,73.3847
第15任總統副總統,在苗栗縣各村(里),苗栗縣,　苗栗市,福安里,107,1327,974,2408,29,2437,1,2438,866,3304,73.7591
第15任總統副總統,在苗栗縣各村(里),苗栗縣,　苗栗市,嘉新里,87,1241,807,2135,17,2152,0,2152,634,2786,77.2434
第15任總統副總統,在苗栗縣各村(里),苗栗縣,　苗栗市,建功里,137,1737,1132,3006,35,3041,0,3041,924,3965,76.6961
第15任總統副總統,在苗栗縣各村(里),苗栗縣,　苗栗市,福麗里,177,2153,1391,3721,39,3760,0,3760,1430,5190,72.4470
第15任總統副總統,在苗栗縣各村(里),苗栗縣,　苗栗市,文山里,127,1519,1088,2734,20,2754,0,2754,851,3605,76.3939
第15任總統副總統,在苗栗縣各村(里),苗栗縣,　苗栗市,文聖里,119,1385,991,2495,23,2518,0,2518,887,3405,73.9501
第15任總統副總統,在苗栗縣各村(里),苗栗縣,　苗栗市,新川里,25,420,331,776,9,785,0,785,345,1130,69.4690
第15任總統副總統,在苗栗縣各村(里),苗栗縣,　苗栗市,南勢里,53,750,531,1334,14,1348,0,1348,564,1912,70.5021
第15任總統副總統,在苗栗縣各村(里),苗栗縣,　苗栗市,新英里,46,629,443,1118,14,1132,0,1132,479,1611,70.2669
第15任總統副總統,在苗栗縣各村(里),苗栗縣,　苑裡鎮,苑東里,60,575,935,1570,15,1585,0,1585,497,2082,76.1287
第15任總統副總統,在苗栗縣各村(里),苗栗縣,　苑裡鎮,苑南里,53,399,610,1062,9,1071,0,1071,389,1460,73.3562
第15任總統副總統,在苗栗縣各村(里),苗栗縣,　苑裡鎮,苑北里,26,220,405,651,1,652,1,653,212,865,75.3757
第15任總統副總統,在苗栗縣各村(里),苗栗縣,　苑裡鎮,西平里,45,349,727,1121,14,1135,0,1135,378,1513,75.0165
第15任總統副總統,在苗栗縣各村(里),苗栗縣,　苑裡鎮,苑港里,43,204,629,876,7,883,0,883,301,1184,74.5777
第15任總統副總統,在苗栗縣各村(里),苗栗縣,　苑裡鎮,西勢里,57,479,903,1439,18,1457,0,1457,470,1927,75.6098
第15任總統副總統,在苗栗縣各村(里),苗栗縣,　苑裡鎮,海岸里,26,205,447,678,14,692,0,692,326,1018,67.9764
第15任總統副總統,在苗栗縣各村(里),苗栗縣,　苑裡鎮,房裡里,61,515,1008,1584,12,1596,0,1596,582,2178,73.2782
第15任總統副總統,在苗栗縣各村(里),苗栗縣,　苑裡鎮,客庄里,135,1029,1650,2814,36,2850,0,2850,913,3763,75.7374
第15任總統副總統,在苗栗縣各村(里),苗栗縣,　苑裡鎮,中正里,60,534,954,1548,14,1562,0,1562,535,2097,74.4874
第15任總統副總統,在苗栗縣各村(里),苗栗縣,　苑裡鎮,苑坑里,18,166,415,599,8,607,0,607,275,882,68.8209
第15任總統副總統,在苗栗縣各村(里),苗栗縣,　苑裡鎮,水坡里,19,145,305,469,2,471,0,471,153,624,75.4808
第15任總統副總統,在苗栗縣各村(里),苗栗縣,　苑裡鎮,新復里,51,344,568,963,10,973,0,973,341,1314,74.0487
第15任總統副總統,在苗栗縣各村(里),苗栗縣,　苑裡鎮,山脚里,43,355,607,1005,9,1014,0,1014,356,1370,74.0146
第15任總統副總統,在苗栗縣各村(里),苗栗縣,　苑裡鎮,舊社里,78,461,723,1262,14,1276,0,1276,467,1743,73.2071
第15任總統副總統,在苗栗縣各村(里),苗栗縣,　苑裡鎮,福田里,41,293,543,877,16,893,0,893,337,1230,72.6016
第15任總統副總統,在苗栗縣各村(里),苗栗縣,　苑裡鎮,石鎮里,11,145,226,382,3,385,0,385,135,520,74.0385
第15任總統副總統,在苗栗縣各村(里),苗栗縣,　苑裡鎮,蕉埔里,32,252,284,568,8,576,0,576,177,753,76.4940
第15任總統副總統,在苗栗縣各村(里),苗栗縣,　苑裡鎮,南勢里,21,150,291,462,7,469,0,469,204,673,69.6880
第15任總統副總統,在苗栗縣各村(里),苗栗縣,　苑裡鎮,泰田里,48,345,771,1164,19,1183,0,1183,409,1592,74.3090
第15任總統副總統,在苗栗縣各村(里),苗栗縣,　苑裡鎮,上舘里,54,433,619,1106,29,1135,0,1135,465,1600,70.9375
第15任總統副總統,在苗栗縣各村(里),苗栗縣,　苑裡鎮,玉田里,56,411,742,1209,17,1226,0,1226,490,1716,71.4452
第15任總統副總統,在苗栗縣各村(里),苗栗縣,　苑裡鎮,社苓里,59,560,1035,1654,18,1672,0,1672,579,2251,74.2781
第15任總統副總統,在苗栗縣各村(里),苗栗縣,　苑裡鎮,山柑里,59,335,549,943,17,960,0,960,404,1364,70.3812
第15任總統副總統,在苗栗縣各村(里),苗栗縣,　苑裡鎮,田心里,75,445,812,1332,17,1349,0,1349,443,1792,75.2790
第15任總統副總統,在苗栗縣各村(里),苗栗縣,　通霄鎮,通東里,31,319,439,789,5,794,0,794,304,1098,72.3133
第15任總統副總統,在苗栗縣各村(里),苗栗縣,　通霄鎮,通西里,56,602,764,1422,15,1437,0,1437,436,1873,76.7218
第15任總統副總統,在苗栗縣各村(里),苗栗縣,　通霄鎮,平元里,50,504,837,1391,12,1403,0,1403,380,1783,78.6876
第15任總統副總統,在苗栗縣各村(里),苗栗縣,　通霄鎮,平安里,70,503,812,1385,21,1406,0,1406,554,1960,71.7347
第15任總統副總統,在苗栗縣各村(里),苗栗縣,　通霄鎮,圳頭里,25,205,255,485,6,491,0,491,171,662,74.1692
第15任總統副總統,在苗栗縣各村(里),苗栗縣,　通霄鎮,梅南里,48,370,677,1095,14,1109,0,1109,394,1503,73.7858
第15任總統副總統,在苗栗縣各村(里),苗栗縣,　通霄鎮,通南里,75,721,1032,1828,19,1847,0,1847,780,2627,70.3083
第15任總統副總統,在苗栗縣各村(里),苗栗縣,　通霄鎮,內湖里,40,492,695,1227,17,1244,0,1244,531,1775,70.0845
第15任總統副總統,在苗栗縣各村(里),苗栗縣,　通霄鎮,楓樹里,18,131,127,276,10,286,0,286,152,438,65.2968
第15任總統副總統,在苗栗縣各村(里),苗栗縣,　通霄鎮,烏眉里,26,324,242,592,8,600,0,600,255,855,70.1754
第15任總統副總統,在苗栗縣各村(里),苗栗縣,　通霄鎮,福龍里,9,156,89,254,1,255,0,255,136,391,65.2174
第15任總統副總統,在苗栗縣各村(里),苗栗縣,　通霄鎮,福源里,30,212,263,505,6,511,0,511,242,753,67.8619
第15任總統副總統,在苗栗縣各村(里),苗栗縣,　通霄鎮,城北里,30,189,264,483,12,495,0,495,153,648,76.3889
第15任總統副總統,在苗栗縣各村(里),苗栗縣,　通霄鎮,城南里,21,228,370,619,2,621,0,621,281,902,68.8470
第15任總統副總統,在苗栗縣各村(里),苗栗縣,　通霄鎮,南和里,20,219,309,548,3,551,0,551,211,762,72.3097
第15任總統副總統,在苗栗縣各村(里),苗栗縣,　通霄鎮,福興里,21,190,223,434,3,437,0,437,201,638,68.4953
第15任總統副總統,在苗栗縣各村(里),苗栗縣,　通霄鎮,坪頂里,45,358,428,831,7,838,0,838,333,1171,71.5628
第15任總統副總統,在苗栗縣各村(里),苗栗縣,　通霄鎮,五南里,40,400,475,915,10,925,0,925,318,1243,74.4167
第15任總統副總統,在苗栗縣各村(里),苗栗縣,　通霄鎮,五北里,54,321,622,997,10,1007,0,1007,373,1380,72.9710
第15任總統副總統,在苗栗縣各村(里),苗栗縣,　通霄鎮,通灣里,72,579,804,1455,20,1475,0,1475,701,2176,67.7849
第15任總統副總統,在苗栗縣各村(里),苗栗縣,　通霄鎮,新埔里,29,190,516,735,10,745,0,745,339,1084,68.7269
第15任總統副總統,在苗栗縣各村(里),苗栗縣,　通霄鎮,內島里,19,179,320,518,4,522,0,522,209,731,71.4090
第15任總統副總統,在苗栗縣各村(里),苗栗縣,　通霄鎮,白東里,39,379,543,961,15,976,0,976,389,1365,71.5018
第15任總統副總統,在苗栗縣各村(里),苗栗縣,　通霄鎮,白西里,25,181,289,495,9,504,0,504,200,704,71.5909
第15任總統副總統,在苗栗縣各村(里),苗栗縣,　竹南鎮,竹南里,52,670,729,1451,11,1462,0,1462,398,1860,78.6022
第15任總統副總統,在苗栗縣各村(里),苗栗縣,　竹南鎮,照南里,129,1025,1337,2491,42,2533,0,2533,686,3219,78.6890
第15任總統副總統,在苗栗縣各村(里),苗栗縣,　竹南鎮,正南里,84,766,1002,1852,15,1867,0,1867,802,2669,69.9513
第15任總統副總統,在苗栗縣各村(里),苗栗縣,　竹南鎮,新南里,190,1468,1751,3409,40,3449,0,3449,1048,4497,76.6956
第15任總統副總統,在苗栗縣各村(里),苗栗縣,　竹南鎮,大厝里,232,1719,1955,3906,37,3943,0,3943,1140,5083,77.5723
第15任總統副總統,在苗栗縣各村(里),苗栗縣,　竹南鎮,營盤里,150,1016,1392,2558,32,2590,0,2590,782,3372,76.8090
第15任總統副總統,在苗栗縣各村(里),苗栗縣,　竹南鎮,聖福里,125,1145,1217,2487,29,2516,0,2516,744,3260,77.1779
第15任總統副總統,在苗栗縣各村(里),苗栗縣,　竹南鎮,竹興里,112,930,1150,2192,25,2217,0,2217,898,3115,71.1717
第15任總統副總統,在苗栗縣各村(里),苗栗縣,　竹南鎮,龍山里,116,700,875,1691,18,1709,0,1709,477,2186,78.1793
第15任總統副總統,在苗栗縣各村(里),苗栗縣,　竹南鎮,天文里,92,718,754,1564,13,1577,0,1577,496,2073,76.0733
第15任總統副總統,在苗栗縣各村(里),苗栗縣,　竹南鎮,龍鳳里,80,676,737,1493,13,1506,0,1506,531,2037,73.9323
第15任總統副總統,在苗栗縣各村(里),苗栗縣,　竹南鎮,山佳里,212,1464,1535,3211,35,3246,0,3246,1304,4550,71.3407
第15任總統副總統,在苗栗縣各村(里),苗栗縣,　竹南鎮,佳興里,133,981,1190,2304,23,2327,0,2327,768,3095,75.1858
第15任總統副總統,在苗栗縣各村(里),苗栗縣,　竹南鎮,中港里,32,350,396,778,10,788,0,788,241,1029,76.5792
第15任總統副總統,在苗栗縣各村(里),苗栗縣,　竹南鎮,中華里,110,877,1083,2070,15,2085,0,2085,646,2731,76.3457
第15任總統副總統,在苗栗縣各村(里),苗栗縣,　竹南鎮,中英里,74,485,526,1085,6,1091,0,1091,352,1443,75.6064
第15任總統副總統,在苗栗縣各村(里),苗栗縣,　竹南鎮,中美里,73,608,713,1394,18,1412,0,1412,489,1901,74.2767
第15任總統副總統,在苗栗縣各村(里),苗栗縣,　竹南鎮,開元里,47,309,417,773,8,781,0,781,272,1053,74.1690
第15任總統副總統,在苗栗縣各村(里),苗栗縣,　竹南鎮,海口里,166,1083,1517,2766,24,2790,0,2790,1047,3837,72.7131
第15任總統副總統,在苗栗縣各村(里),苗栗縣,　竹南鎮,港墘里,84,674,833,1591,32,1623,0,1623,467,2090,77.6555
第15任總統副總統,在苗栗縣各村(里),苗栗縣,　竹南鎮,公舘里,38,415,352,805,3,808,0,808,324,1132,71.3781
第15任總統副總統,在苗栗縣各村(里),苗栗縣,　竹南鎮,大埔里,168,1228,1554,2950,29,2979,0,2979,1212,4191,71.0809
第15任總統副總統,在苗栗縣各村(里),苗栗縣,　竹南鎮,頂埔里,62,655,822,1539,17,1556,0,1556,513,2069,75.2054
第15任總統副總統,在苗栗縣各村(里),苗栗縣,　竹南鎮,崎頂里,122,1142,1366,2630,27,2657,0,2657,974,3631,73.1754
第15任總統副總統,在苗栗縣各村(里),苗栗縣,　竹南鎮,公義里,35,291,436,762,10,772,0,772,229,1001,77.1229
第15任總統副總統,在苗栗縣各村(里),苗栗縣,　頭份市,流東里,83,823,565,1471,28,1499,0,1499,638,2137,70.1451
第15任總統副總統,在苗栗縣各村(里),苗栗縣,　頭份市,珊湖里,55,715,460,1230,13,1243,0,1243,464,1707,72.8178
第15任總統副總統,在苗栗縣各村(里),苗栗縣,　頭份市,斗煥里,124,1172,752,2048,23,2071,0,2071,805,2876,72.0097
第15任總統副總統,在苗栗縣各村(里),苗栗縣,　頭份市,新華里,141,1518,940,2599,22,2621,0,2621,961,3582,73.1714
第15任總統副總統,在苗栗縣各村(里),苗栗縣,　頭份市,興隆里,159,1663,1319,3141,28,3169,1,3170,1083,4253,74.5121
第15任總統副總統,在苗栗縣各村(里),苗栗縣,　頭份市,上埔里,81,1073,653,1807,24,1831,0,1831,696,2527,72.4575
第15任總統副總統,在苗栗縣各村(里),苗栗縣,　頭份市,土牛里,39,345,319,703,8,711,0,711,239,950,74.8421
第15任總統副總統,在苗栗縣各村(里),苗栗縣,　頭份市,頭份里,134,1254,956,2344,26,2370,0,2370,827,3197,74.1320
第15任總統副總統,在苗栗縣各村(里),苗栗縣,　頭份市,忠孝里,120,1246,886,2252,21,2273,0,2273,693,2966,76.6352
第15任總統副總統,在苗栗縣各村(里),苗栗縣,　頭份市,自強里,72,721,582,1375,14,1389,0,1389,555,1944,71.4506
第15任總統副總統,在苗栗縣各村(里),苗栗縣,　頭份市,信義里,16,286,218,520,11,531,0,531,394,925,57.4054
第15任總統副總統,在苗栗縣各村(里),苗栗縣,　頭份市,仁愛里,51,597,454,1102,14,1116,0,1116,385,1501,74.3504
第15任總統副總統,在苗栗縣各村(里),苗栗縣,　頭份市,上興里,75,731,557,1363,16,1379,0,1379,659,2038,67.6644
第15任總統副總統,在苗栗縣各村(里),苗栗縣,　頭份市,下興里,85,956,738,1779,9,1788,0,1788,632,2420,73.8843
第15任總統副總統,在苗栗縣各村(里),苗栗縣,　頭份市,和平里,32,415,347,794,7,801,0,801,209,1010,79.3069
第15任總統副總統,在苗栗縣各村(里),苗栗縣,　頭份市,山下里,158,1468,1207,2833,26,2859,0,2859,920,3779,75.6549
第15任總統副總統,在苗栗縣各村(里),苗栗縣,　頭份市,後庄里,187,1385,1385,2957,33,2990,0,2990,907,3897,76.7257
第15任總統副總統,在苗栗縣各村(里),苗栗縣,　頭份市,合興里,104,907,796,1807,15,1822,0,1822,593,2415,75.4451
第15任總統副總統,在苗栗縣各村(里),苗栗縣,　頭份市,文化里,141,1212,1166,2519,26,2545,0,2545,765,3310,76.8882
第15任總統副總統,在苗栗縣各村(里),苗栗縣,　頭份市,中興里,103,948,841,1892,25,1917,0,1917,695,2612,73.3920
第15任總統副總統,在苗栗縣各村(里),苗栗縣,　頭份市,蟠桃里,130,1084,1027,2241,20,2261,0,2261,836,3097,73.0061
第15任總統副總統,在苗栗縣各村(里),苗栗縣,　頭份市,建國里,124,1312,1084,2520,13,2533,0,2533,807,3340,75.8383
第15任總統副總統,在苗栗縣各村(里),苗栗縣,　頭份市,成功里,141,1398,1037,2576,24,2600,0,2600,830,3430,75.8017
第15任總統副總統,在苗栗縣各村(里),苗栗縣,　頭份市,民族里,66,812,570,1448,19,1467,0,1467,480,1947,75.3467
第15任總統副總統,在苗栗縣各村(里),苗栗縣,　頭份市,民權里,75,783,682,1540,19,1559,0,1559,508,2067,75.4233
第15任總統副總統,在苗栗縣各村(里),苗栗縣,　頭份市,東庄里,126,1504,1161,2791,23,2814,0,2814,990,3804,73.9748
第15任總統副總統,在苗栗縣各村(里),苗栗縣,　頭份市,田寮里,137,1484,1241,2862,26,2888,0,2888,987,3875,74.5290
第15任總統副總統,在苗栗縣各村(里),苗栗縣,　頭份市,民生里,102,883,655,1640,20,1660,0,1660,610,2270,73.1278
第15任總統副總統,在苗栗縣各村(里),苗栗縣,　頭份市,蘆竹里,46,473,438,957,7,964,0,964,325,1289,74.7867
第15任總統副總統,在苗栗縣各村(里),苗栗縣,　頭份市,尖山里,43,537,380,960,14,974,0,974,348,1322,73.6762
第15任總統副總統,在苗栗縣各村(里),苗栗縣,　頭份市,廣興里,27,429,204,660,3,663,0,663,205,868,76.3825
第15任總統副總統,在苗栗縣各村(里),苗栗縣,　頭份市,尖下里,77,1059,641,1777,27,1804,0,1804,672,2476,72.8595
第15任總統副總統,在苗栗縣各村(里),苗栗縣,　頭份市,濫坑里,72,923,550,1545,12,1557,0,1557,581,2138,72.8251
第15任總統副總統,在苗栗縣各村(里),苗栗縣,　後龍鎮,南龍里,39,453,482,974,8,982,0,982,388,1370,71.6788
第15任總統副總統,在苗栗縣各村(里),苗栗縣,　後龍鎮,中龍里,23,227,310,560,3,563,0,563,167,730,77.1233
第15任總統副總統,在苗栗縣各村(里),苗栗縣,　後龍鎮,北龍里,39,378,530,947,9,956,0,956,314,1270,75.2756
第15任總統副總統,在苗栗縣各村(里),苗栗縣,　後龍鎮,大庄里,135,1235,1521,2891,32,2923,0,2923,1104,4027,72.5851
第15任總統副總統,在苗栗縣各村(里),苗栗縣,　後龍鎮,東明里,52,383,524,959,17,976,0,976,448,1424,68.5393
第15任總統副總統,在苗栗縣各村(里),苗栗縣,　後龍鎮,灣寶里,25,320,509,854,12,866,0,866,346,1212,71.4521
第15任總統副總統,在苗栗縣各村(里),苗栗縣,　後龍鎮,海寶里,30,244,379,653,8,661,0,661,277,938,70.4691
第15任總統副總統,在苗栗縣各村(里),苗栗縣,　後龍鎮,豐富里,30,535,335,900,7,907,0,907,277,1184,76.6047
第15任總統副總統,在苗栗縣各村(里),苗栗縣,　後龍鎮,校椅里,24,406,277,707,8,715,0,715,255,970,73.7113
第15任總統副總統,在苗栗縣各村(里),苗栗縣,　後龍鎮,埔頂里,82,826,930,1838,29,1867,0,1867,729,2596,71.9183
第15任總統副總統,在苗栗縣各村(里),苗栗縣,　後龍鎮,新民里,38,453,451,942,13,955,0,955,345,1300,73.4615
第15任總統副總統,在苗栗縣各村(里),苗栗縣,　後龍鎮,復興里,21,222,242,485,7,492,0,492,179,671,73.3234
第15任總統副總統,在苗栗縣各村(里),苗栗縣,　後龍鎮,大山里,35,403,579,1017,12,1029,0,1029,486,1515,67.9208
第15任總統副總統,在苗栗縣各村(里),苗栗縣,　後龍鎮,溪洲里,61,715,765,1541,28,1569,0,1569,643,2212,70.9313
第15任總統副總統,在苗栗縣各村(里),苗栗縣,　後龍鎮,外埔里,21,355,290,666,9,675,0,675,334,1009,66.8979
第15任總統副總統,在苗栗縣各村(里),苗栗縣,　後龍鎮,海埔里,31,232,299,562,11,573,0,573,318,891,64.3098
第15任總統副總統,在苗栗縣各村(里),苗栗縣,　後龍鎮,秀水里,18,208,277,503,6,509,0,509,174,683,74.5242
第15任總統副總統,在苗栗縣各村(里),苗栗縣,　後龍鎮,水尾里,22,301,376,699,8,707,0,707,293,1000,70.7000
第15任總統副總統,在苗栗縣各村(里),苗栗縣,　後龍鎮,龍津里,15,183,210,408,4,412,0,412,172,584,70.5479
第15任總統副總統,在苗栗縣各村(里),苗栗縣,　後龍鎮,龍坑里,33,292,488,813,13,826,0,826,405,1231,67.0999
第15任總統副總統,在苗栗縣各村(里),苗栗縣,　後龍鎮,福寧里,21,208,256,485,6,491,0,491,229,720,68.1944
第15任總統副總統,在苗栗縣各村(里),苗栗縣,　後龍鎮,中和里,27,308,350,685,10,695,0,695,324,1019,68.2041
第15任總統副總統,在苗栗縣各村(里),苗栗縣,　後龍鎮,南港里,29,288,454,771,9,780,0,780,414,1194,65.3266
第15任總統副總統,在苗栗縣各村(里),苗栗縣,　卓蘭鎮,老庄里,48,604,774,1426,15,1441,0,1441,455,1896,76.0021
第15任總統副總統,在苗栗縣各村(里),苗栗縣,　卓蘭鎮,新榮里,36,300,448,784,8,792,0,792,245,1037,76.3742
第15任總統副總統,在苗栗縣各村(里),苗栗縣,　卓蘭鎮,中街里,22,217,299,538,7,545,0,545,155,700,77.8571
第15任總統副總統,在苗栗縣各村(里),苗栗縣,　卓蘭鎮,新厝里,63,469,547,1079,15,1094,0,1094,396,1490,73.4228
第15任總統副總統,在苗栗縣各村(里),苗栗縣,　卓蘭鎮,豐田里,24,281,375,680,5,685,0,685,259,944,72.5636
第15任總統副總統,在苗栗縣各村(里),苗栗縣,　卓蘭鎮,西坪里,23,220,249,492,3,495,0,495,167,662,74.7734
第15任總統副總統,在苗栗縣各村(里),苗栗縣,　卓蘭鎮,苗豐里,19,213,293,525,8,533,0,533,184,717,74.3375
第15任總統副總統,在苗栗縣各村(里),苗栗縣,　卓蘭鎮,上新里,53,584,821,1458,10,1468,0,1468,525,1993,73.6578
第15任總統副總統,在苗栗縣各村(里),苗栗縣,　卓蘭鎮,內灣里,60,564,839,1463,15,1478,0,1478,618,2096,70.5153
第15任總統副總統,在苗栗縣各村(里),苗栗縣,　卓蘭鎮,坪林里,19,346,350,715,6,721,0,721,323,1044,69.0613
第15任總統副總統,在苗栗縣各村(里),苗栗縣,　卓蘭鎮,西坪里、坪林里,18,274,200,492,1,493,0,493,196,689,71.5530
第15任總統副總統,在苗栗縣各村(里),苗栗縣,　卓蘭鎮,景山里,31,291,291,613,3,616,0,616,285,901,68.3685
第15任總統副總統,在苗栗縣各村(里),苗栗縣,　大湖鄉,大湖村,40,704,405,1149,10,1159,0,1159,396,1555,74.5338
第15任總統副總統,在苗栗縣各村(里),苗栗縣,　大湖鄉,明湖村,16,279,121,416,3,419,0,419,143,562,74.5552
第15任總統副總統,在苗栗縣各村(里),苗栗縣,　大湖鄉,大寮村,29,519,297,845,12,857,0,857,342,1199,71.4762
第15任總統副總統,在苗栗縣各村(里),苗栗縣,　大湖鄉,靜湖村,56,791,387,1234,13,1247,0,1247,454,1701,73.3098
第15任總統副總統,在苗栗縣各村(里),苗栗縣,　大湖鄉,富興村,30,549,353,932,13,945,0,945,396,1341,70.4698
第15任總統副總統,在苗栗縣各村(里),苗栗縣,　大湖鄉,大南村,8,231,109,348,3,351,0,351,199,550,63.8182
第15任總統副總統,在苗栗縣各村(里),苗栗縣,　大湖鄉,南湖村,12,247,161,420,8,428,0,428,177,605,70.7438
第15任總統副總統,在苗栗縣各村(里),苗栗縣,　大湖鄉,東興村,15,290,198,503,3,506,0,506,215,721,70.1803
第15任總統副總統,在苗栗縣各村(里),苗栗縣,　大湖鄉,武榮村,19,202,120,341,5,346,0,346,140,486,71.1934
第15任總統副總統,在苗栗縣各村(里),苗栗縣,　大湖鄉,義和村,22,580,382,984,7,991,0,991,448,1439,68.8673
第15任總統副總統,在苗栗縣各村(里),苗栗縣,　大湖鄉,栗林村,24,368,278,670,7,677,0,677,312,989,68.4530
第15任總統副總統,在苗栗縣各村(里),苗栗縣,　大湖鄉,新開村,27,343,288,658,6,664,0,664,315,979,67.8243
第15任總統副總統,在苗栗縣各村(里),苗栗縣,　公館鄉,館中村,49,602,499,1150,8,1158,0,1158,358,1516,76.3852
第15任總統副總統,在苗栗縣各村(里),苗栗縣,　公館鄉,館東村,63,946,658,1667,17,1684,0,1684,581,2265,74.3488
第15任總統副總統,在苗栗縣各村(里),苗栗縣,　公館鄉,館南村,107,1348,996,2451,28,2479,1,2480,846,3326,74.5340
第15任總統副總統,在苗栗縣各村(里),苗栗縣,　公館鄉,中義村,75,827,689,1591,20,1611,0,1611,612,2223,72.4696
第15任總統副總統,在苗栗縣各村(里),苗栗縣,　公館鄉,玉泉村,71,935,703,1709,15,1724,0,1724,502,2226,77.4483
第15任總統副總統,在苗栗縣各村(里),苗栗縣,　公館鄉,大坑村,32,374,259,665,12,677,0,677,243,920,73.5870
第15任總統副總統,在苗栗縣各村(里),苗栗縣,　公館鄉,福基村,36,443,241,720,7,727,0,727,269,996,72.9920
第15任總統副總統,在苗栗縣各村(里),苗栗縣,　公館鄉,福德村,14,140,110,264,3,267,0,267,82,349,76.5043
第15任總統副總統,在苗栗縣各村(里),苗栗縣,　公館鄉,福星村,69,800,645,1514,10,1524,0,1524,440,1964,77.5967
第15任總統副總統,在苗栗縣各村(里),苗栗縣,　公館鄉,石墻村,59,595,376,1030,11,1041,0,1041,423,1464,71.1066
第15任總統副總統,在苗栗縣各村(里),苗栗縣,　公館鄉,開礦村,7,115,85,207,7,214,0,214,73,287,74.5645
第15任總統副總統,在苗栗縣各村(里),苗栗縣,　公館鄉,五谷村,63,797,695,1555,17,1572,0,1572,568,2140,73.4579
第15任總統副總統,在苗栗縣各村(里),苗栗縣,　公館鄉,玉谷村,64,565,407,1036,9,1045,0,1045,374,1419,73.6434
第15任總統副總統,在苗栗縣各村(里),苗栗縣,　公館鄉,鶴岡村,74,667,460,1201,7,1208,1,1209,373,1582,76.3590
第15任總統副總統,在苗栗縣各村(里),苗栗縣,　公館鄉,鶴山村,57,565,395,1017,13,1030,0,1030,387,1417,72.6888
第15任總統副總統,在苗栗縣各村(里),苗栗縣,　公館鄉,尖山村,47,582,404,1033,10,1043,0,1043,342,1385,75.3069
第15任總統副總統,在苗栗縣各村(里),苗栗縣,　公館鄉,仁安村,35,514,382,931,6,937,0,937,332,1269,73.8377
第15任總統副總統,在苗栗縣各村(里),苗栗縣,　公館鄉,南河村,8,102,36,146,4,150,0,150,58,208,72.1154
第15任總統副總統,在苗栗縣各村(里),苗栗縣,　公館鄉,北河村,8,126,93,227,1,228,0,228,91,319,71.4734
第15任總統副總統,在苗栗縣各村(里),苗栗縣,　銅鑼鄉,銅鑼村,131,1860,1211,3202,34,3236,0,3236,1069,4305,75.1684
第15任總統副總統,在苗栗縣各村(里),苗栗縣,　銅鑼鄉,樟樹村,40,505,401,946,13,959,0,959,281,1240,77.3387
第15任總統副總統,在苗栗縣各村(里),苗栗縣,　銅鑼鄉,九湖村,47,461,310,818,6,824,0,824,307,1131,72.8559
第15任總統副總統,在苗栗縣各村(里),苗栗縣,　銅鑼鄉,福興村,21,506,178,705,7,712,0,712,250,962,74.0125
第15任總統副總統,在苗栗縣各村(里),苗栗縣,　銅鑼鄉,朝陽村,62,702,437,1201,10,1211,0,1211,394,1605,75.4517
第15任總統副總統,在苗栗縣各村(里),苗栗縣,　銅鑼鄉,竹森村,19,474,235,728,10,738,0,738,296,1034,71.3733
第15任總統副總統,在苗栗縣各村(里),苗栗縣,　銅鑼鄉,中平村,96,1151,909,2156,21,2177,0,2177,896,3073,70.8428
第15任總統副總統,在苗栗縣各村(里),苗栗縣,　銅鑼鄉,興隆村,16,215,173,404,11,415,0,415,144,559,74.2397
第15任總統副總統,在苗栗縣各村(里),苗栗縣,　銅鑼鄉,盛隆村,8,165,121,294,5,299,0,299,112,411,72.7494
第15任總統副總統,在苗栗縣各村(里),苗栗縣,　銅鑼鄉,新隆村,11,253,139,403,3,406,0,406,114,520,78.0769
第15任總統副總統,在苗栗縣各村(里),苗栗縣,　南庄鄉,東村,18,499,244,761,10,771,0,771,328,1099,70.1547
第15任總統副總統,在苗栗縣各村(里),苗栗縣,　南庄鄉,西村,13,286,150,449,5,454,0,454,161,615,73.8211
第15任總統副總統,在苗栗縣各村(里),苗栗縣,　南庄鄉,南江村,35,575,252,862,4,866,0,866,412,1278,67.7621
第15任總統副總統,在苗栗縣各村(里),苗栗縣,　南庄鄉,田美村,13,358,185,556,11,567,0,567,217,784,72.3214
第15任總統副總統,在苗栗縣各村(里),苗栗縣,　南庄鄉,獅山村,38,322,195,555,4,559,0,559,230,789,70.8492
第15任總統副總統,在苗栗縣各村(里),苗栗縣,　南庄鄉,南富村,36,485,253,774,7,781,0,781,268,1049,74.4519
第15任總統副總統,在苗栗縣各村(里),苗栗縣,　南庄鄉,員林村,31,399,292,722,7,729,0,729,269,998,73.0461
第15任總統副總統,在苗栗縣各村(里),苗栗縣,　南庄鄉,蓬萊村,26,399,132,557,2,559,0,559,295,854,65.4567
第15任總統副總統,在苗栗縣各村(里),苗栗縣,　南庄鄉,東河村,20,421,126,567,4,571,0,571,339,910,62.7473
第15任總統副總統,在苗栗縣各村(里),苗栗縣,　頭屋鄉,頭屋村,68,1115,627,1810,20,1830,0,1830,590,2420,75.6198
第15任總統副總統,在苗栗縣各村(里),苗栗縣,　頭屋鄉,獅潭村,63,684,452,1199,20,1219,0,1219,417,1636,74.5110
第15任總統副總統,在苗栗縣各村(里),苗栗縣,　頭屋鄉,北坑村,23,312,178,513,2,515,0,515,177,692,74.4220
第15任總統副總統,在苗栗縣各村(里),苗栗縣,　頭屋鄉,曲洞村,22,380,269,671,5,676,0,676,187,863,78.3314
第15任總統副總統,在苗栗縣各村(里),苗栗縣,　頭屋鄉,飛鳳村,4,164,107,275,0,275,0,275,97,372,73.9247
第15任總統副總統,在苗栗縣各村(里),苗栗縣,　頭屋鄉,象山村,59,740,552,1351,20,1371,0,1371,412,1783,76.8929
第15任總統副總統,在苗栗縣各村(里),苗栗縣,　頭屋鄉,明德村,33,448,269,750,9,759,0,759,228,987,76.8997
第15任總統副總統,在苗栗縣各村(里),苗栗縣,　頭屋鄉,鳴鳳村,6,128,88,222,2,224,0,224,93,317,70.6625
第15任總統副總統,在苗栗縣各村(里),苗栗縣,　三義鄉,廣盛村,125,1776,1145,3046,35,3081,0,3081,864,3945,78.0989
第15任總統副總統,在苗栗縣各村(里),苗栗縣,　三義鄉,勝興村,116,1333,1057,2506,39,2545,0,2545,732,3277,77.6625
第15任總統副總統,在苗栗縣各村(里),苗栗縣,　三義鄉,双潭村,57,585,366,1008,10,1018,0,1018,308,1326,76.7722
第15任總統副總統,在苗栗縣各村(里),苗栗縣,　三義鄉,双湖村,55,773,468,1296,18,1314,0,1314,440,1754,74.9145
第15任總統副總統,在苗栗縣各村(里),苗栗縣,　三義鄉,西湖村,48,692,339,1079,21,1100,0,1100,308,1408,78.1250
第15任總統副總統,在苗栗縣各村(里),苗栗縣,　三義鄉,龍騰村,23,197,101,321,4,325,0,325,76,401,81.0474
第15任總統副總統,在苗栗縣各村(里),苗栗縣,　三義鄉,鯉魚潭村,52,400,496,948,13,961,1,962,285,1247,77.0650
第15任總統副總統,在苗栗縣各村(里),苗栗縣,　西湖鄉,高埔村,22,291,122,435,5,440,0,440,153,593,74.1990
第15任總統副總統,在苗栗縣各村(里),苗栗縣,　西湖鄉,下埔村,13,270,123,406,5,411,0,411,142,553,74.3219
第15任總統副總統,在苗栗縣各村(里),苗栗縣,　西湖鄉,五湖村,29,356,185,570,3,573,0,573,235,808,70.9158
第15任總統副總統,在苗栗縣各村(里),苗栗縣,　西湖鄉,四湖村,20,271,128,419,7,426,0,426,195,621,68.5990
第15任總統副總統,在苗栗縣各村(里),苗栗縣,　西湖鄉,三湖村,20,378,241,639,6,645,0,645,253,898,71.8263
第15任總統副總統,在苗栗縣各村(里),苗栗縣,　西湖鄉,龍洞村,20,179,120,319,7,326,0,326,111,437,74.5995
第15任總統副總統,在苗栗縣各村(里),苗栗縣,　西湖鄉,金獅村,26,218,105,349,6,355,0,355,131,486,73.0453
第15任總統副總統,在苗栗縣各村(里),苗栗縣,　西湖鄉,湖東村,47,399,294,740,9,749,0,749,348,1097,68.2771
第15任總統副總統,在苗栗縣各村(里),苗栗縣,　西湖鄉,二湖村,20,256,184,460,7,467,0,467,188,655,71.2977
第15任總統副總統,在苗栗縣各村(里),苗栗縣,　造橋鄉,造橋村,82,862,509,1453,13,1466,0,1466,526,1992,73.5944
第15任總統副總統,在苗栗縣各村(里),苗栗縣,　造橋鄉,平興村,14,203,112,329,3,332,0,332,132,464,71.5517
第15任總統副總統,在苗栗縣各村(里),苗栗縣,　造橋鄉,豐湖村,30,424,256,710,4,714,0,714,263,977,73.0809
第15任總統副總統,在苗栗縣各村(里),苗栗縣,　造橋鄉,大西村,104,1331,962,2397,31,2428,0,2428,857,3285,73.9117
第15任總統副總統,在苗栗縣各村(里),苗栗縣,　造橋鄉,錦水村,20,213,131,364,0,364,0,364,127,491,74.1344
第15任總統副總統,在苗栗縣各村(里),苗栗縣,　造橋鄉,大龍村,9,231,143,383,6,389,1,390,82,472,82.4153
第15任總統副總統,在苗栗縣各村(里),苗栗縣,　造橋鄉,朝陽村,51,376,453,880,15,895,0,895,339,1234,72.5284
第15任總統副總統,在苗栗縣各村(里),苗栗縣,　造橋鄉,談文村,22,274,255,551,4,555,0,555,233,788,70.4315
第15任總統副總統,在苗栗縣各村(里),苗栗縣,　造橋鄉,龍昇村,36,266,374,676,14,690,0,690,237,927,74.4337
第15任總統副總統,在苗栗縣各村(里),苗栗縣,　三灣鄉,三灣村,76,883,602,1561,13,1574,0,1574,531,2105,74.7743
第15任總統副總統,在苗栗縣各村(里),苗栗縣,　三灣鄉,內灣村,18,286,171,475,4,479,0,479,136,615,77.8862
第15任總統副總統,在苗栗縣各村(里),苗栗縣,　三灣鄉,銅鏡村,20,396,206,622,8,630,0,630,204,834,75.5396
第15任總統副總統,在苗栗縣各村(里),苗栗縣,　三灣鄉,頂寮村,5,110,52,167,0,167,0,167,74,241,69.2946
第15任總統副總統,在苗栗縣各村(里),苗栗縣,　三灣鄉,北埔村,15,204,149,368,7,375,0,375,152,527,71.1575
第15任總統副總統,在苗栗縣各村(里),苗栗縣,　三灣鄉,大河村,20,240,139,399,5,404,0,404,147,551,73.3212
第15任總統副總統,在苗栗縣各村(里),苗栗縣,　三灣鄉,大坪村,12,173,120,305,3,308,0,308,87,395,77.9747
第15任總統副總統,在苗栗縣各村(里),苗栗縣,　三灣鄉,永和村,13,181,81,275,3,278,0,278,107,385,72.2078
第15任總統副總統,在苗栗縣各村(里),苗栗縣,　獅潭鄉,百壽村,5,162,56,223,3,226,0,226,100,326,69.3252
第15任總統副總統,在苗栗縣各村(里),苗栗縣,　獅潭鄉,永興村,15,212,119,346,10,356,0,356,172,528,67.4242
第15任總統副總統,在苗栗縣各村(里),苗栗縣,　獅潭鄉,新店村,17,414,203,634,10,644,0,644,242,886,72.6862
第15任總統副總統,在苗栗縣各村(里),苗栗縣,　獅潭鄉,和興村,11,224,147,382,4,386,0,386,161,547,70.5667
第15任總統副總統,在苗栗縣各村(里),苗栗縣,　獅潭鄉,豐林村,11,273,103,387,0,387,0,387,178,565,68.4956
第15任總統副總統,在苗栗縣各村(里),苗栗縣,　獅潭鄉,新豐村,7,143,85,235,5,240,0,240,87,327,73.3945
第15任總統副總統,在苗栗縣各村(里),苗栗縣,　獅潭鄉,竹木村,18,309,151,478,5,483,0,483,168,651,74.1935
第15任總統副總統,在苗栗縣各村(里),苗栗縣,　泰安鄉,八卦村,5,160,58,223,2,225,0,225,94,319,70.5329
第15任總統副總統,在苗栗縣各村(里),苗栗縣,　泰安鄉,錦水村,22,581,165,768,4,772,0,772,321,1093,70.6313
第15任總統副總統,在苗栗縣各村(里),苗栗縣,　泰安鄉,清安村,19,442,168,629,6,635,0,635,236,871,72.9047
第15任總統副總統,在苗栗縣各村(里),苗栗縣,　泰安鄉,大興村,7,280,56,343,3,346,0,346,125,471,73.4607
第15任總統副總統,在苗栗縣各村(里),苗栗縣,　泰安鄉,中興村,9,266,82,357,4,361,0,361,148,509,70.9234
第15任總統副總統,在苗栗縣各村(里),苗栗縣,　泰安鄉,梅園村,13,287,74,374,1,375,0,375,100,475,78.9474
第15任總統副總統,在苗栗縣各村(里),苗栗縣,　泰安鄉,象鼻村,12,375,113,500,4,504,0,504,144,648,77.7778
第15任總統副總統,在苗栗縣各村(里),苗栗縣,　泰安鄉,士林村,15,352,56,423,4,427,0,427,133,560,76.2500
第15任總統副總統,在桃園市各村(里),桃園市,　桃園區,三元里,131,1072,1433,2636,24,2660,0,2660,919,3579,74.3224
第15任總統副總統,在桃園市各村(里),桃園市,　桃園區,三民里,173,1417,1529,3119,40,3159,0,3159,903,4062,77.7696
第15任總統副總統,在桃園市各村(里),桃園市,　桃園區,大有里,238,1863,2238,4339,39,4378,0,4378,1590,5968,73.3579
第15任總統副總統,在桃園市各村(里),桃園市,　桃園區,大業里,179,1413,1892,3484,33,3517,0,3517,1243,4760,73.8866
第15任總統副總統,在桃園市各村(里),桃園市,　桃園區,大興里,165,1427,2211,3803,28,3831,0,3831,1489,5320,72.0113
第15任總統副總統,在桃園市各村(里),桃園市,　桃園區,汴洲里,201,1333,2411,3945,40,3985,0,3985,1346,5331,74.7515
第15任總統副總統,在桃園市各村(里),桃園市,　桃園區,忠義里,129,988,1328,2445,9,2454,0,2454,984,3438,71.3787
第15任總統副總統,在桃園市各村(里),桃園市,　桃園區,青溪里,149,1038,1956,3143,37,3180,0,3180,966,4146,76.7004
第15任總統副總統,在桃園市各村(里),桃園市,　桃園區,春日里,240,1564,2432,4236,43,4279,0,4279,1656,5935,72.0977
第15任總統副總統,在桃園市各村(里),桃園市,　桃園區,會稽里,332,2821,3315,6468,49,6517,1,6518,2510,9028,72.1865
第15任總統副總統,在桃園市各村(里),桃園市,　桃園區,萬壽里,23,236,421,680,7,687,0,687,261,948,72.4684
第15任總統副總統,在桃園市各村(里),桃園市,　桃園區,福元里,161,1223,1608,2992,37,3029,0,3029,1083,4112,73.6625
第15任總統副總統,在桃園市各村(里),桃園市,　桃園區,寶山里,291,2309,3086,5686,61,5747,0,5747,2295,8042,71.4623
第15任總統副總統,在桃園市各村(里),桃園市,　桃園區,大林里,247,1695,2895,4837,43,4880,0,4880,1739,6619,73.7271
第15任總統副總統,在桃園市各村(里),桃園市,　桃園區,大樹里,122,1021,1654,2797,30,2827,0,2827,977,3804,74.3165
第15任總統副總統,在桃園市各村(里),桃園市,　桃園區,大豐里,175,1288,2145,3608,29,3637,0,3637,1238,4875,74.6051
第15任總統副總統,在桃園市各村(里),桃園市,　桃園區,建國里,154,1471,2036,3661,33,3694,0,3694,1320,5014,73.6737
第15任總統副總統,在桃園市各村(里),桃園市,　桃園區,雲林里,201,1762,2480,4443,53,4496,0,4496,1325,5821,77.2376
第15任總統副總統,在桃園市各村(里),桃園市,　桃園區,福安里,140,1189,1725,3054,38,3092,0,3092,948,4040,76.5347
第15任總統副總統,在桃園市各村(里),桃園市,　桃園區,福林里,183,1695,2534,4412,34,4446,0,4446,1246,5692,78.1096
第15任總統副總統,在桃園市各村(里),桃園市,　桃園區,豐林里,214,1739,2642,4595,39,4634,0,4634,1433,6067,76.3804
第15任總統副總統,在桃園市各村(里),桃園市,　桃園區,中和里,52,310,627,989,10,999,0,999,341,1340,74.5522
第15任總統副總統,在桃園市各村(里),桃園市,　桃園區,中興里,166,1371,2461,3998,44,4042,0,4042,1237,5279,76.5675
第15任總統副總統,在桃園市各村(里),桃園市,　桃園區,文化里,38,222,327,587,6,593,0,593,215,808,73.3911
第15任總統副總統,在桃園市各村(里),桃園市,　桃園區,文昌里,22,178,377,577,4,581,0,581,193,774,75.0646
第15任總統副總統,在桃園市各村(里),桃園市,　桃園區,文明里,48,381,576,1005,10,1015,0,1015,296,1311,77.4218
第15任總統副總統,在桃園市各村(里),桃園市,　桃園區,北門里,44,464,764,1272,6,1278,0,1278,400,1678,76.1621
第15任總統副總統,在桃園市各村(里),桃園市,　桃園區,民生里,52,366,625,1043,10,1053,0,1053,359,1412,74.5751
第15任總統副總統,在桃園市各村(里),桃園市,　桃園區,永興里,66,406,828,1300,10,1310,0,1310,465,1775,73.8028
第15任總統副總統,在桃園市各村(里),桃園市,　桃園區,光興里,134,1255,2146,3535,29,3564,0,3564,974,4538,78.5368
第15任總統副總統,在桃園市各村(里),桃園市,　桃園區,西門里,62,435,583,1080,14,1094,0,1094,432,1526,71.6907
第15任總統副總統,在桃園市各村(里),桃園市,　桃園區,西湖里,53,430,618,1101,14,1115,0,1115,302,1417,78.6874
第15任總統副總統,在桃園市各村(里),桃園市,　桃園區,武陵里,46,406,653,1105,14,1119,0,1119,459,1578,70.9125
第15任總統副總統,在桃園市各村(里),桃園市,　桃園區,長美里,16,225,476,717,9,726,0,726,251,977,74.3091
第15任總統副總統,在桃園市各村(里),桃園市,　桃園區,南門里,197,1613,2410,4220,57,4277,0,4277,1419,5696,75.0878
第15任總統副總統,在桃園市各村(里),桃園市,　桃園區,南華里,48,347,624,1019,9,1028,0,1028,350,1378,74.6009
第15任總統副總統,在桃園市各村(里),桃園市,　桃園區,中山里,272,1902,2738,4912,46,4958,0,4958,1509,6467,76.6662
第15任總統副總統,在桃園市各村(里),桃園市,　桃園區,中平里,167,1371,1827,3365,43,3408,0,3408,1108,4516,75.4650
第15任總統副總統,在桃園市各村(里),桃園市,　桃園區,中正里,195,1749,2325,4269,49,4318,0,4318,1298,5616,76.8875
第15任總統副總統,在桃園市各村(里),桃園市,　桃園區,中成里,123,1325,2052,3500,33,3533,0,3533,1040,4573,77.2578
第15任總統副總統,在桃園市各村(里),桃園市,　桃園區,中信里,175,1638,2213,4026,44,4070,0,4070,1458,5528,73.6252
第15任總統副總統,在桃園市各村(里),桃園市,　桃園區,中原里,184,1415,1809,3408,35,3443,0,3443,1000,4443,77.4927
第15任總統副總統,在桃園市各村(里),桃園市,　桃園區,中泰里,160,1335,1552,3047,47,3094,0,3094,828,3922,78.8883
第15任總統副總統,在桃園市各村(里),桃園市,　桃園區,中聖里,214,1767,1859,3840,39,3879,0,3879,1384,5263,73.7032
第15任總統副總統,在桃園市各村(里),桃園市,　桃園區,中路里,130,1174,1558,2862,33,2895,0,2895,939,3834,75.5086
第15任總統副總統,在桃園市各村(里),桃園市,　桃園區,中德里,227,1842,2735,4804,47,4851,0,4851,1456,6307,76.9145
第15任總統副總統,在桃園市各村(里),桃園市,　桃園區,文中里,111,801,1243,2155,26,2181,0,2181,658,2839,76.8228
第15任總統副總統,在桃園市各村(里),桃園市,　桃園區,玉山里,146,1344,2142,3632,36,3668,0,3668,1135,4803,76.3689
第15任總統副總統,在桃園市各村(里),桃園市,　桃園區,泰山里,142,1052,1562,2756,41,2797,0,2797,819,3616,77.3507
第15任總統副總統,在桃園市各村(里),桃園市,　桃園區,龍山里,101,1045,1273,2419,29,2448,0,2448,993,3441,71.1421
第15任總統副總統,在桃園市各村(里),桃園市,　桃園區,龍安里,196,1485,2123,3804,47,3851,0,3851,1252,5103,75.4654
第15任總統副總統,在桃園市各村(里),桃園市,　桃園區,龍岡里,199,1825,2149,4173,40,4213,0,4213,1374,5587,75.4072
第15任總統副總統,在桃園市各村(里),桃園市,　桃園區,龍祥里,195,1528,1724,3447,32,3479,0,3479,1285,4764,73.0269
第15任總統副總統,在桃園市各村(里),桃園市,　桃園區,龍壽里,223,1656,2510,4389,45,4434,0,4434,1506,5940,74.6465
第15任總統副總統,在桃園市各村(里),桃園市,　桃園區,龍鳳里,275,2218,2792,5285,61,5346,0,5346,3937,9283,57.5891
第15任總統副總統,在桃園市各村(里),桃園市,　桃園區,中埔里,76,502,1136,1714,21,1735,0,1735,482,2217,78.2589
第15任總統副總統,在桃園市各村(里),桃園市,　桃園區,中寧里,206,1771,2260,4237,41,4278,0,4278,1524,5802,73.7332
第15任總統副總統,在桃園市各村(里),桃園市,　桃園區,北埔里,163,1280,1807,3250,31,3281,0,3281,1138,4419,74.2476
第15任總統副總統,在桃園市各村(里),桃園市,　桃園區,永安里,147,1011,2115,3273,42,3315,0,3315,1070,4385,75.5986
第15任總統副總統,在桃園市各村(里),桃園市,　桃園區,同安里,313,2456,3514,6283,62,6345,0,6345,2189,8534,74.3497
第15任總統副總統,在桃園市各村(里),桃園市,　桃園區,同德里,222,1836,2242,4300,61,4361,0,4361,1370,5731,76.0949
第15任總統副總統,在桃園市各村(里),桃園市,　桃園區,自強里,295,2171,2891,5357,59,5416,0,5416,1758,7174,75.4948
第15任總統副總統,在桃園市各村(里),桃園市,　桃園區,西埔里,88,660,1515,2263,25,2288,0,2288,725,3013,75.9376
第15任總統副總統,在桃園市各村(里),桃園市,　桃園區,明德里,107,977,1180,2264,35,2299,0,2299,782,3081,74.6186
第15任總統副總統,在桃園市各村(里),桃園市,　桃園區,東埔里,109,1136,2076,3321,46,3367,0,3367,1152,4519,74.5076
第15任總統副總統,在桃園市各村(里),桃園市,　桃園區,長安里,108,903,1648,2659,24,2683,0,2683,788,3471,77.2976
第15任總統副總統,在桃園市各村(里),桃園市,　桃園區,長德里,190,1314,2104,3608,34,3642,0,3642,1121,4763,76.4644
第15任總統副總統,在桃園市各村(里),桃園市,　桃園區,信光里,204,1763,2897,4864,54,4918,0,4918,1758,6676,73.6669
第15任總統副總統,在桃園市各村(里),桃園市,　桃園區,南埔里,173,1313,2006,3492,49,3541,0,3541,1084,4625,76.5622
第15任總統副總統,在桃園市各村(里),桃園市,　桃園區,莊敬里,299,2678,3156,6133,57,6190,0,6190,2088,8278,74.7765
第15任總統副總統,在桃園市各村(里),桃園市,　桃園區,慈文里,206,1647,2508,4361,52,4413,0,4413,1556,5969,73.9320
第15任總統副總統,在桃園市各村(里),桃園市,　桃園區,新埔里,304,2849,3625,6778,62,6840,0,6840,2236,9076,75.3636
第15任總統副總統,在桃園市各村(里),桃園市,　桃園區,瑞慶里,227,1625,2233,4085,41,4126,0,4126,1563,5689,72.5259
第15任總統副總統,在桃園市各村(里),桃園市,　桃園區,寶安里,318,2331,2977,5626,56,5682,0,5682,2071,7753,73.2878
第15任總統副總統,在桃園市各村(里),桃園市,　桃園區,寶慶里,229,1762,2348,4339,43,4382,0,4382,1415,5797,75.5908
第15任總統副總統,在桃園市各村(里),桃園市,　桃園區,朝陽里,57,489,860,1406,16,1422,0,1422,500,1922,73.9854
第15任總統副總統,在桃園市各村(里),桃園市,　桃園區,成功里,138,1164,1605,2907,25,2932,0,2932,867,3799,77.1782
第15任總統副總統,在桃園市各村(里),桃園市,　桃園區,東門里,80,860,1186,2126,24,2150,0,2150,731,2881,74.6269
第15任總統副總統,在桃園市各村(里),桃園市,　桃園區,東山里,75,517,763,1355,21,1376,0,1376,504,1880,73.1915
第15任總統副總統,在桃園市各村(里),桃園市,　中壢區,後寮里,170,1470,1742,3382,33,3415,0,3415,1283,4698,72.6905
第15任總統副總統,在桃園市各村(里),桃園市,　中壢區,明德里,181,1398,1903,3482,38,3520,0,3520,1057,4577,76.9063
第15任總統副總統,在桃園市各村(里),桃園市,　中壢區,至善里,113,1345,1064,2522,23,2545,0,2545,949,3494,72.8392
第15任總統副總統,在桃園市各村(里),桃園市,　中壢區,龍慈里,191,1684,1524,3399,38,3437,0,3437,1184,4621,74.3778
第15任總統副總統,在桃園市各村(里),桃園市,　中壢區,龍興里,162,1372,1650,3184,31,3215,0,3215,970,4185,76.8220
第15任總統副總統,在桃園市各村(里),桃園市,　中壢區,龍德里,148,1437,1510,3095,22,3117,1,3118,855,3973,78.4546
第15任總統副總統,在桃園市各村(里),桃園市,　中壢區,龍岡里,157,1858,1486,3501,30,3531,0,3531,1051,4582,77.0624
第15任總統副總統,在桃園市各村(里),桃園市,　中壢區,龍東里,173,2216,1200,3589,39,3628,0,3628,1166,4794,75.6779
第15任總統副總統,在桃園市各村(里),桃園市,　中壢區,龍昌里,162,2007,1759,3928,39,3967,1,3968,1292,5260,75.4183
第15任總統副總統,在桃園市各村(里),桃園市,　中壢區,龍平里,81,1429,632,2142,27,2169,0,2169,685,2854,75.9986
第15任總統副總統,在桃園市各村(里),桃園市,　中壢區,仁美里,197,1919,1879,3995,38,4033,0,4033,1327,5360,75.2425
第15任總統副總統,在桃園市各村(里),桃園市,　中壢區,仁福里,148,1692,1501,3341,28,3369,0,3369,1275,4644,72.5452
第15任總統副總統,在桃園市各村(里),桃園市,　中壢區,華愛里,125,1239,1141,2505,31,2536,0,2536,874,3410,74.3695
第15任總統副總統,在桃園市各村(里),桃園市,　中壢區,普仁里,138,1264,1477,2879,29,2908,0,2908,1189,4097,70.9788
第15任總統副總統,在桃園市各村(里),桃園市,　中壢區,普忠里,114,1042,1231,2387,28,2415,0,2415,836,3251,74.2848
第15任總統副總統,在桃園市各村(里),桃園市,　中壢區,普強里,151,1256,1352,2759,39,2798,0,2798,807,3605,77.6144
第15任總統副總統,在桃園市各村(里),桃園市,　中壢區,普慶里,88,871,961,1920,17,1937,3,1940,559,2499,77.5110
第15任總統副總統,在桃園市各村(里),桃園市,　中壢區,信義里,182,1381,1687,3250,37,3287,0,3287,913,4200,78.2619
第15任總統副總統,在桃園市各村(里),桃園市,　中壢區,正義里,145,1272,1753,3170,35,3205,0,3205,991,4196,76.3823
第15任總統副總統,在桃園市各村(里),桃園市,　中壢區,普義里,135,1339,1408,2882,32,2914,0,2914,2543,5457,53.3993
第15任總統副總統,在桃園市各村(里),桃園市,　中壢區,德義里,90,802,994,1886,26,1912,0,1912,570,2482,77.0346
第15任總統副總統,在桃園市各村(里),桃園市,　中壢區,仁義里,142,1080,1544,2766,32,2798,0,2798,952,3750,74.6133
第15任總統副總統,在桃園市各村(里),桃園市,　中壢區,忠義里,101,1107,1410,2618,24,2642,0,2642,999,3641,72.5625
第15任總統副總統,在桃園市各村(里),桃園市,　中壢區,中興里,116,1102,1074,2292,21,2313,1,2314,847,3161,73.1730
第15任總統副總統,在桃園市各村(里),桃園市,　中壢區,自立里,197,2689,926,3812,32,3844,0,3844,1221,5065,75.8934
第15任總統副總統,在桃園市各村(里),桃園市,　中壢區,自信里,215,1907,1803,3925,38,3963,0,3963,1364,5327,74.3946
第15任總統副總統,在桃園市各村(里),桃園市,　中壢區,莊敬里,110,1641,802,2553,30,2583,0,2583,810,3393,76.1273
第15任總統副總統,在桃園市各村(里),桃園市,　中壢區,自治里,137,1583,860,2580,30,2610,0,2610,769,3379,77.2418
第15任總統副總統,在桃園市各村(里),桃園市,　中壢區,內壢里,73,799,667,1539,17,1556,0,1556,574,2130,73.0516
第15任總統副總統,在桃園市各村(里),桃園市,　中壢區,成功里,135,1343,1549,3027,36,3063,0,3063,1090,4153,73.7539
第15任總統副總統,在桃園市各村(里),桃園市,　中壢區,福德里,122,950,1024,2096,32,2128,0,2128,655,2783,76.4642
第15任總統副總統,在桃園市各村(里),桃園市,　中壢區,中原里,110,1166,1440,2716,31,2747,19,2766,845,3611,76.0731
第15任總統副總統,在桃園市各村(里),桃園市,　中壢區,忠孝里,184,1416,1704,3304,47,3351,0,3351,1073,4424,75.7459
第15任總統副總統,在桃園市各村(里),桃園市,　中壢區,復興里,337,2674,3449,6460,62,6522,0,6522,2429,8951,72.8634
第15任總統副總統,在桃園市各村(里),桃園市,　中壢區,復華里,198,1678,2197,4073,42,4115,0,4115,1245,5360,76.7724
第15任總統副總統,在桃園市各村(里),桃園市,　中壢區,文化里,346,2520,3526,6392,66,6458,0,6458,2031,8489,76.0749
第15任總統副總統,在桃園市各村(里),桃園市,　中壢區,和平里,98,824,993,1915,22,1937,0,1937,531,2468,78.4846
第15任總統副總統,在桃園市各村(里),桃園市,　中壢區,內定里,222,1673,3090,4985,54,5039,0,5039,1522,6561,76.8023
第15任總統副總統,在桃園市各村(里),桃園市,　中壢區,石頭里,46,472,687,1205,16,1221,0,1221,438,1659,73.5986
第15任總統副總統,在桃園市各村(里),桃園市,　中壢區,中央里,131,1104,1405,2640,42,2682,0,2682,752,3434,78.1013
第15任總統副總統,在桃園市各村(里),桃園市,　中壢區,新興里,153,1117,1411,2681,43,2724,0,2724,848,3572,76.2598
第15任總統副總統,在桃園市各村(里),桃園市,　中壢區,林森里,126,1200,1510,2836,26,2862,0,2862,835,3697,77.4141
第15任總統副總統,在桃園市各村(里),桃園市,　中壢區,振興里,166,1584,1821,3571,30,3601,0,3601,1126,4727,76.1794
第15任總統副總統,在桃園市各村(里),桃園市,　中壢區,東興里,134,964,1370,2468,22,2490,0,2490,782,3272,76.1002
第15任總統副總統,在桃園市各村(里),桃園市,　中壢區,健行里,176,1415,1701,3292,34,3326,0,3326,989,4315,77.0800
第15任總統副總統,在桃園市各村(里),桃園市,　中壢區,水尾里,121,956,1518,2595,23,2618,0,2618,842,3460,75.6647
第15任總統副總統,在桃園市各村(里),桃園市,　中壢區,金華里,158,1473,1412,3043,40,3083,0,3083,812,3895,79.1528
第15任總統副總統,在桃園市各村(里),桃園市,　中壢區,忠福里,278,2207,3179,5664,63,5727,0,5727,1802,7529,76.0659
第15任總統副總統,在桃園市各村(里),桃園市,　中壢區,幸福里,195,1738,2438,4371,41,4412,0,4412,1461,5873,75.1234
第15任總統副總統,在桃園市各村(里),桃園市,　中壢區,永福里,206,1500,2386,4092,50,4142,1,4143,1199,5342,77.5365
第15任總統副總統,在桃園市各村(里),桃園市,　中壢區,青埔里,163,1184,1724,3071,37,3108,0,3108,1059,4167,74.5860
第15任總統副總統,在桃園市各村(里),桃園市,　中壢區,新街里,77,636,845,1558,25,1583,0,1583,541,2124,74.5292
第15任總統副總統,在桃園市各村(里),桃園市,　中壢區,興南里,112,948,1109,2169,27,2196,0,2196,830,3026,72.5711
第15任總統副總統,在桃園市各村(里),桃園市,　中壢區,興國里,61,552,802,1415,17,1432,0,1432,475,1907,75.0918
第15任總統副總統,在桃園市各村(里),桃園市,　中壢區,興平里,82,635,1127,1844,23,1867,0,1867,492,2359,79.1437
第15任總統副總統,在桃園市各村(里),桃園市,　中壢區,興和里,85,764,1283,2132,15,2147,0,2147,540,2687,79.9032
第15任總統副總統,在桃園市各村(里),桃園市,　中壢區,永興里,34,278,392,704,6,710,0,710,226,936,75.8547
第15任總統副總統,在桃園市各村(里),桃園市,　中壢區,中壢里,27,198,284,509,9,518,0,518,176,694,74.6398
第15任總統副總統,在桃園市各村(里),桃園市,　中壢區,中榮里,18,244,337,599,6,605,0,605,213,818,73.9609
第15任總統副總統,在桃園市各村(里),桃園市,　中壢區,中建里,34,265,435,734,5,739,0,739,248,987,74.8734
第15任總統副總統,在桃園市各村(里),桃園市,　中壢區,舊明里,45,415,706,1166,14,1180,0,1180,291,1471,80.2175
第15任總統副總統,在桃園市各村(里),桃園市,　中壢區,新明里,127,1036,1580,2743,18,2761,0,2761,923,3684,74.9457
第15任總統副總統,在桃園市各村(里),桃園市,　中壢區,光明里,182,1750,2037,3969,60,4029,0,4029,1266,5295,76.0907
第15任總統副總統,在桃園市各村(里),桃園市,　中壢區,永光里,187,1516,2244,3947,46,3993,3,3996,1332,5328,74.9437
第15任總統副總統,在桃園市各村(里),桃園市,　中壢區,三民里,91,769,1463,2323,32,2355,0,2355,721,3076,76.5605
第15任總統副總統,在桃園市各村(里),桃園市,　中壢區,五權里,194,1556,2580,4330,50,4380,0,4380,1469,5849,74.8846
第15任總統副總統,在桃園市各村(里),桃園市,　中壢區,五福里,106,1013,1595,2714,30,2744,0,2744,775,3519,77.9767
第15任總統副總統,在桃園市各村(里),桃園市,　中壢區,芝芭里,114,793,1694,2601,32,2633,0,2633,852,3485,75.5524
第15任總統副總統,在桃園市各村(里),桃園市,　中壢區,洽溪里,216,1442,2450,4108,39,4147,0,4147,1374,5521,75.1132
第15任總統副總統,在桃園市各村(里),桃園市,　中壢區,內厝里,160,1045,2282,3487,33,3520,0,3520,1065,4585,76.7721
第15任總統副總統,在桃園市各村(里),桃園市,　中壢區,月眉里,163,1008,2748,3919,29,3948,0,3948,1319,5267,74.9573
第15任總統副總統,在桃園市各村(里),桃園市,　中壢區,山東里,104,688,1959,2751,21,2772,1,2773,848,3621,76.5534
第15任總統副總統,在桃園市各村(里),桃園市,　中壢區,過嶺里,254,1692,3039,4985,53,5038,0,5038,1641,6679,75.4305
第15任總統副總統,在桃園市各村(里),桃園市,　中壢區,龍安里,60,1002,551,1613,24,1637,0,1637,412,2049,79.8926
第15任總統副總統,在桃園市各村(里),桃園市,　中壢區,仁愛里,119,950,1159,2228,27,2255,0,2255,665,2920,77.2260
第15任總統副總統,在桃園市各村(里),桃園市,　中壢區,仁德里,130,1148,943,2221,30,2251,0,2251,709,2960,76.0473
第15任總統副總統,在桃園市各村(里),桃園市,　中壢區,仁和里,127,1241,1139,2507,13,2520,1,2521,954,3475,72.5180
第15任總統副總統,在桃園市各村(里),桃園市,　中壢區,仁祥里,89,1087,827,2003,15,2018,0,2018,717,2735,73.7843
第15任總統副總統,在桃園市各村(里),桃園市,　中壢區,華勛里,103,1472,1001,2576,25,2601,0,2601,964,3565,72.9593
第15任總統副總統,在桃園市各村(里),桃園市,　中壢區,中堅里,148,1441,1104,2693,23,2716,0,2716,937,3653,74.3498
第15任總統副總統,在桃園市各村(里),桃園市,　中壢區,興仁里,117,1111,1147,2375,24,2399,0,2399,918,3317,72.3244
第15任總統副總統,在桃園市各村(里),桃園市,　中壢區,中正里,164,1774,1727,3665,23,3688,0,3688,1326,5014,73.5540
第15任總統副總統,在桃園市各村(里),桃園市,　中壢區,中山里,178,1564,1526,3268,40,3308,0,3308,1271,4579,72.2428
第15任總統副總統,在桃園市各村(里),桃園市,　中壢區,篤行里,90,825,876,1791,17,1808,0,1808,664,2472,73.1392
第15任總統副總統,在桃園市各村(里),桃園市,　中壢區,自強里,157,1282,1135,2574,17,2591,1,2592,803,3395,76.3181
第15任總統副總統,在桃園市各村(里),桃園市,　大溪區,興和里,36,326,742,1104,16,1120,0,1120,325,1445,77.5087
第15任總統副總統,在桃園市各村(里),桃園市,　大溪區,福仁里,23,203,529,755,6,761,0,761,209,970,78.4536
第15任總統副總統,在桃園市各村(里),桃園市,　大溪區,田心里,141,971,2132,3244,31,3275,0,3275,1069,4344,75.3913
第15任總統副總統,在桃園市各村(里),桃園市,　大溪區,一心里,136,1029,2100,3265,28,3293,0,3293,1323,4616,71.3388
第15任總統副總統,在桃園市各村(里),桃園市,　大溪區,一德里,156,1192,2531,3879,35,3914,0,3914,1481,5395,72.5487
第15任總統副總統,在桃園市各村(里),桃園市,　大溪區,月眉里,36,219,637,892,7,899,0,899,311,1210,74.2975
第15任總統副總統,在桃園市各村(里),桃園市,　大溪區,永福里,15,183,508,706,8,714,0,714,256,970,73.6082
第15任總統副總統,在桃園市各村(里),桃園市,　大溪區,康安里,29,258,689,976,10,986,0,986,309,1295,76.1390
第15任總統副總統,在桃園市各村(里),桃園市,　大溪區,義和里,47,336,925,1308,7,1315,0,1315,454,1769,74.3358
第15任總統副總統,在桃園市各村(里),桃園市,　大溪區,美華里,94,648,1522,2264,22,2286,0,2286,709,2995,76.3272
第15任總統副總統,在桃園市各村(里),桃園市,　大溪區,福安里,60,399,1172,1631,14,1645,0,1645,534,2179,75.4933
第15任總統副總統,在桃園市各村(里),桃園市,　大溪區,復興里,26,172,436,634,8,642,0,642,245,887,72.3788
第15任總統副總統,在桃園市各村(里),桃園市,　大溪區,新峰里,21,165,393,579,12,591,0,591,202,793,74.5271
第15任總統副總統,在桃園市各村(里),桃園市,　大溪區,中新里,32,325,822,1179,11,1190,0,1190,307,1497,79.4923
第15任總統副總統,在桃園市各村(里),桃園市,　大溪區,瑞興里,79,629,1232,1940,18,1958,0,1958,729,2687,72.8694
第15任總統副總統,在桃園市各村(里),桃園市,　大溪區,仁善里,146,1105,1591,2842,25,2867,0,2867,937,3804,75.3680
第15任總統副總統,在桃園市各村(里),桃園市,　大溪區,仁美里,100,1047,1210,2357,31,2388,0,2388,800,3188,74.9059
第15任總統副總統,在桃園市各村(里),桃園市,　大溪區,僑愛里,69,1287,499,1855,29,1884,0,1884,603,2487,75.7539
第15任總統副總統,在桃園市各村(里),桃園市,　大溪區,仁義里,86,1195,637,1918,31,1949,0,1949,829,2778,70.1584
第15任總統副總統,在桃園市各村(里),桃園市,　大溪區,仁和里,155,1388,1852,3395,32,3427,0,3427,1133,4560,75.1535
第15任總統副總統,在桃園市各村(里),桃園市,　大溪區,仁愛里,183,1437,2083,3703,39,3742,0,3742,1198,4940,75.7490
第15任總統副總統,在桃園市各村(里),桃園市,　大溪區,仁武里,116,950,1184,2250,40,2290,0,2290,801,3091,74.0861
第15任總統副總統,在桃園市各村(里),桃園市,　大溪區,仁文里,129,1152,1415,2696,26,2722,0,2722,1050,3772,72.1633
第15任總統副總統,在桃園市各村(里),桃園市,　大溪區,南興里,123,1126,2182,3431,37,3468,0,3468,1399,4867,71.2554
第15任總統副總統,在桃園市各村(里),桃園市,　大溪區,光明里,84,855,699,1638,27,1665,0,1665,645,2310,72.0779
第15任總統副總統,在桃園市各村(里),桃園市,　大溪區,員林里,47,437,566,1050,14,1064,0,1064,420,1484,71.6981
第15任總統副總統,在桃園市各村(里),桃園市,　大溪區,三元里,106,1142,887,2135,22,2157,0,2157,762,2919,73.8952
第15任總統副總統,在桃園市各村(里),桃園市,　大溪區,瑞源里,118,950,1626,2694,28,2722,0,2722,912,3634,74.9037
第15任總統副總統,在桃園市各村(里),桃園市,　楊梅區,仁美里,127,1280,1425,2832,30,2862,0,2862,939,3801,75.2960
第15任總統副總統,在桃園市各村(里),桃園市,　楊梅區,埔心里,47,399,649,1095,12,1107,0,1107,291,1398,79.1845
第15任總統副總統,在桃園市各村(里),桃園市,　楊梅區,光華里,99,1178,1042,2319,22,2341,0,2341,772,3113,75.2008
第15任總統副總統,在桃園市各村(里),桃園市,　楊梅區,金龍里,30,511,287,828,16,844,0,844,278,1122,75.2228
第15任總統副總統,在桃園市各村(里),桃園市,　楊梅區,四維里,212,1400,1557,3169,29,3198,0,3198,936,4134,77.3585
第15任總統副總統,在桃園市各村(里),桃園市,　楊梅區,永平里,70,574,650,1294,20,1314,0,1314,586,1900,69.1579
第15任總統副總統,在桃園市各村(里),桃園市,　楊梅區,瑞塘里,193,1607,2116,3916,48,3964,0,3964,1357,5321,74.4973
第15任總統副總統,在桃園市各村(里),桃園市,　楊梅區,瑞坪里,193,1915,1821,3929,27,3956,0,3956,1562,5518,71.6926
第15任總統副總統,在桃園市各村(里),桃園市,　楊梅區,梅溪里,124,1241,1475,2840,25,2865,0,2865,1065,3930,72.9008
第15任總統副總統,在桃園市各村(里),桃園市,　楊梅區,瑞溪里,115,999,1303,2417,21,2438,0,2438,997,3435,70.9753
第15任總統副總統,在桃園市各村(里),桃園市,　楊梅區,金溪里,156,1255,1336,2747,46,2793,0,2793,948,3741,74.6592
第15任總統副總統,在桃園市各村(里),桃園市,　楊梅區,三民里,136,1041,1151,2328,23,2351,0,2351,852,3203,73.3999
第15任總統副總統,在桃園市各村(里),桃園市,　楊梅區,楊明里,300,2077,2503,4880,58,4938,0,4938,1772,6710,73.5917
第15任總統副總統,在桃園市各村(里),桃園市,　楊梅區,裕成里,114,1143,1056,2313,26,2339,0,2339,802,3141,74.4667
第15任總統副總統,在桃園市各村(里),桃園市,　楊梅區,裕新里,77,758,675,1510,10,1520,0,1520,792,2312,65.7439
第15任總統副總統,在桃園市各村(里),桃園市,　楊梅區,大同里,99,1145,1171,2415,14,2429,0,2429,774,3203,75.8352
第15任總統副總統,在桃園市各村(里),桃園市,　楊梅區,中山里,99,1011,1130,2240,20,2260,0,2260,666,2926,77.2386
第15任總統副總統,在桃園市各村(里),桃園市,　楊梅區,楊梅里,124,1240,1424,2788,32,2820,0,2820,805,3625,77.7931
第15任總統副總統,在桃園市各村(里),桃園市,　楊梅區,楊江里,38,369,379,786,11,797,0,797,243,1040,76.6346
第15任總統副總統,在桃園市各村(里),桃園市,　楊梅區,梅新里,81,683,697,1461,12,1473,0,1473,485,1958,75.2298
第15任總統副總統,在桃園市各村(里),桃園市,　楊梅區,紅梅里,88,884,979,1951,14,1965,0,1965,574,2539,77.3927
第15任總統副總統,在桃園市各村(里),桃園市,　楊梅區,永寧里,219,1946,2447,4612,39,4651,0,4651,2353,7004,66.4049
第15任總統副總統,在桃園市各村(里),桃園市,　楊梅區,大平里,105,1019,1074,2198,22,2220,1,2221,896,3117,71.2223
第15任總統副總統,在桃園市各村(里),桃園市,　楊梅區,秀才里,110,1009,1297,2416,30,2446,0,2446,773,3219,75.9863
第15任總統副總統,在桃園市各村(里),桃園市,　楊梅區,東流里,90,702,1139,1931,21,1952,0,1952,890,2842,68.6840
第15任總統副總統,在桃園市各村(里),桃園市,　楊梅區,豐野里,141,1156,1505,2802,41,2843,0,2843,931,3774,75.3312
第15任總統副總統,在桃園市各村(里),桃園市,　楊梅區,富岡里,60,602,694,1356,25,1381,0,1381,416,1797,76.8503
第15任總統副總統,在桃園市各村(里),桃園市,　楊梅區,富豐里,84,857,1152,2093,25,2118,1,2119,774,2893,73.2112
第15任總統副總統,在桃園市各村(里),桃園市,　楊梅區,員本里,105,721,1132,1958,28,1986,0,1986,698,2684,73.9940
第15任總統副總統,在桃園市各村(里),桃園市,　楊梅區,三湖里,98,782,1090,1970,16,1986,0,1986,653,2639,75.2558
第15任總統副總統,在桃園市各村(里),桃園市,　楊梅區,頭湖里,126,834,999,1959,24,1983,0,1983,754,2737,72.4516
第15任總統副總統,在桃園市各村(里),桃園市,　楊梅區,上湖里,182,1634,1984,3800,41,3841,0,3841,1670,5511,69.6970
第15任總統副總統,在桃園市各村(里),桃園市,　楊梅區,上田里,91,647,1131,1869,21,1890,0,1890,629,2519,75.0298
第15任總統副總統,在桃園市各村(里),桃園市,　楊梅區,高山里,121,1163,1211,2495,25,2520,0,2520,1041,3561,70.7666
第15任總統副總統,在桃園市各村(里),桃園市,　楊梅區,高上里,92,752,1106,1950,25,1975,0,1975,669,2644,74.6974
第15任總統副總統,在桃園市各村(里),桃園市,　楊梅區,青山里,128,1230,1336,2694,19,2713,0,2713,1371,4084,66.4300
第15任總統副總統,在桃園市各村(里),桃園市,　楊梅區,高榮里,122,877,1497,2496,32,2528,0,2528,835,3363,75.1710
第15任總統副總統,在桃園市各村(里),桃園市,　楊梅區,雙榮里,118,946,1392,2456,26,2482,0,2482,654,3136,79.1454
第15任總統副總統,在桃園市各村(里),桃園市,　楊梅區,新榮里,114,977,1476,2567,28,2595,0,2595,763,3358,77.2781
第15任總統副總統,在桃園市各村(里),桃園市,　楊梅區,水美里,145,1219,1580,2944,30,2974,0,2974,988,3962,75.0631
第15任總統副總統,在桃園市各村(里),桃園市,　楊梅區,瑞原里,133,1057,1381,2571,28,2599,0,2599,1014,3613,71.9347
第15任總統副總統,在桃園市各村(里),桃園市,　蘆竹區,新興里,85,547,1465,2097,26,2123,1,2124,682,2806,75.6593
第15任總統副總統,在桃園市各村(里),桃園市,　蘆竹區,中福里,107,777,2010,2894,25,2919,1,2920,927,3847,75.8773
第15任總統副總統,在桃園市各村(里),桃園市,　蘆竹區,上興里,117,834,1449,2400,19,2419,0,2419,716,3135,77.1611
第15任總統副總統,在桃園市各村(里),桃園市,　蘆竹區,中興里,185,1222,1994,3401,27,3428,0,3428,1254,4682,73.2166
第15任總統副總統,在桃園市各村(里),桃園市,　蘆竹區,新莊里,147,1048,2321,3516,29,3545,0,3545,1218,4763,74.4279
第15任總統副總統,在桃園市各村(里),桃園市,　蘆竹區,上竹里,112,875,1581,2568,23,2591,0,2591,788,3379,76.6795
第15任總統副總統,在桃園市各村(里),桃園市,　蘆竹區,宏竹里,109,656,1437,2202,24,2226,0,2226,667,2893,76.9443
第15任總統副總統,在桃園市各村(里),桃園市,　蘆竹區,大竹里,202,1289,2095,3586,26,3612,0,3612,1091,4703,76.8020
第15任總統副總統,在桃園市各村(里),桃園市,　蘆竹區,富竹里,51,193,734,978,9,987,0,987,285,1272,77.5943
第15任總統副總統,在桃園市各村(里),桃園市,　蘆竹區,蘆竹里,83,789,2110,2982,34,3016,0,3016,963,3979,75.7979
第15任總統副總統,在桃園市各村(里),桃園市,　蘆竹區,南興里,186,1574,1892,3652,48,3700,0,3700,1246,4946,74.8079
第15任總統副總統,在桃園市各村(里),桃園市,　蘆竹區,福昌里,175,1442,1944,3561,36,3597,0,3597,1248,4845,74.2415
第15任總統副總統,在桃園市各村(里),桃園市,　蘆竹區,福興里,130,917,1326,2373,25,2398,0,2398,935,3333,71.9472
第15任總統副總統,在桃園市各村(里),桃園市,　蘆竹區,正興里,146,1076,1693,2915,32,2947,0,2947,1202,4149,71.0292
第15任總統副總統,在桃園市各村(里),桃園市,　蘆竹區,順興里,132,986,1457,2575,28,2603,0,2603,978,3581,72.6892
第15任總統副總統,在桃園市各村(里),桃園市,　蘆竹區,蘆興里,51,393,757,1201,13,1214,0,1214,361,1575,77.0794
第15任總統副總統,在桃園市各村(里),桃園市,　蘆竹區,南榮里,122,872,1344,2338,31,2369,0,2369,813,3182,74.4500
第15任總統副總統,在桃園市各村(里),桃園市,　蘆竹區,南崁里,136,972,1555,2663,30,2693,0,2693,885,3578,75.2655
第15任總統副總統,在桃園市各村(里),桃園市,　蘆竹區,錦興里,128,984,1762,2874,28,2902,0,2902,890,3792,76.5295
第15任總統副總統,在桃園市各村(里),桃園市,　蘆竹區,錦中里,96,833,1329,2258,39,2297,0,2297,787,3084,74.4812
第15任總統副總統,在桃園市各村(里),桃園市,　蘆竹區,興榮里,106,858,1086,2050,17,2067,0,2067,603,2670,77.4157
第15任總統副總統,在桃園市各村(里),桃園市,　蘆竹區,長興里,85,610,1046,1741,19,1760,0,1760,765,2525,69.7030
第15任總統副總統,在桃園市各村(里),桃園市,　蘆竹區,五福里,86,675,987,1748,20,1768,0,1768,534,2302,76.8028
第15任總統副總統,在桃園市各村(里),桃園市,　蘆竹區,中山里,113,876,1211,2200,18,2218,0,2218,840,3058,72.5311
第15任總統副總統,在桃園市各村(里),桃園市,　蘆竹區,福祿里,129,797,1315,2241,32,2273,0,2273,783,3056,74.3783
第15任總統副總統,在桃園市各村(里),桃園市,　蘆竹區,羊稠里,167,1226,1695,3088,33,3121,0,3121,1061,4182,74.6294
第15任總統副總統,在桃園市各村(里),桃園市,　蘆竹區,吉祥里,125,1150,1316,2591,26,2617,0,2617,840,3457,75.7015
第15任總統副總統,在桃園市各村(里),桃園市,　蘆竹區,長壽里,229,1619,2051,3899,35,3934,0,3934,1300,5234,75.1624
第15任總統副總統,在桃園市各村(里),桃園市,　蘆竹區,營盤里,190,1342,1789,3321,46,3367,0,3367,1220,4587,73.4031
第15任總統副總統,在桃園市各村(里),桃園市,　蘆竹區,營福里,125,859,1306,2290,32,2322,0,2322,840,3162,73.4345
第15任總統副總統,在桃園市各村(里),桃園市,　蘆竹區,瓦窯里,123,975,1077,2175,31,2206,0,2206,972,3178,69.4147
第15任總統副總統,在桃園市各村(里),桃園市,　蘆竹區,內厝里,69,473,1032,1574,17,1591,0,1591,877,2468,64.4652
第15任總統副總統,在桃園市各村(里),桃園市,　蘆竹區,山鼻里,76,434,763,1273,13,1286,0,1286,428,1714,75.0292
第15任總統副總統,在桃園市各村(里),桃園市,　蘆竹區,山腳里,124,681,1795,2600,25,2625,0,2625,858,3483,75.3661
第15任總統副總統,在桃園市各村(里),桃園市,　蘆竹區,外社里,50,230,848,1128,16,1144,0,1144,315,1459,78.4099
第15任總統副總統,在桃園市各村(里),桃園市,　蘆竹區,坑子里,49,255,932,1236,7,1243,0,1243,370,1613,77.0614
第15任總統副總統,在桃園市各村(里),桃園市,　蘆竹區,坑口里,69,490,1259,1818,19,1837,0,1837,612,2449,75.0102
第15任總統副總統,在桃園市各村(里),桃園市,　蘆竹區,海湖里,113,786,1194,2093,23,2116,0,2116,744,2860,73.9860
第15任總統副總統,在桃園市各村(里),桃園市,　蘆竹區,濱海里,65,612,1010,1687,20,1707,0,1707,737,2444,69.8445
第15任總統副總統,在桃園市各村(里),桃園市,　大園區,大園里,210,1466,2638,4314,37,4351,0,4351,1589,5940,73.2492
第15任總統副總統,在桃園市各村(里),桃園市,　大園區,田心里,255,1513,3098,4866,52,4918,0,4918,1614,6532,75.2909
第15任總統副總統,在桃園市各村(里),桃園市,　大園區,溪海里,131,1028,2048,3207,48,3255,0,3255,1295,4550,71.5385
第15任總統副總統,在桃園市各村(里),桃園市,　大園區,和平里,56,291,826,1173,12,1185,0,1185,377,1562,75.8643
第15任總統副總統,在桃園市各村(里),桃園市,　大園區,橫峰里,412,2859,4587,7858,78,7936,0,7936,2693,10629,74.6637
第15任總統副總統,在桃園市各村(里),桃園市,　大園區,五權里,134,1031,2489,3654,34,3688,0,3688,1179,4867,75.7756
第15任總統副總統,在桃園市各村(里),桃園市,　大園區,埔心里,175,1399,2708,4282,38,4320,0,4320,1477,5797,74.5213
第15任總統副總統,在桃園市各村(里),桃園市,　大園區,大海里,61,518,605,1184,15,1199,0,1199,401,1600,74.9375
第15任總統副總統,在桃園市各村(里),桃園市,　大園區,三石里,103,665,1392,2160,27,2187,0,2187,631,2818,77.6082
第15任總統副總統,在桃園市各村(里),桃園市,　大園區,菓林里,218,1694,3011,4923,62,4985,2,4987,1863,6850,72.7737
第15任總統副總統,在桃園市各村(里),桃園市,　大園區,竹圍里,104,820,1417,2341,35,2376,0,2376,807,3183,74.6466
第15任總統副總統,在桃園市各村(里),桃園市,　大園區,海口里,69,494,743,1306,20,1326,0,1326,476,1802,73.5849
第15任總統副總統,在桃園市各村(里),桃園市,　大園區,沙崙里,81,685,1119,1885,23,1908,0,1908,745,2653,71.9186
第15任總統副總統,在桃園市各村(里),桃園市,　大園區,後厝里,110,614,1139,1863,19,1882,0,1882,607,2489,75.6127
第15任總統副總統,在桃園市各村(里),桃園市,　大園區,圳頭里,83,593,1201,1877,26,1903,0,1903,618,2521,75.4859
第15任總統副總統,在桃園市各村(里),桃園市,　大園區,內海里,77,529,995,1601,15,1616,0,1616,497,2113,76.4789
第15任總統副總統,在桃園市各村(里),桃園市,　大園區,北港里,103,566,1263,1932,15,1947,0,1947,800,2747,70.8773
第15任總統副總統,在桃園市各村(里),桃園市,　大園區,南港里,212,1331,2096,3639,36,3675,0,3675,1580,5255,69.9334
第15任總統副總統,在桃園市各村(里),桃園市,　龜山區,大同里,195,1530,2349,4074,54,4128,1,4129,1496,5625,73.3867
第15任總統副總統,在桃園市各村(里),桃園市,　龜山區,大坑里,72,425,893,1390,23,1413,0,1413,470,1883,75.0398
第15任總統副總統,在桃園市各村(里),桃園市,　龜山區,大崗里,122,1038,1682,2842,47,2889,0,2889,1111,4000,72.2250
第15任總統副總統,在桃園市各村(里),桃園市,　龜山區,大湖里,204,1407,2106,3717,35,3752,0,3752,1410,5162,72.6850
第15任總統副總統,在桃園市各村(里),桃園市,　龜山區,大華里,335,2227,3763,6325,73,6398,0,6398,2186,8584,74.5340
第15任總統副總統,在桃園市各村(里),桃園市,　龜山區,山頂里,177,1438,2031,3646,37,3683,0,3683,1624,5307,69.3989
第15任總統副總統,在桃園市各村(里),桃園市,　龜山區,山福里,127,852,1398,2377,19,2396,0,2396,854,3250,73.7231
第15任總統副總統,在桃園市各村(里),桃園市,　龜山區,山德里,186,1240,2103,3529,32,3561,0,3561,1229,4790,74.3424
第15任總統副總統,在桃園市各村(里),桃園市,　龜山區,中興里,163,1287,1841,3291,40,3331,10,3341,1244,4585,72.6499
第15任總統副總統,在桃園市各村(里),桃園市,　龜山區,公西里,34,342,511,887,6,893,0,893,251,1144,78.0594
第15任總統副總統,在桃園市各村(里),桃園市,　龜山區,文化里,242,1674,2748,4664,57,4721,0,4721,1598,6319,74.7112
第15任總統副總統,在桃園市各村(里),桃園市,　龜山區,文青里,307,1988,2780,5075,64,5139,0,5139,1777,6916,74.3060
第15任總統副總統,在桃園市各村(里),桃園市,　龜山區,兔坑里,148,1076,1764,2988,30,3018,0,3018,1276,4294,70.2841
第15任總統副總統,在桃園市各村(里),桃園市,　龜山區,幸福里,197,1343,1857,3397,41,3438,0,3438,1678,5116,67.2009
第15任總統副總統,在桃園市各村(里),桃園市,　龜山區,長庚里,178,752,1897,2827,28,2855,0,2855,746,3601,79.2835
第15任總統副總統,在桃園市各村(里),桃園市,　龜山區,南上里,76,432,883,1391,20,1411,0,1411,416,1827,77.2304
第15任總統副總統,在桃園市各村(里),桃園市,　龜山區,南美里,87,592,972,1651,29,1680,0,1680,551,2231,75.3026
第15任總統副總統,在桃園市各村(里),桃園市,　龜山區,迴龍里,213,1497,2498,4208,36,4244,0,4244,1574,5818,72.9460
第15任總統副總統,在桃園市各村(里),桃園市,　龜山區,陸光里,91,2084,524,2699,27,2726,0,2726,788,3514,77.5754
第15任總統副總統,在桃園市各村(里),桃園市,　龜山區,新路里,181,1487,2295,3963,43,4006,0,4006,1227,5233,76.5526
第15任總統副總統,在桃園市各村(里),桃園市,　龜山區,新興里,79,817,702,1598,18,1616,0,1616,1285,2901,55.7049
第15任總統副總統,在桃園市各村(里),桃園市,　龜山區,新嶺里,135,969,1581,2685,21,2706,0,2706,1124,3830,70.6527
第15任總統副總統,在桃園市各村(里),桃園市,　龜山區,楓福里,120,850,1296,2266,23,2289,0,2289,652,2941,77.8307
第15任總統副總統,在桃園市各村(里),桃園市,　龜山區,楓樹里,135,911,1690,2736,27,2763,0,2763,858,3621,76.3049
第15任總統副總統,在桃園市各村(里),桃園市,　龜山區,福源里,58,606,753,1417,8,1425,0,1425,545,1970,72.3350
第15任總統副總統,在桃園市各村(里),桃園市,　龜山區,精忠里,207,1876,1680,3763,42,3805,0,3805,1218,5023,75.7515
第15任總統副總統,在桃園市各村(里),桃園市,　龜山區,樂善里,134,839,1590,2563,29,2592,0,2592,966,3558,72.8499
第15任總統副總統,在桃園市各村(里),桃園市,　龜山區,龍華里,120,815,1486,2421,29,2450,0,2450,866,3316,73.8842
第15任總統副總統,在桃園市各村(里),桃園市,　龜山區,龍壽里,48,322,874,1244,15,1259,0,1259,461,1720,73.1977
第15任總統副總統,在桃園市各村(里),桃園市,　龜山區,龜山里,248,1689,2753,4690,64,4754,0,4754,1761,6515,72.9701
第15任總統副總統,在桃園市各村(里),桃園市,　龜山區,嶺頂里,116,904,1673,2693,30,2723,0,2723,1133,3856,70.6172
第15任總統副總統,在桃園市各村(里),桃園市,　龜山區,舊路里,75,659,1157,1891,15,1906,0,1906,606,2512,75.8758
第15任總統副總統,在桃園市各村(里),桃園市,　八德區,興仁里,234,2009,2713,4956,56,5012,0,5012,2721,7733,64.8131
第15任總統副總統,在桃園市各村(里),桃園市,　八德區,福興里,333,2459,3561,6353,77,6430,0,6430,2633,9063,70.9478
第15任總統副總統,在桃園市各村(里),桃園市,　八德區,瑞豐里,142,1177,1570,2889,29,2918,0,2918,1157,4075,71.6074
第15任總統副總統,在桃園市各村(里),桃園市,　八德區,瑞興里,88,737,1152,1977,24,2001,0,2001,646,2647,75.5950
第15任總統副總統,在桃園市各村(里),桃園市,　八德區,瑞泰里,141,1164,1648,2953,30,2983,0,2983,1084,4067,73.3464
第15任總統副總統,在桃園市各村(里),桃園市,　八德區,瑞發里,134,1112,1124,2370,24,2394,0,2394,698,3092,77.4256
第15任總統副總統,在桃園市各村(里),桃園市,　八德區,瑞德里,105,1280,1075,2460,35,2495,0,2495,996,3491,71.4695
第15任總統副總統,在桃園市各村(里),桃園市,　八德區,瑞祥里,100,1291,974,2365,24,2389,0,2389,805,3194,74.7965
第15任總統副總統,在桃園市各村(里),桃園市,　八德區,廣德里,89,751,1160,2000,15,2015,0,2015,639,2654,75.9231
第15任總統副總統,在桃園市各村(里),桃園市,　八德區,廣興里,107,847,1364,2318,21,2339,0,2339,867,3206,72.9570
第15任總統副總統,在桃園市各村(里),桃園市,　八德區,廣隆里,137,1432,1743,3312,34,3346,0,3346,1031,4377,76.4451
第15任總統副總統,在桃園市各村(里),桃園市,　八德區,竹園里,92,963,1363,2418,26,2444,0,2444,892,3336,73.2614
第15任總統副總統,在桃園市各村(里),桃園市,　八德區,霄裡里,64,593,908,1565,18,1583,0,1583,563,2146,73.7651
第15任總統副總統,在桃園市各村(里),桃園市,　八德區,龍友里,64,1063,493,1620,19,1639,0,1639,485,2124,77.1657
第15任總統副總統,在桃園市各村(里),桃園市,　八德區,茄明里,176,1289,1761,3226,27,3253,0,3253,1271,4524,71.9054
第15任總統副總統,在桃園市各村(里),桃園市,　八德區,茄苳里,102,586,1153,1841,12,1853,0,1853,610,2463,75.2335
第15任總統副總統,在桃園市各村(里),桃園市,　八德區,永豐里,83,772,1194,2049,20,2069,0,2069,663,2732,75.7321
第15任總統副總統,在桃園市各村(里),桃園市,　八德區,高明里,136,1008,1531,2675,46,2721,0,2721,1068,3789,71.8131
第15任總統副總統,在桃園市各村(里),桃園市,　八德區,高城里,114,890,1229,2233,25,2258,0,2258,741,2999,75.2918
第15任總統副總統,在桃園市各村(里),桃園市,　八德區,白鷺里,94,831,1312,2237,26,2263,0,2263,776,3039,74.4653
第15任總統副總統,在桃園市各村(里),桃園市,　八德區,大湳里,112,968,1684,2764,35,2799,0,2799,998,3797,73.7161
第15任總統副總統,在桃園市各村(里),桃園市,　八德區,大發里,48,503,888,1439,7,1446,0,1446,492,1938,74.6130
第15任總統副總統,在桃園市各村(里),桃園市,　八德區,大仁里,128,1055,1865,3048,30,3078,0,3078,984,4062,75.7755
第15任總統副總統,在桃園市各村(里),桃園市,　八德區,大明里,134,882,1565,2581,28,2609,0,2609,899,3508,74.3729
第15任總統副總統,在桃園市各村(里),桃園市,　八德區,大安里,127,821,1543,2491,32,2523,0,2523,813,3336,75.6295
第15任總統副總統,在桃園市各村(里),桃園市,　八德區,大竹里,35,405,703,1143,10,1153,0,1153,316,1469,78.4888
第15任總統副總統,在桃園市各村(里),桃園市,　八德區,大興里,126,1029,1502,2657,16,2673,0,2673,839,3512,76.1105
第15任總統副總統,在桃園市各村(里),桃園市,　八德區,大愛里,120,791,974,1885,36,1921,0,1921,559,2480,77.4597
第15任總統副總統,在桃園市各村(里),桃園市,　八德區,大華里,87,811,960,1858,14,1872,0,1872,572,2444,76.5957
第15任總統副總統,在桃園市各村(里),桃園市,　八德區,大順里,97,732,997,1826,20,1846,0,1846,663,2509,73.5751
第15任總統副總統,在桃園市各村(里),桃園市,　八德區,大和里,238,2417,2372,5027,61,5088,0,5088,1899,6987,72.8210
第15任總統副總統,在桃園市各村(里),桃園市,　八德區,大昌里,92,916,1125,2133,23,2156,0,2156,656,2812,76.6714
第15任總統副總統,在桃園市各村(里),桃園市,　八德區,大信里,101,1177,1132,2410,33,2443,0,2443,1084,3527,69.2657
第15任總統副總統,在桃園市各村(里),桃園市,　八德區,陸光里,137,2049,825,3011,53,3064,0,3064,1149,4213,72.7273
第15任總統副總統,在桃園市各村(里),桃園市,　八德區,大同里,34,416,634,1084,6,1090,0,1090,364,1454,74.9656
第15任總統副總統,在桃園市各村(里),桃園市,　八德區,大慶里,53,384,575,1012,10,1022,0,1022,357,1379,74.1117
第15任總統副總統,在桃園市各村(里),桃園市,　八德區,大成里,99,966,1376,2441,24,2465,0,2465,719,3184,77.4183
第15任總統副總統,在桃園市各村(里),桃園市,　八德區,大義里,131,1196,1279,2606,30,2636,0,2636,947,3583,73.5696
第15任總統副總統,在桃園市各村(里),桃園市,　八德區,大忠里,54,577,634,1265,14,1279,0,1279,463,1742,73.4214
第15任總統副總統,在桃園市各村(里),桃園市,　八德區,大智里,140,1412,1417,2969,35,3004,0,3004,1003,4007,74.9688
第15任總統副總統,在桃園市各村(里),桃園市,　八德區,大宏里,132,1268,1562,2962,26,2988,0,2988,927,3915,76.3218
第15任總統副總統,在桃園市各村(里),桃園市,　八德區,大正里,147,1107,1579,2833,27,2860,0,2860,958,3818,74.9083
第15任總統副總統,在桃園市各村(里),桃園市,　八德區,大福里,189,1529,2157,3875,33,3908,0,3908,1064,4972,78.6002
第15任總統副總統,在桃園市各村(里),桃園市,　八德區,大強里,114,758,1425,2297,26,2323,0,2323,683,3006,77.2788
第15任總統副總統,在桃園市各村(里),桃園市,　八德區,大勇里,119,1134,1685,2938,33,2971,0,2971,905,3876,76.6512
第15任總統副總統,在桃園市各村(里),桃園市,　八德區,大榮里,74,552,782,1408,15,1423,0,1423,501,1924,73.9605
第15任總統副總統,在桃園市各村(里),桃園市,　八德區,大千里,80,740,771,1591,16,1607,0,1607,517,2124,75.6591
第15任總統副總統,在桃園市各村(里),桃園市,　八德區,大漢里,147,1194,1407,2748,24,2772,0,2772,1019,3791,73.1205
第15任總統副總統,在桃園市各村(里),桃園市,　龍潭區,黃唐里,167,1426,1665,3258,29,3287,0,3287,1168,4455,73.7823
第15任總統副總統,在桃園市各村(里),桃園市,　龍潭區,永興里,109,861,1013,1983,17,2000,0,2000,734,2734,73.1529
第15任總統副總統,在桃園市各村(里),桃園市,　龍潭區,中山里,193,1787,2001,3981,49,4030,0,4030,1518,5548,72.6388
第15任總統副總統,在桃園市各村(里),桃園市,　龍潭區,烏樹林里,97,698,1028,1823,29,1852,0,1852,605,2457,75.3765
第15任總統副總統,在桃園市各村(里),桃園市,　龍潭區,烏林里,129,1274,1383,2786,41,2827,0,2827,1162,3989,70.8699
第15任總統副總統,在桃園市各村(里),桃園市,　龍潭區,百年里,156,1796,1141,3093,25,3118,0,3118,933,4051,76.9686
第15任總統副總統,在桃園市各村(里),桃園市,　龍潭區,凌雲里,110,1133,1302,2545,29,2574,0,2574,1043,3617,71.1639
第15任總統副總統,在桃園市各村(里),桃園市,　龍潭區,龍祥里,109,1164,1196,2469,25,2494,0,2494,976,3470,71.8732
第15任總統副總統,在桃園市各村(里),桃園市,　龍潭區,八德里,145,1224,1593,2962,32,2994,0,2994,1073,4067,73.6169
第15任總統副總統,在桃園市各村(里),桃園市,　龍潭區,聖德里,86,800,1224,2110,20,2130,0,2130,815,2945,72.3260
第15任總統副總統,在桃園市各村(里),桃園市,　龍潭區,上林里,152,1262,1703,3117,36,3153,0,3153,1076,4229,74.5566
第15任總統副總統,在桃園市各村(里),桃園市,　龍潭區,龍潭里,56,601,784,1441,21,1462,0,1462,384,1846,79.1983
第15任總統副總統,在桃園市各村(里),桃園市,　龍潭區,龍星里,140,1381,1493,3014,37,3051,1,3052,887,3939,77.4562
第15任總統副總統,在桃園市各村(里),桃園市,　龍潭區,中正里,193,1887,1824,3904,45,3949,0,3949,1226,5175,76.3092
第15任總統副總統,在桃園市各村(里),桃園市,　龍潭區,上華里,113,1205,1041,2359,12,2371,0,2371,756,3127,75.8235
第15任總統副總統,在桃園市各村(里),桃園市,　龍潭區,九龍里,114,1250,1185,2549,31,2580,0,2580,966,3546,72.7580
第15任總統副總統,在桃園市各村(里),桃園市,　龍潭區,武漢里,51,547,469,1067,9,1076,0,1076,353,1429,75.2974
第15任總統副總統,在桃園市各村(里),桃園市,　龍潭區,祥和里,63,398,543,1004,9,1013,0,1013,424,1437,70.4941
第15任總統副總統,在桃園市各村(里),桃園市,　龍潭區,東興里,135,1554,1088,2777,28,2805,0,2805,1067,3872,72.4432
第15任總統副總統,在桃園市各村(里),桃園市,　龍潭區,中興里,149,1486,1333,2968,33,3001,0,3001,1128,4129,72.6810
第15任總統副總統,在桃園市各村(里),桃園市,　龍潭區,北興里,93,817,654,1564,17,1581,0,1581,706,2287,69.1299
第15任總統副總統,在桃園市各村(里),桃園市,　龍潭區,佳安里,117,1368,1085,2570,20,2590,0,2590,776,3366,76.9459
第15任總統副總統,在桃園市各村(里),桃園市,　龍潭區,三坑里,34,380,648,1062,4,1066,0,1066,399,1465,72.7645
第15任總統副總統,在桃園市各村(里),桃園市,　龍潭區,大平里,61,689,835,1585,12,1597,0,1597,604,2201,72.5579
第15任總統副總統,在桃園市各村(里),桃園市,　龍潭區,三林里,104,1171,1040,2315,24,2339,0,2339,615,2954,79.1808
第15任總統副總統,在桃園市各村(里),桃園市,　龍潭區,建林里,117,1621,1070,2808,25,2833,0,2833,769,3602,78.6507
第15任總統副總統,在桃園市各村(里),桃園市,　龍潭區,富林里,125,1358,1014,2497,28,2525,0,2525,832,3357,75.2160
第15任總統副總統,在桃園市各村(里),桃園市,　龍潭區,高平里,110,879,1289,2278,26,2304,0,2304,828,3132,73.5632
第15任總統副總統,在桃園市各村(里),桃園市,　龍潭區,高原里,149,1260,1699,3108,28,3136,0,3136,1178,4314,72.6936
第15任總統副總統,在桃園市各村(里),桃園市,　龍潭區,三和里,75,843,913,1831,25,1856,0,1856,507,2363,78.5442
第15任總統副總統,在桃園市各村(里),桃園市,　龍潭區,三水里,16,130,349,495,8,503,0,503,154,657,76.5601
第15任總統副總統,在桃園市各村(里),桃園市,　平鎮區,平鎮里,155,1202,1771,3128,31,3159,0,3159,1173,4332,72.9224
第15任總統副總統,在桃園市各村(里),桃園市,　平鎮區,鎮興里,104,766,1271,2141,23,2164,0,2164,771,2935,73.7308
第15任總統副總統,在桃園市各村(里),桃園市,　平鎮區,南勢里,217,1707,2257,4181,37,4218,0,4218,1390,5608,75.2140
第15任總統副總統,在桃園市各村(里),桃園市,　平鎮區,金星里,247,1774,2424,4445,48,4493,0,4493,1682,6175,72.7611
第15任總統副總統,在桃園市各村(里),桃園市,　平鎮區,平安里,182,1406,2040,3628,45,3673,0,3673,1215,4888,75.1432
第15任總統副總統,在桃園市各村(里),桃園市,　平鎮區,平南里,262,1920,2494,4676,41,4717,0,4717,1576,6293,74.9563
第15任總統副總統,在桃園市各村(里),桃園市,　平鎮區,山峰里,97,821,800,1718,20,1738,0,1738,567,2305,75.4013
第15任總統副總統,在桃園市各村(里),桃園市,　平鎮區,福林里,115,959,1344,2418,23,2441,0,2441,719,3160,77.2468
第15任總統副總統,在桃園市各村(里),桃園市,　平鎮區,湧光里,184,1723,1916,3823,39,3862,0,3862,1238,5100,75.7255
第15任總統副總統,在桃園市各村(里),桃園市,　平鎮區,莊敬里,151,1732,1386,3269,46,3315,0,3315,1037,4352,76.1719
第15任總統副總統,在桃園市各村(里),桃園市,　平鎮區,湧豐里,51,577,664,1292,12,1304,0,1304,444,1748,74.5995
第15任總統副總統,在桃園市各村(里),桃園市,　平鎮區,湧安里,152,1347,1573,3072,27,3099,0,3099,1136,4235,73.1759
第15任總統副總統,在桃園市各村(里),桃園市,　平鎮區,宋屋里,168,1190,1625,2983,25,3008,0,3008,1002,4010,75.0125
第15任總統副總統,在桃園市各村(里),桃園市,　平鎮區,平興里,219,1635,2033,3887,38,3925,0,3925,1273,5198,75.5098
第15任總統副總統,在桃園市各村(里),桃園市,　平鎮區,廣興里,181,1721,2291,4193,41,4234,0,4234,1108,5342,79.2587
第15任總統副總統,在桃園市各村(里),桃園市,　平鎮區,廣達里,103,999,1689,2791,37,2828,0,2828,875,3703,76.3705
第15任總統副總統,在桃園市各村(里),桃園市,　平鎮區,廣仁里,167,1219,1604,2990,26,3016,0,3016,1151,4167,72.3782
第15任總統副總統,在桃園市各村(里),桃園市,　平鎮區,復旦里,199,1625,2149,3973,31,4004,0,4004,1169,5173,77.4019
第15任總統副總統,在桃園市各村(里),桃園市,　平鎮區,復興里,206,1374,2145,3725,42,3767,4,3771,985,4756,79.2052
第15任總統副總統,在桃園市各村(里),桃園市,　平鎮區,義民里,199,1529,1952,3680,39,3719,0,3719,1248,4967,74.8742
第15任總統副總統,在桃園市各村(里),桃園市,　平鎮區,義興里,245,1910,2799,4954,61,5015,0,5015,1512,6527,76.8347
第15任總統副總統,在桃園市各村(里),桃園市,　平鎮區,雙連里,163,1434,1825,3422,34,3456,0,3456,1175,4631,74.6275
第15任總統副總統,在桃園市各村(里),桃園市,　平鎮區,高雙里,136,1124,1886,3146,30,3176,0,3176,899,4075,77.9387
第15任總統副總統,在桃園市各村(里),桃園市,　平鎮區,北勢里,76,753,1054,1883,25,1908,0,1908,495,2403,79.4007
第15任總統副總統,在桃園市各村(里),桃園市,　平鎮區,北華里,118,1253,1463,2834,38,2872,0,2872,805,3677,78.1072
第15任總統副總統,在桃園市各村(里),桃園市,　平鎮區,新勢里,131,1057,1503,2691,42,2733,0,2733,833,3566,76.6405
第15任總統副總統,在桃園市各村(里),桃園市,　平鎮區,北安里,56,434,684,1174,7,1181,0,1181,347,1528,77.2906
第15任總統副總統,在桃園市各村(里),桃園市,　平鎮區,新榮里,208,1544,2167,3919,41,3960,0,3960,1061,5021,78.8688
第15任總統副總統,在桃園市各村(里),桃園市,　平鎮區,新富里,188,1813,2055,4056,52,4108,0,4108,2267,6375,64.4392
第15任總統副總統,在桃園市各村(里),桃園市,　平鎮區,新英里,150,1243,1313,2706,36,2742,0,2742,868,3610,75.9557
第15任總統副總統,在桃園市各村(里),桃園市,　平鎮區,新貴里,106,857,1335,2298,32,2330,0,2330,679,3009,77.4344
第15任總統副總統,在桃園市各村(里),桃園市,　平鎮區,北興里,112,1130,1689,2931,48,2979,0,2979,845,3824,77.9027
第15任總統副總統,在桃園市各村(里),桃園市,　平鎮區,金陵里,116,885,1135,2136,30,2166,0,2166,591,2757,78.5637
第15任總統副總統,在桃園市各村(里),桃園市,　平鎮區,北貴里,138,1156,1711,3005,33,3038,0,3038,904,3942,77.0675
第15任總統副總統,在桃園市各村(里),桃園市,　平鎮區,北富里,142,1076,1660,2878,36,2914,0,2914,827,3741,77.8936
第15任總統副總統,在桃園市各村(里),桃園市,　平鎮區,建安里,153,1235,1731,3119,23,3142,0,3142,955,4097,76.6903
第15任總統副總統,在桃園市各村(里),桃園市,　平鎮區,華安里,148,1544,1257,2949,38,2987,0,2987,1087,4074,73.3186
第15任總統副總統,在桃園市各村(里),桃園市,　平鎮區,東安里,97,1022,881,2000,32,2032,0,2032,698,2730,74.4322
第15任總統副總統,在桃園市各村(里),桃園市,　平鎮區,新安里,162,1460,1511,3133,27,3160,0,3160,1091,4251,74.3355
第15任總統副總統,在桃園市各村(里),桃園市,　平鎮區,東勢里,172,1508,2217,3897,37,3934,0,3934,1309,5243,75.0334
第15任總統副總統,在桃園市各村(里),桃園市,　平鎮區,龍恩里,102,1058,835,1995,26,2021,0,2021,695,2716,74.4109
第15任總統副總統,在桃園市各村(里),桃園市,　平鎮區,東社里,105,1253,1055,2413,24,2437,0,2437,796,3233,75.3789
第15任總統副總統,在桃園市各村(里),桃園市,　平鎮區,忠貞里,45,531,318,894,10,904,0,904,264,1168,77.3973
第15任總統副總統,在桃園市各村(里),桃園市,　平鎮區,貿易里,83,846,561,1490,14,1504,0,1504,375,1879,80.0426
第15任總統副總統,在桃園市各村(里),桃園市,　平鎮區,龍興里,82,1110,684,1876,21,1897,0,1897,597,2494,76.0626
第15任總統副總統,在桃園市各村(里),桃園市,　平鎮區,中正里,44,738,415,1197,18,1215,0,1215,376,1591,76.3671
第15任總統副總統,在桃園市各村(里),桃園市,　新屋區,新屋里,102,834,1152,2088,25,2113,0,2113,665,2778,76.0619
第15任總統副總統,在桃園市各村(里),桃園市,　新屋區,新生里,148,1170,1678,2996,28,3024,0,3024,808,3832,78.9144
第15任總統副總統,在桃園市各村(里),桃園市,　新屋區,後湖里,55,393,704,1152,16,1168,0,1168,330,1498,77.9706
第15任總統副總統,在桃園市各村(里),桃園市,　新屋區,清華里,128,1116,1671,2915,30,2945,0,2945,924,3869,76.1179
第15任總統副總統,在桃園市各村(里),桃園市,　新屋區,石磊里,60,515,933,1508,14,1522,0,1522,467,1989,76.5209
第15任總統副總統,在桃園市各村(里),桃園市,　新屋區,東明里,39,409,644,1092,17,1109,0,1109,305,1414,78.4300
第15任總統副總統,在桃園市各村(里),桃園市,　新屋區,社子里,39,306,699,1044,6,1050,0,1050,288,1338,78.4753
第15任總統副總統,在桃園市各村(里),桃園市,　新屋區,埔頂里,106,657,1075,1838,17,1855,0,1855,582,2437,76.1182
第15任總統副總統,在桃園市各村(里),桃園市,　新屋區,九斗里,77,550,1054,1681,18,1699,0,1699,530,2229,76.2225
第15任總統副總統,在桃園市各村(里),桃園市,　新屋區,頭洲里,141,1076,1839,3056,34,3090,0,3090,1017,4107,75.2374
第15任總統副總統,在桃園市各村(里),桃園市,　新屋區,大坡里,39,290,620,949,8,957,0,957,301,1258,76.0731
第15任總統副總統,在桃園市各村(里),桃園市,　新屋區,望間里,35,299,698,1032,7,1039,0,1039,316,1355,76.6790
第15任總統副總統,在桃園市各村(里),桃園市,　新屋區,後庄里,42,347,427,816,11,827,0,827,244,1071,77.2176
第15任總統副總統,在桃園市各村(里),桃園市,　新屋區,蚵間里,38,191,428,657,6,663,0,663,226,889,74.5782
第15任總統副總統,在桃園市各村(里),桃園市,　新屋區,深圳里,20,170,283,473,6,479,0,479,156,635,75.4331
第15任總統副總統,在桃園市各村(里),桃園市,　新屋區,槺榔里,27,234,484,745,10,755,0,755,278,1033,73.0881
第15任總統副總統,在桃園市各村(里),桃園市,　新屋區,笨港里,34,293,468,795,13,808,0,808,215,1023,78.9834
第15任總統副總統,在桃園市各村(里),桃園市,　新屋區,永安里,71,582,1010,1663,19,1682,0,1682,519,2201,76.4198
第15任總統副總統,在桃園市各村(里),桃園市,　新屋區,永興里,40,213,480,733,7,740,0,740,251,991,74.6720
第15任總統副總統,在桃園市各村(里),桃園市,　新屋區,下埔里,22,195,344,561,6,567,0,567,136,703,80.6543
第15任總統副總統,在桃園市各村(里),桃園市,　新屋區,石牌里,32,240,427,699,19,718,0,718,184,902,79.6009
第15任總統副總統,在桃園市各村(里),桃園市,　新屋區,下田里,52,451,741,1244,12,1256,0,1256,419,1675,74.9851
第15任總統副總統,在桃園市各村(里),桃園市,　新屋區,赤欄里,45,360,578,983,10,993,0,993,305,1298,76.5023
第15任總統副總統,在桃園市各村(里),桃園市,　觀音區,觀音里,82,642,1106,1830,20,1850,0,1850,774,2624,70.5030
第15任總統副總統,在桃園市各村(里),桃園市,　觀音區,白玉里,40,275,384,699,9,708,0,708,201,909,77.8878
第15任總統副總統,在桃園市各村(里),桃園市,　觀音區,廣興里,43,348,564,955,10,965,0,965,334,1299,74.2879
第15任總統副總統,在桃園市各村(里),桃園市,　觀音區,大潭里,74,401,770,1245,12,1257,0,1257,468,1725,72.8696
第15任總統副總統,在桃園市各村(里),桃園市,　觀音區,保生里,57,510,946,1513,13,1526,0,1526,550,2076,73.5067
第15任總統副總統,在桃園市各村(里),桃園市,　觀音區,武威里,25,197,424,646,6,652,0,652,213,865,75.3757
第15任總統副總統,在桃園市各村(里),桃園市,　觀音區,三和里,28,183,413,624,8,632,0,632,189,821,76.9793
第15任總統副總統,在桃園市各村(里),桃園市,　觀音區,新興里,21,179,340,540,4,544,0,544,153,697,78.0488
第15任總統副總統,在桃園市各村(里),桃園市,　觀音區,坑尾里,48,376,686,1110,14,1124,0,1124,502,1626,69.1267
第15任總統副總統,在桃園市各村(里),桃園市,　觀音區,金湖里,97,563,1182,1842,20,1862,0,1862,687,2549,73.0483
第15任總統副總統,在桃園市各村(里),桃園市,　觀音區,藍埔里,103,506,1200,1809,22,1831,0,1831,626,2457,74.5218
第15任總統副總統,在桃園市各村(里),桃園市,　觀音區,大同里,82,605,1516,2203,12,2215,0,2215,757,2972,74.5289
第15任總統副總統,在桃園市各村(里),桃園市,　觀音區,大堀里,57,271,716,1044,10,1054,0,1054,374,1428,73.8095
第15任總統副總統,在桃園市各村(里),桃園市,　觀音區,崙坪里,164,965,2343,3472,37,3509,0,3509,1102,4611,76.1006
第15任總統副總統,在桃園市各村(里),桃園市,　觀音區,富源里,129,965,1631,2725,37,2762,0,2762,900,3662,75.4233
第15任總統副總統,在桃園市各村(里),桃園市,　觀音區,上大里,88,579,1101,1768,19,1787,0,1787,553,2340,76.3675
第15任總統副總統,在桃園市各村(里),桃園市,　觀音區,新坡里,91,590,1467,2148,17,2165,0,2165,730,2895,74.7841
第15任總統副總統,在桃園市各村(里),桃園市,　觀音區,廣福里,104,455,1269,1828,16,1844,0,1844,570,2414,76.3877
第15任總統副總統,在桃園市各村(里),桃園市,　觀音區,塔腳里,46,215,495,756,7,763,0,763,272,1035,73.7198
第15任總統副總統,在桃園市各村(里),桃園市,　觀音區,保障里,64,361,973,1398,23,1421,0,1421,470,1891,75.1454
第15任總統副總統,在桃園市各村(里),桃園市,　觀音區,草漯里,70,443,1079,1592,13,1605,0,1605,631,2236,71.7800
第15任總統副總統,在桃園市各村(里),桃園市,　觀音區,草新里,209,1244,2349,3802,42,3844,0,3844,1453,5297,72.5694
第15任總統副總統,在桃園市各村(里),桃園市,　觀音區,樹林里,127,849,1512,2488,40,2528,0,2528,1391,3919,64.5063
第15任總統副總統,在桃園市各村(里),桃園市,　觀音區,富林里,64,384,870,1318,9,1327,0,1327,498,1825,72.7123
第15任總統副總統,在桃園市各村(里),桃園市,　復興區,三民里,53,666,646,1365,20,1385,0,1385,598,1983,69.8437
第15任總統副總統,在桃園市各村(里),桃園市,　復興區,澤仁里,39,588,286,913,9,922,0,922,446,1368,67.3977
第15任總統副總統,在桃園市各村(里),桃園市,　復興區,霞雲里,17,272,94,383,1,384,0,384,188,572,67.1329
第15任總統副總統,在桃園市各村(里),桃園市,　復興區,義盛里,14,375,88,477,4,481,0,481,222,703,68.4211
第15任總統副總統,在桃園市各村(里),桃園市,　復興區,羅浮里,29,423,221,673,5,678,0,678,318,996,68.0723
第15任總統副總統,在桃園市各村(里),桃園市,　復興區,長興里,11,256,126,393,4,397,0,397,259,656,60.5183
第15任總統副總統,在桃園市各村(里),桃園市,　復興區,奎輝里,14,377,104,495,5,500,0,500,238,738,67.7507
第15任總統副總統,在桃園市各村(里),桃園市,　復興區,高義里,18,292,115,425,2,427,0,427,278,705,60.5674
第15任總統副總統,在桃園市各村(里),桃園市,　復興區,三光里,16,333,95,444,3,447,0,447,229,676,66.1243
第15任總統副總統,在桃園市各村(里),桃園市,　復興區,華陵里,22,461,263,746,1,747,0,747,450,1197,62.4060
第15任總統副總統,在花蓮縣各村(里),花蓮縣,　花蓮市,民德里,46,631,446,1123,13,1136,0,1136,342,1478,76.8606
第15任總統副總統,在花蓮縣各村(里),花蓮縣,　花蓮市,民勤里,94,1400,779,2273,21,2294,0,2294,729,3023,75.8849
第15任總統副總統,在花蓮縣各村(里),花蓮縣,　花蓮市,民意里,53,975,338,1366,16,1382,0,1382,579,1961,70.4742
第15任總統副總統,在花蓮縣各村(里),花蓮縣,　花蓮市,民心里,25,376,252,653,5,658,0,658,238,896,73.4375
第15任總統副總統,在花蓮縣各村(里),花蓮縣,　花蓮市,民享里,90,1336,690,2116,14,2130,0,2130,764,2894,73.6006
第15任總統副總統,在花蓮縣各村(里),花蓮縣,　花蓮市,民孝里,139,1615,752,2506,27,2533,1,2534,876,3410,74.2815
第15任總統副總統,在花蓮縣各村(里),花蓮縣,　花蓮市,民運里,62,799,537,1398,15,1413,0,1413,543,1956,72.2393
第15任總統副總統,在花蓮縣各村(里),花蓮縣,　花蓮市,民政里,85,1584,955,2624,23,2647,0,2647,855,3502,75.5854
第15任總統副總統,在花蓮縣各村(里),花蓮縣,　花蓮市,民立里,53,580,417,1050,14,1064,0,1064,436,1500,70.9333
第15任總統副總統,在花蓮縣各村(里),花蓮縣,　花蓮市,民樂里,16,247,173,436,3,439,0,439,155,594,73.9057
第15任總統副總統,在花蓮縣各村(里),花蓮縣,　花蓮市,民有里,18,220,198,436,5,441,0,441,158,599,73.6227
第15任總統副總統,在花蓮縣各村(里),花蓮縣,　花蓮市,民主里,16,241,145,402,3,405,0,405,157,562,72.0641
第15任總統副總統,在花蓮縣各村(里),花蓮縣,　花蓮市,民族里,12,181,137,330,1,331,0,331,112,443,74.7178
第15任總統副總統,在花蓮縣各村(里),花蓮縣,　花蓮市,民生里,29,393,353,775,8,783,0,783,298,1081,72.4329
第15任總統副總統,在花蓮縣各村(里),花蓮縣,　花蓮市,民權里,10,169,103,282,3,285,0,285,109,394,72.3350
第15任總統副總統,在花蓮縣各村(里),花蓮縣,　花蓮市,主商里,17,203,205,425,5,430,0,430,130,560,76.7857
第15任總統副總統,在花蓮縣各村(里),花蓮縣,　花蓮市,主勤里,25,287,266,578,5,583,0,583,212,795,73.3333
第15任總統副總統,在花蓮縣各村(里),花蓮縣,　花蓮市,主工里,18,204,172,394,8,402,0,402,115,517,77.7563
第15任總統副總統,在花蓮縣各村(里),花蓮縣,　花蓮市,主信里,17,213,193,423,9,432,0,432,153,585,73.8462
第15任總統副總統,在花蓮縣各村(里),花蓮縣,　花蓮市,主義里,15,191,137,343,4,347,0,347,96,443,78.3296
第15任總統副總統,在花蓮縣各村(里),花蓮縣,　花蓮市,主睦里,19,195,175,389,1,390,0,390,149,539,72.3562
第15任總統副總統,在花蓮縣各村(里),花蓮縣,　花蓮市,主計里,17,291,222,530,10,540,0,540,234,774,69.7674
第15任總統副總統,在花蓮縣各村(里),花蓮縣,　花蓮市,主和里,91,1121,904,2116,22,2138,2,2140,741,2881,74.2103
第15任總統副總統,在花蓮縣各村(里),花蓮縣,　花蓮市,主學里,56,693,556,1305,10,1315,0,1315,473,1788,73.5459
第15任總統副總統,在花蓮縣各村(里),花蓮縣,　花蓮市,主農里,103,1374,1035,2512,30,2542,0,2542,853,3395,74.8748
第15任總統副總統,在花蓮縣各村(里),花蓮縣,　花蓮市,主安里,80,966,659,1705,15,1720,1,1721,659,2380,72.2689
第15任總統副總統,在花蓮縣各村(里),花蓮縣,　花蓮市,主權里,159,2070,1445,3674,34,3708,0,3708,1353,5061,73.2662
第15任總統副總統,在花蓮縣各村(里),花蓮縣,　花蓮市,主力里,88,991,832,1911,21,1932,0,1932,679,2611,73.9946
第15任總統副總統,在花蓮縣各村(里),花蓮縣,　花蓮市,國風里,95,1282,948,2325,24,2349,0,2349,783,3132,75.0000
第15任總統副總統,在花蓮縣各村(里),花蓮縣,　花蓮市,國威里,35,530,465,1030,15,1045,0,1045,697,1742,59.9885
第15任總統副總統,在花蓮縣各村(里),花蓮縣,　花蓮市,國治里,20,348,246,614,8,622,0,622,219,841,73.9596
第15任總統副總統,在花蓮縣各村(里),花蓮縣,　花蓮市,國安里,24,243,169,436,2,438,0,438,107,545,80.3670
第15任總統副總統,在花蓮縣各村(里),花蓮縣,　花蓮市,國光里,32,451,347,830,11,841,0,841,341,1182,71.1506
第15任總統副總統,在花蓮縣各村(里),花蓮縣,　花蓮市,國防里,23,312,238,573,8,581,0,581,217,798,72.8070
第15任總統副總統,在花蓮縣各村(里),花蓮縣,　花蓮市,國華里,58,875,697,1630,23,1653,0,1653,485,2138,77.3152
第15任總統副總統,在花蓮縣各村(里),花蓮縣,　花蓮市,國魂里,47,711,581,1339,20,1359,0,1359,495,1854,73.3010
第15任總統副總統,在花蓮縣各村(里),花蓮縣,　花蓮市,國聯里,53,1029,834,1916,17,1933,0,1933,763,2696,71.6988
第15任總統副總統,在花蓮縣各村(里),花蓮縣,　花蓮市,國盛里,92,1394,957,2443,29,2472,0,2472,1149,3621,68.2684
第15任總統副總統,在花蓮縣各村(里),花蓮縣,　花蓮市,國強里,45,706,471,1222,18,1240,0,1240,437,1677,73.9416
第15任總統副總統,在花蓮縣各村(里),花蓮縣,　花蓮市,國富里,140,1956,1436,3532,32,3564,0,3564,1337,4901,72.7199
第15任總統副總統,在花蓮縣各村(里),花蓮縣,　花蓮市,國裕里,99,1721,1123,2943,46,2989,0,2989,1101,4090,73.0807
第15任總統副總統,在花蓮縣各村(里),花蓮縣,　花蓮市,國慶里,26,410,359,795,9,804,0,804,244,1048,76.7176
第15任總統副總統,在花蓮縣各村(里),花蓮縣,　花蓮市,國興里,116,1706,1081,2903,25,2928,0,2928,1054,3982,73.5309
第15任總統副總統,在花蓮縣各村(里),花蓮縣,　花蓮市,國福里,45,576,344,965,7,972,0,972,479,1451,66.9883
第15任總統副總統,在花蓮縣各村(里),花蓮縣,　鳳林鎮,鳳仁里,31,492,292,815,9,824,0,824,318,1142,72.1541
第15任總統副總統,在花蓮縣各村(里),花蓮縣,　鳳林鎮,鳳義里,15,295,124,434,6,440,0,440,179,619,71.0824
第15任總統副總統,在花蓮縣各村(里),花蓮縣,　鳳林鎮,鳳禮里,6,264,164,434,6,440,0,440,144,584,75.3425
第15任總統副總統,在花蓮縣各村(里),花蓮縣,　鳳林鎮,鳳智里,24,501,259,784,12,796,0,796,294,1090,73.0275
第15任總統副總統,在花蓮縣各村(里),花蓮縣,　鳳林鎮,鳳信里,31,597,263,891,6,897,0,897,406,1303,68.8411
第15任總統副總統,在花蓮縣各村(里),花蓮縣,　鳳林鎮,山興里,15,238,95,348,3,351,0,351,173,524,66.9847
第15任總統副總統,在花蓮縣各村(里),花蓮縣,　鳳林鎮,大榮里,29,469,330,828,9,837,0,837,375,1212,69.0594
第15任總統副總統,在花蓮縣各村(里),花蓮縣,　鳳林鎮,北林里,11,198,176,385,4,389,0,389,132,521,74.6641
第15任總統副總統,在花蓮縣各村(里),花蓮縣,　鳳林鎮,南平里,12,203,149,364,2,366,0,366,160,526,69.5817
第15任總統副總統,在花蓮縣各村(里),花蓮縣,　鳳林鎮,林榮里,22,363,183,568,12,580,0,580,205,785,73.8854
第15任總統副總統,在花蓮縣各村(里),花蓮縣,　鳳林鎮,長橋里,24,367,234,625,4,629,0,629,320,949,66.2803
第15任總統副總統,在花蓮縣各村(里),花蓮縣,　鳳林鎮,森榮里,1,57,11,69,0,69,0,69,26,95,72.6316
第15任總統副總統,在花蓮縣各村(里),花蓮縣,　玉里鎮,中城里,99,1928,1290,3317,37,3354,0,3354,1596,4950,67.7576
第15任總統副總統,在花蓮縣各村(里),花蓮縣,　玉里鎮,國武里,24,455,322,801,9,810,0,810,354,1164,69.5876
第15任總統副總統,在花蓮縣各村(里),花蓮縣,　玉里鎮,啟模里,37,588,347,972,11,983,0,983,573,1556,63.1748
第15任總統副總統,在花蓮縣各村(里),花蓮縣,　玉里鎮,泰昌里,25,419,192,636,3,639,0,639,666,1305,48.9655
第15任總統副總統,在花蓮縣各村(里),花蓮縣,　玉里鎮,永昌里,31,450,211,692,12,704,0,704,519,1223,57.5634
第15任總統副總統,在花蓮縣各村(里),花蓮縣,　玉里鎮,源城里,27,444,271,742,7,749,0,749,448,1197,62.5731
第15任總統副總統,在花蓮縣各村(里),花蓮縣,　玉里鎮,長良里,23,226,101,350,4,354,0,354,267,621,57.0048
第15任總統副總統,在花蓮縣各村(里),花蓮縣,　玉里鎮,樂合里,21,406,100,527,7,534,0,534,433,967,55.2223
第15任總統副總統,在花蓮縣各村(里),花蓮縣,　玉里鎮,東豐里,11,209,79,299,3,302,0,302,199,501,60.2794
第15任總統副總統,在花蓮縣各村(里),花蓮縣,　玉里鎮,觀音里,22,562,236,820,9,829,0,829,647,1476,56.1653
第15任總統副總統,在花蓮縣各村(里),花蓮縣,　玉里鎮,松浦里,33,505,175,713,9,722,0,722,719,1441,50.1041
第15任總統副總統,在花蓮縣各村(里),花蓮縣,　玉里鎮,春日里,12,334,139,485,9,494,0,494,342,836,59.0909
第15任總統副總統,在花蓮縣各村(里),花蓮縣,　玉里鎮,德武里,9,350,59,418,8,426,0,426,317,743,57.3351
第15任總統副總統,在花蓮縣各村(里),花蓮縣,　玉里鎮,三民里,19,274,217,510,6,516,0,516,315,831,62.0939
第15任總統副總統,在花蓮縣各村(里),花蓮縣,　玉里鎮,大禹里,17,400,197,614,4,618,0,618,415,1033,59.8258
第15任總統副總統,在花蓮縣各村(里),花蓮縣,　新城鄉,新城村,34,514,377,925,12,937,0,937,312,1249,75.0200
第15任總統副總統,在花蓮縣各村(里),花蓮縣,　新城鄉,順安村,20,250,353,623,5,628,0,628,266,894,70.2461
第15任總統副總統,在花蓮縣各村(里),花蓮縣,　新城鄉,康樂村,50,1027,596,1673,14,1687,0,1687,656,2343,72.0017
第15任總統副總統,在花蓮縣各村(里),花蓮縣,　新城鄉,大漢村,75,1171,471,1717,17,1734,0,1734,720,2454,70.6601
第15任總統副總統,在花蓮縣各村(里),花蓮縣,　新城鄉,北埔村,101,1611,909,2621,32,2653,0,2653,1255,3908,67.8864
第15任總統副總統,在花蓮縣各村(里),花蓮縣,　新城鄉,佳林村,22,425,236,683,5,688,0,688,276,964,71.3693
第15任總統副總統,在花蓮縣各村(里),花蓮縣,　新城鄉,嘉里村,119,1563,856,2538,36,2574,0,2574,1080,3654,70.4433
第15任總統副總統,在花蓮縣各村(里),花蓮縣,　新城鄉,嘉新村,30,569,206,805,12,817,0,817,383,1200,68.0833
第15任總統副總統,在花蓮縣各村(里),花蓮縣,　吉安鄉,永安村,116,1663,1179,2958,34,2992,0,2992,1108,4100,72.9756
第15任總統副總統,在花蓮縣各村(里),花蓮縣,　吉安鄉,太昌村,88,1351,1046,2485,25,2510,0,2510,1134,3644,68.8804
第15任總統副總統,在花蓮縣各村(里),花蓮縣,　吉安鄉,慶豐村,205,2685,1981,4871,52,4923,0,4923,1769,6692,73.5655
第15任總統副總統,在花蓮縣各村(里),花蓮縣,　吉安鄉,吉安村,171,2113,1388,3672,42,3714,0,3714,1486,5200,71.4231
第15任總統副總統,在花蓮縣各村(里),花蓮縣,　吉安鄉,福興村,88,1086,916,2090,34,2124,0,2124,740,2864,74.1620
第15任總統副總統,在花蓮縣各村(里),花蓮縣,　吉安鄉,南華村,35,573,472,1080,17,1097,0,1097,428,1525,71.9344
第15任總統副總統,在花蓮縣各村(里),花蓮縣,　吉安鄉,干城村,21,521,184,726,8,734,0,734,527,1261,58.2078
第15任總統副總統,在花蓮縣各村(里),花蓮縣,　吉安鄉,永興村,74,1175,666,1915,18,1933,0,1933,845,2778,69.5824
第15任總統副總統,在花蓮縣各村(里),花蓮縣,　吉安鄉,稻香村,99,1309,819,2227,23,2250,1,2251,806,3057,73.6016
第15任總統副總統,在花蓮縣各村(里),花蓮縣,　吉安鄉,南昌村,102,1707,984,2793,27,2820,0,2820,1179,3999,70.5176
第15任總統副總統,在花蓮縣各村(里),花蓮縣,　吉安鄉,宜昌村,96,1577,1065,2738,29,2767,0,2767,1060,3827,72.3021
第15任總統副總統,在花蓮縣各村(里),花蓮縣,　吉安鄉,北昌村,180,2808,2145,5133,54,5187,0,5187,1766,6953,74.6009
第15任總統副總統,在花蓮縣各村(里),花蓮縣,　吉安鄉,勝安村,128,1904,1507,3539,32,3571,0,3571,1209,4780,74.7071
第15任總統副總統,在花蓮縣各村(里),花蓮縣,　吉安鄉,仁里村,144,2602,1538,4284,37,4321,0,4321,1563,5884,73.4364
第15任總統副總統,在花蓮縣各村(里),花蓮縣,　吉安鄉,東昌村,130,2349,1360,3839,39,3878,0,3878,1436,5314,72.9770
第15任總統副總統,在花蓮縣各村(里),花蓮縣,　吉安鄉,仁安村,56,877,621,1554,10,1564,0,1564,708,2272,68.8380
第15任總統副總統,在花蓮縣各村(里),花蓮縣,　吉安鄉,仁和村,119,1766,1072,2957,37,2994,0,2994,1354,4348,68.8592
第15任總統副總統,在花蓮縣各村(里),花蓮縣,　吉安鄉,光華村,48,891,375,1314,15,1329,0,1329,555,1884,70.5414
第15任總統副總統,在花蓮縣各村(里),花蓮縣,　壽豐鄉,溪口村,23,428,214,665,9,674,0,674,353,1027,65.6280
第15任總統副總統,在花蓮縣各村(里),花蓮縣,　壽豐鄉,樹湖村,11,142,90,243,5,248,0,248,101,349,71.0602
第15任總統副總統,在花蓮縣各村(里),花蓮縣,　壽豐鄉,豐山村,43,688,474,1205,16,1221,0,1221,613,1834,66.5758
第15任總統副總統,在花蓮縣各村(里),花蓮縣,　壽豐鄉,豐裡村,31,550,333,914,19,933,0,933,423,1356,68.8053
第15任總統副總統,在花蓮縣各村(里),花蓮縣,　壽豐鄉,豐坪村,24,362,186,572,7,579,0,579,272,851,68.0376
第15任總統副總統,在花蓮縣各村(里),花蓮縣,　壽豐鄉,壽豐村,33,620,430,1083,14,1097,0,1097,505,1602,68.4769
第15任總統副總統,在花蓮縣各村(里),花蓮縣,　壽豐鄉,共和村,15,305,199,519,6,525,0,525,178,703,74.6799
第15任總統副總統,在花蓮縣各村(里),花蓮縣,　壽豐鄉,光榮村,13,412,146,571,3,574,0,574,208,782,73.4015
第15任總統副總統,在花蓮縣各村(里),花蓮縣,　壽豐鄉,池南村,16,310,200,526,8,534,0,534,217,751,71.1052
第15任總統副總統,在花蓮縣各村(里),花蓮縣,　壽豐鄉,平和村,36,542,394,972,12,984,0,984,412,1396,70.4871
第15任總統副總統,在花蓮縣各村(里),花蓮縣,　壽豐鄉,志學村,53,926,763,1742,33,1775,0,1775,715,2490,71.2851
第15任總統副總統,在花蓮縣各村(里),花蓮縣,　壽豐鄉,米棧村,2,118,59,179,3,182,0,182,86,268,67.9104
第15任總統副總統,在花蓮縣各村(里),花蓮縣,　壽豐鄉,月眉村,19,390,114,523,6,529,0,529,271,800,66.1250
第15任總統副總統,在花蓮縣各村(里),花蓮縣,　壽豐鄉,鹽寮村,15,219,104,338,1,339,0,339,161,500,67.8000
第15任總統副總統,在花蓮縣各村(里),花蓮縣,　壽豐鄉,水璉村,15,321,134,470,5,475,0,475,244,719,66.0640
第15任總統副總統,在花蓮縣各村(里),花蓮縣,　光復鄉,大華村,25,482,329,836,12,848,0,848,405,1253,67.6776
第15任總統副總統,在花蓮縣各村(里),花蓮縣,　光復鄉,大安村,20,335,234,589,0,589,1,590,234,824,71.4806
第15任總統副總統,在花蓮縣各村(里),花蓮縣,　光復鄉,大平村,14,411,159,584,6,590,0,590,330,920,64.1304
第15任總統副總統,在花蓮縣各村(里),花蓮縣,　光復鄉,大馬村,28,443,125,596,10,606,0,606,360,966,62.7329
第15任總統副總統,在花蓮縣各村(里),花蓮縣,　光復鄉,大同村,16,406,224,646,8,654,0,654,345,999,65.4655
第15任總統副總統,在花蓮縣各村(里),花蓮縣,　光復鄉,東富村,16,474,102,592,6,598,0,598,378,976,61.2705
第15任總統副總統,在花蓮縣各村(里),花蓮縣,　光復鄉,西富村,14,426,147,587,5,592,0,592,340,932,63.5193
第15任總統副總統,在花蓮縣各村(里),花蓮縣,　光復鄉,南富村,16,390,128,534,1,535,0,535,297,832,64.3029
第15任總統副總統,在花蓮縣各村(里),花蓮縣,　光復鄉,北富村,11,447,114,572,3,575,0,575,317,892,64.4619
第15任總統副總統,在花蓮縣各村(里),花蓮縣,　光復鄉,大進村,8,200,101,309,2,311,0,311,143,454,68.5022
第15任總統副總統,在花蓮縣各村(里),花蓮縣,　光復鄉,大全村,18,284,165,467,4,471,0,471,274,745,63.2215
第15任總統副總統,在花蓮縣各村(里),花蓮縣,　光復鄉,大興村,8,197,62,267,2,269,0,269,189,458,58.7336
第15任總統副總統,在花蓮縣各村(里),花蓮縣,　光復鄉,大富村,10,99,79,188,0,188,0,188,121,309,60.8414
第15任總統副總統,在花蓮縣各村(里),花蓮縣,　光復鄉,大豐村,5,147,99,251,2,253,0,253,186,439,57.6310
第15任總統副總統,在花蓮縣各村(里),花蓮縣,　豐濱鄉,靜浦村,8,278,63,349,3,352,0,352,317,669,52.6158
第15任總統副總統,在花蓮縣各村(里),花蓮縣,　豐濱鄉,港口村,11,289,150,450,6,456,0,456,260,716,63.6872
第15任總統副總統,在花蓮縣各村(里),花蓮縣,　豐濱鄉,豐濱村,30,684,219,933,15,948,0,948,677,1625,58.3385
第15任總統副總統,在花蓮縣各村(里),花蓮縣,　豐濱鄉,新社村,5,224,83,312,6,318,0,318,294,612,51.9608
第15任總統副總統,在花蓮縣各村(里),花蓮縣,　豐濱鄉,磯崎村,7,172,46,225,2,227,0,227,187,414,54.8309
第15任總統副總統,在花蓮縣各村(里),花蓮縣,　瑞穗鄉,瑞穗村,35,704,440,1179,10,1189,0,1189,650,1839,64.6547
第15任總統副總統,在花蓮縣各村(里),花蓮縣,　瑞穗鄉,瑞美村,38,709,418,1165,11,1176,0,1176,568,1744,67.4312
第15任總統副總統,在花蓮縣各村(里),花蓮縣,　瑞穗鄉,瑞良村,17,206,129,352,3,355,0,355,175,530,66.9811
第15任總統副總統,在花蓮縣各村(里),花蓮縣,　瑞穗鄉,瑞祥村,28,357,221,606,11,617,0,617,322,939,65.7082
第15任總統副總統,在花蓮縣各村(里),花蓮縣,　瑞穗鄉,瑞北村,8,221,99,328,3,331,0,331,235,566,58.4806
第15任總統副總統,在花蓮縣各村(里),花蓮縣,　瑞穗鄉,舞鶴村,17,380,168,565,7,572,0,572,349,921,62.1064
第15任總統副總統,在花蓮縣各村(里),花蓮縣,　瑞穗鄉,鶴岡村,24,349,109,482,6,488,0,488,360,848,57.5472
第15任總統副總統,在花蓮縣各村(里),花蓮縣,　瑞穗鄉,奇美村,3,118,31,152,2,154,0,154,174,328,46.9512
第15任總統副總統,在花蓮縣各村(里),花蓮縣,　瑞穗鄉,富源村,17,270,149,436,12,448,0,448,284,732,61.2022
第15任總統副總統,在花蓮縣各村(里),花蓮縣,　瑞穗鄉,富民村,14,345,95,454,8,462,0,462,363,825,56.0000
第15任總統副總統,在花蓮縣各村(里),花蓮縣,　瑞穗鄉,富興村,10,197,139,346,9,355,0,355,231,586,60.5802
第15任總統副總統,在花蓮縣各村(里),花蓮縣,　富里鄉,吳江村,16,165,76,257,6,263,0,263,199,462,56.9264
第15任總統副總統,在花蓮縣各村(里),花蓮縣,　富里鄉,東里村,38,277,195,510,9,519,0,519,477,996,52.1084
第15任總統副總統,在花蓮縣各村(里),花蓮縣,　富里鄉,萬寧村,15,241,83,339,5,344,0,344,282,626,54.9521
第15任總統副總統,在花蓮縣各村(里),花蓮縣,　富里鄉,新興村,10,184,97,291,7,298,0,298,277,575,51.8261
第15任總統副總統,在花蓮縣各村(里),花蓮縣,　富里鄉,竹田村,20,453,186,659,5,664,0,664,363,1027,64.6543
第15任總統副總統,在花蓮縣各村(里),花蓮縣,　富里鄉,羅山村,17,150,82,249,5,254,0,254,168,422,60.1896
第15任總統副總統,在花蓮縣各村(里),花蓮縣,　富里鄉,石牌村,26,306,202,534,5,539,0,539,321,860,62.6744
第15任總統副總統,在花蓮縣各村(里),花蓮縣,　富里鄉,明里村,10,137,67,214,3,217,0,217,127,344,63.0814
第15任總統副總統,在花蓮縣各村(里),花蓮縣,　富里鄉,富里村,32,465,306,803,7,810,0,810,492,1302,62.2120
第15任總統副總統,在花蓮縣各村(里),花蓮縣,　富里鄉,永豐村,7,151,98,256,4,260,0,260,172,432,60.1852
第15任總統副總統,在花蓮縣各村(里),花蓮縣,　富里鄉,豐南村,12,238,80,330,3,333,0,333,269,602,55.3156
第15任總統副總統,在花蓮縣各村(里),花蓮縣,　富里鄉,富南村,10,160,108,278,3,281,0,281,207,488,57.5820
第15任總統副總統,在花蓮縣各村(里),花蓮縣,　富里鄉,學田村,15,214,160,389,9,398,0,398,210,608,65.4605
第15任總統副總統,在花蓮縣各村(里),花蓮縣,　秀林鄉,和平村,42,616,304,962,9,971,0,971,426,1397,69.5061
第15任總統副總統,在花蓮縣各村(里),花蓮縣,　秀林鄉,崇德村,36,695,172,903,10,913,0,913,420,1333,68.4921
第15任總統副總統,在花蓮縣各村(里),花蓮縣,　秀林鄉,富世村,35,782,349,1166,13,1179,0,1179,565,1744,67.6032
第15任總統副總統,在花蓮縣各村(里),花蓮縣,　秀林鄉,秀林村,30,779,328,1137,20,1157,0,1157,550,1707,67.7797
第15任總統副總統,在花蓮縣各村(里),花蓮縣,　秀林鄉,景美村,39,724,362,1125,19,1144,0,1144,516,1660,68.9157
第15任總統副總統,在花蓮縣各村(里),花蓮縣,　秀林鄉,佳民村,9,529,129,667,8,675,0,675,287,962,70.1663
第15任總統副總統,在花蓮縣各村(里),花蓮縣,　秀林鄉,水源村,23,607,175,805,10,815,0,815,296,1111,73.3573
第15任總統副總統,在花蓮縣各村(里),花蓮縣,　秀林鄉,銅門村,25,637,156,818,9,827,0,827,343,1170,70.6838
第15任總統副總統,在花蓮縣各村(里),花蓮縣,　秀林鄉,文蘭村,18,569,180,767,10,777,0,777,270,1047,74.2120
第15任總統副總統,在花蓮縣各村(里),花蓮縣,　萬榮鄉,西林村,18,534,152,704,4,708,0,708,333,1041,68.0115
第15任總統副總統,在花蓮縣各村(里),花蓮縣,　萬榮鄉,見晴村,8,242,73,323,8,331,0,331,187,518,63.8996
第15任總統副總統,在花蓮縣各村(里),花蓮縣,　萬榮鄉,萬榮村,11,392,105,508,3,511,0,511,232,743,68.7752
第15任總統副總統,在花蓮縣各村(里),花蓮縣,　萬榮鄉,明利村,10,300,90,400,1,401,0,401,231,632,63.4494
第15任總統副總統,在花蓮縣各村(里),花蓮縣,　萬榮鄉,馬遠村,24,455,154,633,6,639,0,639,424,1063,60.1129
第15任總統副總統,在花蓮縣各村(里),花蓮縣,　萬榮鄉,紅葉村,22,487,132,641,9,650,1,651,384,1035,62.8019
第15任總統副總統,在花蓮縣各村(里),花蓮縣,　卓溪鄉,崙山村,8,239,59,306,5,311,0,311,205,516,60.2713
第15任總統副總統,在花蓮縣各村(里),花蓮縣,　卓溪鄉,立山村,16,443,123,582,7,589,0,589,379,968,60.8471
第15任總統副總統,在花蓮縣各村(里),花蓮縣,　卓溪鄉,太平村,14,342,73,429,7,436,0,436,226,662,65.8610
第15任總統副總統,在花蓮縣各村(里),花蓮縣,　卓溪鄉,卓溪村,9,351,95,455,5,460,0,460,266,726,63.3609
第15任總統副總統,在花蓮縣各村(里),花蓮縣,　卓溪鄉,卓清村,13,472,90,575,3,578,0,578,424,1002,57.6846
第15任總統副總統,在花蓮縣各村(里),花蓮縣,　卓溪鄉,古風村,16,444,91,551,6,557,0,557,337,894,62.3043
第15任總統副總統,在金門縣各村(里),金門縣,　金城鎮,東門里,65,1579,421,2065,18,2083,0,2083,2705,4788,43.5046
第15任總統副總統,在金門縣各村(里),金門縣,　金城鎮,南門里,87,1638,464,2189,18,2207,0,2207,3060,5267,41.9024
第15任總統副總統,在金門縣各村(里),金門縣,　金城鎮,西門里,131,3036,846,4013,31,4044,0,4044,5434,9478,42.6672
第15任總統副總統,在金門縣各村(里),金門縣,　金城鎮,北門里,55,1330,327,1712,19,1731,0,1731,2438,4169,41.5207
第15任總統副總統,在金門縣各村(里),金門縣,　金城鎮,賢庵里,56,1350,434,1840,14,1854,0,1854,2741,4595,40.3482
第15任總統副總統,在金門縣各村(里),金門縣,　金城鎮,金水里,30,663,182,875,12,887,0,887,1271,2158,41.1029
第15任總統副總統,在金門縣各村(里),金門縣,　金城鎮,古城里,48,1107,269,1424,11,1435,0,1435,2411,3846,37.3115
第15任總統副總統,在金門縣各村(里),金門縣,　金城鎮,珠沙里,33,789,227,1049,5,1054,0,1054,1733,2787,37.8184
第15任總統副總統,在金門縣各村(里),金門縣,　金沙鎮,汶沙里,64,1619,383,2066,22,2088,0,2088,3036,5124,40.7494
第15任總統副總統,在金門縣各村(里),金門縣,　金沙鎮,何斗里,27,619,104,750,9,759,0,759,1212,1971,38.5084
第15任總統副總統,在金門縣各村(里),金門縣,　金沙鎮,浦山里,17,719,164,900,10,910,0,910,1393,2303,39.5137
第15任總統副總統,在金門縣各村(里),金門縣,　金沙鎮,西園里,12,441,77,530,5,535,0,535,992,1527,35.0360
第15任總統副總統,在金門縣各村(里),金門縣,　金沙鎮,官嶼里,12,658,104,774,13,787,0,787,1371,2158,36.4690
第15任總統副總統,在金門縣各村(里),金門縣,　金沙鎮,三山里,16,577,121,714,6,720,0,720,1186,1906,37.7754
第15任總統副總統,在金門縣各村(里),金門縣,　金沙鎮,大洋里,11,375,75,461,2,463,0,463,656,1119,41.3762
第15任總統副總統,在金門縣各村(里),金門縣,　金沙鎮,光前里,26,728,170,924,5,929,0,929,1297,2226,41.7341
第15任總統副總統,在金門縣各村(里),金門縣,　金湖鎮,新市里,87,1438,381,1906,14,1920,0,1920,2340,4260,45.0704
第15任總統副總統,在金門縣各村(里),金門縣,　金湖鎮,山外里,56,1007,264,1327,18,1345,0,1345,1848,3193,42.1234
第15任總統副總統,在金門縣各村(里),金門縣,　金湖鎮,溪湖里,14,425,86,525,3,528,0,528,937,1465,36.0410
第15任總統副總統,在金門縣各村(里),金門縣,　金湖鎮,蓮庵里,20,532,119,671,7,678,0,678,945,1623,41.7745
第15任總統副總統,在金門縣各村(里),金門縣,　金湖鎮,料羅里,29,612,160,801,9,810,0,810,1176,1986,40.7855
第15任總統副總統,在金門縣各村(里),金門縣,　金湖鎮,新湖里,140,2331,874,3345,19,3364,0,3364,4303,7667,43.8764
第15任總統副總統,在金門縣各村(里),金門縣,　金湖鎮,正義里,31,794,185,1010,7,1017,0,1017,1573,2590,39.2664
第15任總統副總統,在金門縣各村(里),金門縣,　金湖鎮,瓊林里,38,982,205,1225,10,1235,0,1235,1838,3073,40.1887
第15任總統副總統,在金門縣各村(里),金門縣,　金寧鄉,古寧村,26,891,201,1118,9,1127,0,1127,2118,3245,34.7304
第15任總統副總統,在金門縣各村(里),金門縣,　金寧鄉,安美村,76,1330,446,1852,25,1877,0,1877,2918,4795,39.1449
第15任總統副總統,在金門縣各村(里),金門縣,　金寧鄉,湖埔村,140,1884,975,2999,29,3028,0,3028,3795,6823,44.3793
第15任總統副總統,在金門縣各村(里),金門縣,　金寧鄉,榜林村,59,1459,460,1978,18,1996,0,1996,3089,5085,39.2527
第15任總統副總統,在金門縣各村(里),金門縣,　金寧鄉,盤山村,123,1517,988,2628,27,2655,0,2655,3339,5994,44.2943
第15任總統副總統,在金門縣各村(里),金門縣,　金寧鄉,后盤村,13,454,91,558,3,561,0,561,982,1543,36.3577
第15任總統副總統,在金門縣各村(里),金門縣,　烈嶼鄉,林湖村,34,975,189,1198,6,1204,0,1204,2102,3306,36.4186
第15任總統副總統,在金門縣各村(里),金門縣,　烈嶼鄉,黃埔村,6,394,93,493,2,495,0,495,1092,1587,31.1909
第15任總統副總統,在金門縣各村(里),金門縣,　烈嶼鄉,西口村,15,531,144,690,3,693,0,693,1671,2364,29.3147
第15任總統副總統,在金門縣各村(里),金門縣,　烈嶼鄉,上林村,13,340,62,415,7,422,0,422,966,1388,30.4035
第15任總統副總統,在金門縣各村(里),金門縣,　烈嶼鄉,上岐村,24,728,150,902,6,908,0,908,1863,2771,32.7680
第15任總統副總統,在金門縣各村(里),金門縣,　烏坵鄉,大坵村,1,60,10,71,0,71,0,71,193,264,26.8939
第15任總統副總統,在金門縣各村(里),金門縣,　烏坵鄉,小坵村,1,36,5,42,1,43,0,43,234,277,15.5235
第15任總統副總統,在南投縣各村(里),南投縣,　南投市,龍泉里,26,241,391,658,8,666,0,666,228,894,74.4966
第15任總統副總統,在南投縣各村(里),南投縣,　南投市,康壽里,55,455,572,1082,12,1094,0,1094,282,1376,79.5058
第15任總統副總統,在南投縣各村(里),南投縣,　南投市,三民里,22,276,315,613,8,621,0,621,154,775,80.1290
第15任總統副總統,在南投縣各村(里),南投縣,　南投市,仁和里,26,144,238,408,5,413,0,413,83,496,83.2661
第15任總統副總統,在南投縣各村(里),南投縣,　南投市,南投里,15,171,238,424,4,428,0,428,129,557,76.8402
第15任總統副總統,在南投縣各村(里),南投縣,　南投市,彰仁里,13,92,171,276,7,283,0,283,69,352,80.3977
第15任總統副總統,在南投縣各村(里),南投縣,　南投市,崇文里,38,283,373,694,10,704,0,704,225,929,75.7804
第15任總統副總統,在南投縣各村(里),南投縣,　南投市,三興里,171,1798,1915,3884,61,3945,0,3945,1313,5258,75.0285
第15任總統副總統,在南投縣各村(里),南投縣,　南投市,三和里,104,902,1064,2070,21,2091,0,2091,580,2671,78.2853
第15任總統副總統,在南投縣各村(里),南投縣,　南投市,嘉興里,66,481,913,1460,26,1486,0,1486,576,2062,72.0660
第15任總統副總統,在南投縣各村(里),南投縣,　南投市,嘉和里,171,1255,1674,3100,34,3134,0,3134,1143,4277,73.2757
第15任總統副總統,在南投縣各村(里),南投縣,　南投市,平和里,208,1852,2165,4225,39,4264,0,4264,1589,5853,72.8515
第15任總統副總統,在南投縣各村(里),南投縣,　南投市,振興里,58,515,908,1481,19,1500,0,1500,512,2012,74.5527
第15任總統副總統,在南投縣各村(里),南投縣,　南投市,千秋里,31,272,419,722,4,726,0,726,263,989,73.4075
第15任總統副總統,在南投縣各村(里),南投縣,　南投市,軍功里,169,1341,1737,3247,38,3285,0,3285,1154,4439,74.0032
第15任總統副總統,在南投縣各村(里),南投縣,　南投市,東山里,18,109,150,277,6,283,0,283,90,373,75.8713
第15任總統副總統,在南投縣各村(里),南投縣,　南投市,營南里,115,799,869,1783,12,1795,0,1795,510,2305,77.8742
第15任總統副總統,在南投縣各村(里),南投縣,　南投市,營北里,251,2596,1710,4557,43,4600,0,4600,1113,5713,80.5181
第15任總統副總統,在南投縣各村(里),南投縣,　南投市,內興里,275,2425,2200,4900,59,4959,0,4959,1441,6400,77.4844
第15任總統副總統,在南投縣各村(里),南投縣,　南投市,內新里,69,404,555,1028,16,1044,0,1044,329,1373,76.0379
第15任總統副總統,在南投縣各村(里),南投縣,　南投市,光輝里,25,224,170,419,2,421,0,421,88,509,82.7112
第15任總統副總統,在南投縣各村(里),南投縣,　南投市,光榮里,36,576,163,775,10,785,0,785,261,1046,75.0478
第15任總統副總統,在南投縣各村(里),南投縣,　南投市,光明里,29,591,121,741,9,750,0,750,226,976,76.8443
第15任總統副總統,在南投縣各村(里),南投縣,　南投市,光華里,34,445,118,597,5,602,0,602,206,808,74.5050
第15任總統副總統,在南投縣各村(里),南投縣,　南投市,漳興里,83,753,1078,1914,14,1928,2,1930,615,2545,75.7564
第15任總統副總統,在南投縣各村(里),南投縣,　南投市,漳和里,226,2167,2662,5055,58,5113,0,5113,1697,6810,75.0808
第15任總統副總統,在南投縣各村(里),南投縣,　南投市,平山里,187,1545,1965,3697,32,3729,0,3729,1445,5174,72.0719
第15任總統副總統,在南投縣各村(里),南投縣,　南投市,新興里,179,1328,1893,3400,38,3438,1,3439,1412,4851,70.8720
第15任總統副總統,在南投縣各村(里),南投縣,　南投市,永豐里,105,753,1161,2019,21,2040,0,2040,700,2740,74.4526
第15任總統副總統,在南投縣各村(里),南投縣,　南投市,福興里,127,822,1206,2155,24,2179,0,2179,804,2983,73.0473
第15任總統副總統,在南投縣各村(里),南投縣,　南投市,鳳山里,42,199,494,735,15,750,0,750,327,1077,69.6379
第15任總統副總統,在南投縣各村(里),南投縣,　南投市,永興里,20,220,282,522,10,532,0,532,221,753,70.6507
第15任總統副總統,在南投縣各村(里),南投縣,　南投市,鳳鳴里,20,108,287,415,5,420,0,420,197,617,68.0713
第15任總統副總統,在南投縣各村(里),南投縣,　南投市,福山里,63,548,733,1344,18,1362,0,1362,498,1860,73.2258
第15任總統副總統,在南投縣各村(里),南投縣,　埔里鎮,東門里,93,896,880,1869,20,1889,0,1889,676,2565,73.6452
第15任總統副總統,在南投縣各村(里),南投縣,　埔里鎮,杷城里,76,851,909,1836,19,1855,1,1856,664,2520,73.6111
第15任總統副總統,在南投縣各村(里),南投縣,　埔里鎮,枇杷里,197,2558,2346,5101,82,5183,2,5185,2052,7237,71.6181
第15任總統副總統,在南投縣各村(里),南投縣,　埔里鎮,水頭里,141,1131,1305,2577,44,2621,0,2621,1088,3709,70.6659
第15任總統副總統,在南投縣各村(里),南投縣,　埔里鎮,麒麟里,20,327,314,661,1,662,0,662,340,1002,66.0679
第15任總統副總統,在南投縣各村(里),南投縣,　埔里鎮,珠格里,28,365,384,777,11,788,0,788,290,1078,73.0983
第15任總統副總統,在南投縣各村(里),南投縣,　埔里鎮,溪南里,42,410,341,793,11,804,0,804,278,1082,74.3068
第15任總統副總統,在南投縣各村(里),南投縣,　埔里鎮,西門里,80,985,1069,2134,28,2162,0,2162,792,2954,73.1889
第15任總統副總統,在南投縣各村(里),南投縣,　埔里鎮,南門里,23,265,320,608,5,613,0,613,179,792,77.3990
第15任總統副總統,在南投縣各村(里),南投縣,　埔里鎮,北門里,84,790,775,1649,18,1667,0,1667,749,2416,68.9983
第15任總統副總統,在南投縣各村(里),南投縣,　埔里鎮,北安里,74,1136,1119,2329,24,2353,0,2353,737,3090,76.1489
第15任總統副總統,在南投縣各村(里),南投縣,　埔里鎮,北梅里,93,1072,1098,2263,26,2289,0,2289,770,3059,74.8284
第15任總統副總統,在南投縣各村(里),南投縣,　埔里鎮,泰安里,64,779,701,1544,15,1559,0,1559,512,2071,75.2776
第15任總統副總統,在南投縣各村(里),南投縣,　埔里鎮,大湳里,52,488,627,1167,12,1179,0,1179,411,1590,74.1509
第15任總統副總統,在南投縣各村(里),南投縣,　埔里鎮,蜈蚣里,80,857,781,1718,25,1743,3,1746,738,2484,70.1691
第15任總統副總統,在南投縣各村(里),南投縣,　埔里鎮,同聲里,94,737,741,1572,23,1595,2,1597,563,2160,73.8426
第15任總統副總統,在南投縣各村(里),南投縣,　埔里鎮,清新里,107,1232,1221,2560,34,2594,0,2594,978,3572,72.6204
第15任總統副總統,在南投縣各村(里),南投縣,　埔里鎮,薰化里,32,342,365,739,9,748,0,748,229,977,76.5609
第15任總統副總統,在南投縣各村(里),南投縣,　埔里鎮,大城里,173,1983,1865,4021,55,4076,0,4076,1511,5587,72.9551
第15任總統副總統,在南投縣各村(里),南投縣,　埔里鎮,籃城里,33,265,409,707,14,721,0,721,211,932,77.3605
第15任總統副總統,在南投縣各村(里),南投縣,　埔里鎮,桃米里,39,349,314,702,6,708,0,708,304,1012,69.9605
第15任總統副總統,在南投縣各村(里),南投縣,　埔里鎮,成功里,6,103,90,199,3,202,0,202,92,294,68.7075
第15任總統副總統,在南投縣各村(里),南投縣,　埔里鎮,南村里,37,444,425,906,10,916,0,916,388,1304,70.2454
第15任總統副總統,在南投縣各村(里),南投縣,　埔里鎮,愛蘭里,46,511,451,1008,13,1021,0,1021,374,1395,73.1900
第15任總統副總統,在南投縣各村(里),南投縣,　埔里鎮,鐵山里,56,539,564,1159,14,1173,0,1173,477,1650,71.0909
第15任總統副總統,在南投縣各村(里),南投縣,　埔里鎮,房里里,43,472,439,954,9,963,0,963,364,1327,72.5697
第15任總統副總統,在南投縣各村(里),南投縣,　埔里鎮,向善里,31,217,227,475,7,482,0,482,181,663,72.6998
第15任總統副總統,在南投縣各村(里),南投縣,　埔里鎮,一新里,22,479,252,753,6,759,0,759,220,979,77.5281
第15任總統副總統,在南投縣各村(里),南投縣,　埔里鎮,合成里,46,428,668,1142,13,1155,0,1155,415,1570,73.5669
第15任總統副總統,在南投縣各村(里),南投縣,　埔里鎮,廣成里,32,387,366,785,7,792,0,792,346,1138,69.5958
第15任總統副總統,在南投縣各村(里),南投縣,　埔里鎮,史港里,19,244,183,446,5,451,0,451,139,590,76.4407
第15任總統副總統,在南投縣各村(里),南投縣,　埔里鎮,福興里,21,236,406,663,7,670,0,670,278,948,70.6751
第15任總統副總統,在南投縣各村(里),南投縣,　埔里鎮,牛眠里,86,786,1106,1978,25,2003,0,2003,699,2702,74.1303
第15任總統副總統,在南投縣各村(里),南投縣,　草屯鎮,玉峰里,79,677,830,1586,14,1600,0,1600,452,2052,77.9727
第15任總統副總統,在南投縣各村(里),南投縣,　草屯鎮,明正里,131,1219,1401,2751,33,2784,0,2784,858,3642,76.4415
第15任總統副總統,在南投縣各村(里),南投縣,　草屯鎮,炎峰里,63,646,808,1517,13,1530,0,1530,466,1996,76.6533
第15任總統副總統,在南投縣各村(里),南投縣,　草屯鎮,中正里,19,221,257,497,4,501,0,501,161,662,75.6798
第15任總統副總統,在南投縣各村(里),南投縣,　草屯鎮,和平里,38,334,468,840,14,854,0,854,238,1092,78.2051
第15任總統副總統,在南投縣各村(里),南投縣,　草屯鎮,中山里,81,712,926,1719,20,1739,0,1739,526,2265,76.7770
第15任總統副總統,在南投縣各村(里),南投縣,　草屯鎮,敦和里,243,1958,2445,4646,38,4684,0,4684,1591,6275,74.6454
第15任總統副總統,在南投縣各村(里),南投縣,　草屯鎮,山腳里,307,2647,2560,5514,69,5583,0,5583,1599,7182,77.7360
第15任總統副總統,在南投縣各村(里),南投縣,　草屯鎮,新厝里,125,1097,1190,2412,28,2440,0,2440,686,3126,78.0550
第15任總統副總統,在南投縣各村(里),南投縣,　草屯鎮,上林里,139,1061,1172,2372,32,2404,0,2404,689,3093,77.7239
第15任總統副總統,在南投縣各村(里),南投縣,　草屯鎮,碧峰里,178,1252,1788,3218,35,3253,0,3253,1062,4315,75.3882
第15任總統副總統,在南投縣各村(里),南投縣,　草屯鎮,碧洲里,94,824,888,1806,12,1818,0,1818,539,2357,77.1319
第15任總統副總統,在南投縣各村(里),南投縣,　草屯鎮,復興里,92,821,1132,2045,37,2082,0,2082,748,2830,73.5689
第15任總統副總統,在南投縣各村(里),南投縣,　草屯鎮,御史里,221,1730,2441,4392,44,4436,0,4436,1460,5896,75.2374
第15任總統副總統,在南投縣各村(里),南投縣,　草屯鎮,新豐里,131,1105,1757,2993,30,3023,0,3023,936,3959,76.3577
第15任總統副總統,在南投縣各村(里),南投縣,　草屯鎮,新庄里,130,1098,1417,2645,27,2672,0,2672,886,3558,75.0984
第15任總統副總統,在南投縣各村(里),南投縣,　草屯鎮,加老里,70,593,1028,1691,21,1712,0,1712,470,2182,78.4601
第15任總統副總統,在南投縣各村(里),南投縣,　草屯鎮,石川里,52,435,573,1060,14,1074,0,1074,377,1451,74.0179
第15任總統副總統,在南投縣各村(里),南投縣,　草屯鎮,北投里,118,713,1329,2160,25,2185,1,2186,650,2836,77.0451
第15任總統副總統,在南投縣各村(里),南投縣,　草屯鎮,富寮里,228,1872,2627,4727,37,4764,0,4764,1648,6412,74.2982
第15任總統副總統,在南投縣各村(里),南投縣,　草屯鎮,北勢里,56,518,810,1384,12,1396,0,1396,494,1890,73.8624
第15任總統副總統,在南投縣各村(里),南投縣,　草屯鎮,中原里,64,479,973,1516,16,1532,0,1532,461,1993,76.8690
第15任總統副總統,在南投縣各村(里),南投縣,　草屯鎮,南埔里,139,1102,1793,3034,39,3073,0,3073,961,4034,76.1775
第15任總統副總統,在南投縣各村(里),南投縣,　草屯鎮,坪頂里,24,320,398,742,12,754,0,754,237,991,76.0848
第15任總統副總統,在南投縣各村(里),南投縣,　草屯鎮,土城里,44,543,566,1153,19,1172,0,1172,444,1616,72.5248
第15任總統副總統,在南投縣各村(里),南投縣,　草屯鎮,平林里,30,366,396,792,11,803,0,803,257,1060,75.7547
第15任總統副總統,在南投縣各村(里),南投縣,　草屯鎮,雙冬里,76,632,823,1531,11,1542,0,1542,650,2192,70.3467
第15任總統副總統,在南投縣各村(里),南投縣,　竹山鎮,竹山里,54,666,771,1491,9,1500,0,1500,430,1930,77.7202
第15任總統副總統,在南投縣各村(里),南投縣,　竹山鎮,中正里,16,197,232,445,5,450,0,450,159,609,73.8916
第15任總統副總統,在南投縣各村(里),南投縣,　竹山鎮,中山里,96,1283,1723,3102,32,3134,0,3134,1240,4374,71.6507
第15任總統副總統,在南投縣各村(里),南投縣,　竹山鎮,雲林里,95,1115,1287,2497,24,2521,0,2521,917,3438,73.3275
第15任總統副總統,在南投縣各村(里),南投縣,　竹山鎮,竹圍里,49,692,847,1588,20,1608,0,1608,670,2278,70.5882
第15任總統副總統,在南投縣各村(里),南投縣,　竹山鎮,桂林里,98,1061,1414,2573,33,2606,0,2606,977,3583,72.7323
第15任總統副總統,在南投縣各村(里),南投縣,　竹山鎮,下坪里,40,354,442,836,13,849,0,849,319,1168,72.6884
第15任總統副總統,在南投縣各村(里),南投縣,　竹山鎮,中和里,14,182,451,647,6,653,0,653,272,925,70.5946
第15任總統副總統,在南投縣各村(里),南投縣,　竹山鎮,中崎里,34,422,489,945,13,958,0,958,382,1340,71.4925
第15任總統副總統,在南投縣各村(里),南投縣,　竹山鎮,秀林里,18,189,265,472,4,476,0,476,190,666,71.4715
第15任總統副總統,在南投縣各村(里),南投縣,　竹山鎮,大鞍里,4,139,135,278,3,281,0,281,136,417,67.3861
第15任總統副總統,在南投縣各村(里),南投縣,　竹山鎮,延和里,147,1354,1862,3363,47,3410,0,3410,1299,4709,72.4145
第15任總統副總統,在南投縣各村(里),南投縣,　竹山鎮,延祥里,101,1011,1391,2503,22,2525,0,2525,964,3489,72.3703
第15任總統副總統,在南投縣各村(里),南投縣,　竹山鎮,延正里,42,461,641,1144,18,1162,0,1162,492,1654,70.2539
第15任總統副總統,在南投縣各村(里),南投縣,　竹山鎮,延平里,84,737,1135,1956,29,1985,0,1985,765,2750,72.1818
第15任總統副總統,在南投縣各村(里),南投縣,　竹山鎮,延山里,18,249,327,594,11,605,0,605,231,836,72.3684
第15任總統副總統,在南投縣各村(里),南投縣,　竹山鎮,山崇里,49,503,684,1236,12,1248,1,1249,537,1786,69.8768
第15任總統副總統,在南投縣各村(里),南投縣,　竹山鎮,社寮里,41,357,567,965,10,975,0,975,329,1304,74.7699
第15任總統副總統,在南投縣各村(里),南投縣,　竹山鎮,中央里,29,311,484,824,10,834,0,834,337,1171,71.2212
第15任總統副總統,在南投縣各村(里),南投縣,　竹山鎮,富州里,23,174,234,431,7,438,0,438,161,599,73.1219
第15任總統副總統,在南投縣各村(里),南投縣,　竹山鎮,田子里,10,177,212,399,6,405,0,405,192,597,67.8392
第15任總統副總統,在南投縣各村(里),南投縣,　竹山鎮,硘磘里,40,459,704,1203,17,1220,0,1220,414,1634,74.6634
第15任總統副總統,在南投縣各村(里),南投縣,　竹山鎮,德興里,22,278,331,631,11,642,0,642,218,860,74.6512
第15任總統副總統,在南投縣各村(里),南投縣,　竹山鎮,福興里,15,229,165,409,9,418,0,418,155,573,72.9494
第15任總統副總統,在南投縣各村(里),南投縣,　竹山鎮,鯉魚里,14,196,267,477,5,482,0,482,281,763,63.1717
第15任總統副總統,在南投縣各村(里),南投縣,　竹山鎮,坪頂里,7,141,163,311,2,313,0,313,112,425,73.6471
第15任總統副總統,在南投縣各村(里),南投縣,　竹山鎮,瑞竹里,9,137,219,365,5,370,0,370,180,550,67.2727
第15任總統副總統,在南投縣各村(里),南投縣,　竹山鎮,桶頭里,6,252,293,551,9,560,0,560,290,850,65.8824
第15任總統副總統,在南投縣各村(里),南投縣,　集集鎮,集集里,45,376,357,778,19,797,0,797,239,1036,76.9305
第15任總統副總統,在南投縣各村(里),南投縣,　集集鎮,和平里,26,289,327,642,3,645,0,645,233,878,73.4624
第15任總統副總統,在南投縣各村(里),南投縣,　集集鎮,林尾里,20,166,227,413,5,418,0,418,148,566,73.8516
第15任總統副總統,在南投縣各村(里),南投縣,　集集鎮,田寮里,45,322,459,826,12,838,0,838,310,1148,72.9965
第15任總統副總統,在南投縣各村(里),南投縣,　集集鎮,隘寮里,12,129,176,317,8,325,0,325,144,469,69.2964
第15任總統副總統,在南投縣各村(里),南投縣,　集集鎮,玉映里,22,140,193,355,6,361,0,361,121,482,74.8963
第15任總統副總統,在南投縣各村(里),南投縣,　集集鎮,吳厝里,19,316,291,626,7,633,0,633,243,876,72.2603
第15任總統副總統,在南投縣各村(里),南投縣,　集集鎮,八張里,45,468,488,1001,15,1016,0,1016,368,1384,73.4104
第15任總統副總統,在南投縣各村(里),南投縣,　集集鎮,永昌里,26,285,383,694,7,701,0,701,242,943,74.3372
第15任總統副總統,在南投縣各村(里),南投縣,　集集鎮,廣明里,22,290,287,599,12,611,0,611,270,881,69.3530
第15任總統副總統,在南投縣各村(里),南投縣,　集集鎮,富山里,19,194,177,390,4,394,0,394,163,557,70.7361
第15任總統副總統,在南投縣各村(里),南投縣,　名間鄉,南雅村,33,309,426,768,7,775,0,775,242,1017,76.2045
第15任總統副總統,在南投縣各村(里),南投縣,　名間鄉,中正村,75,953,1395,2423,38,2461,0,2461,822,3283,74.9619
第15任總統副總統,在南投縣各村(里),南投縣,　名間鄉,中山村,71,617,828,1516,11,1527,0,1527,639,2166,70.4986
第15任總統副總統,在南投縣各村(里),南投縣,　名間鄉,濁水村,37,407,623,1067,16,1083,0,1083,439,1522,71.1564
第15任總統副總統,在南投縣各村(里),南投縣,　名間鄉,新民村,26,247,416,689,5,694,0,694,247,941,73.7513
第15任總統副總統,在南投縣各村(里),南投縣,　名間鄉,炭寮村,19,267,439,725,10,735,0,735,249,984,74.6951
第15任總統副總統,在南投縣各村(里),南投縣,　名間鄉,新街村,146,1034,1799,2979,30,3009,0,3009,1059,4068,73.9676
第15任總統副總統,在南投縣各村(里),南投縣,　名間鄉,東湖村,52,400,693,1145,14,1159,0,1159,443,1602,72.3471
第15任總統副總統,在南投縣各村(里),南投縣,　名間鄉,仁和村,24,285,284,593,5,598,0,598,275,873,68.4994
第15任總統副總統,在南投縣各村(里),南投縣,　名間鄉,萬丹村,31,198,422,651,11,662,0,662,254,916,72.2707
第15任總統副總統,在南投縣各村(里),南投縣,　名間鄉,田仔村,39,276,569,884,8,892,0,892,331,1223,72.9354
第15任總統副總統,在南投縣各村(里),南投縣,　名間鄉,大坑村,24,149,337,510,8,518,0,518,214,732,70.7650
第15任總統副總統,在南投縣各村(里),南投縣,　名間鄉,大庄村,51,345,894,1290,12,1302,0,1302,492,1794,72.5753
第15任總統副總統,在南投縣各村(里),南投縣,　名間鄉,廍下村,27,220,382,629,2,631,0,631,263,894,70.5817
第15任總統副總統,在南投縣各村(里),南投縣,　名間鄉,赤水村,30,280,499,809,8,817,0,817,316,1133,72.1094
第15任總統副總統,在南投縣各村(里),南投縣,　名間鄉,竹圍村,24,201,451,676,10,686,0,686,226,912,75.2193
第15任總統副總統,在南投縣各村(里),南投縣,　名間鄉,三崙村,53,375,682,1110,19,1129,0,1129,368,1497,75.4175
第15任總統副總統,在南投縣各村(里),南投縣,　名間鄉,松山村,55,351,666,1072,15,1087,0,1087,359,1446,75.1729
第15任總統副總統,在南投縣各村(里),南投縣,　名間鄉,松柏村,32,231,565,828,10,838,0,838,303,1141,73.4443
第15任總統副總統,在南投縣各村(里),南投縣,　名間鄉,崁腳村,25,268,345,638,12,650,0,650,214,864,75.2315
第15任總統副總統,在南投縣各村(里),南投縣,　名間鄉,埔中村,32,231,377,640,7,647,0,647,204,851,76.0282
第15任總統副總統,在南投縣各村(里),南投縣,　名間鄉,新厝村,18,234,290,542,10,552,0,552,203,755,73.1126
第15任總統副總統,在南投縣各村(里),南投縣,　名間鄉,新光村,49,428,764,1241,22,1263,0,1263,439,1702,74.2068
第15任總統副總統,在南投縣各村(里),南投縣,　鹿谷鄉,鹿谷村,38,578,657,1273,10,1283,0,1283,528,1811,70.8448
第15任總統副總統,在南投縣各村(里),南投縣,　鹿谷鄉,彰雅村,35,472,451,958,12,970,0,970,310,1280,75.7813
第15任總統副總統,在南投縣各村(里),南投縣,　鹿谷鄉,廣興村,55,722,632,1409,17,1426,0,1426,484,1910,74.6597
第15任總統副總統,在南投縣各村(里),南投縣,　鹿谷鄉,永隆村,47,473,658,1178,9,1187,0,1187,409,1596,74.3734
第15任總統副總統,在南投縣各村(里),南投縣,　鹿谷鄉,鳳凰村,34,359,560,953,22,975,0,975,356,1331,73.2532
第15任總統副總統,在南投縣各村(里),南投縣,　鹿谷鄉,內湖村,41,351,350,742,11,753,0,753,276,1029,73.1778
第15任總統副總統,在南投縣各村(里),南投縣,　鹿谷鄉,和雅村,15,267,166,448,6,454,0,454,158,612,74.1830
第15任總統副總統,在南投縣各村(里),南投縣,　鹿谷鄉,竹林村,40,536,488,1064,7,1071,0,1071,403,1474,72.6594
第15任總統副總統,在南投縣各村(里),南投縣,　鹿谷鄉,竹豐村,26,358,257,641,9,650,0,650,246,896,72.5446
第15任總統副總統,在南投縣各村(里),南投縣,　鹿谷鄉,初鄉村,20,485,469,974,10,984,0,984,436,1420,69.2958
第15任總統副總統,在南投縣各村(里),南投縣,　鹿谷鄉,秀峰村,23,197,283,503,5,508,0,508,261,769,66.0598
第15任總統副總統,在南投縣各村(里),南投縣,　鹿谷鄉,清水村,14,198,274,486,6,492,0,492,208,700,70.2857
第15任總統副總統,在南投縣各村(里),南投縣,　鹿谷鄉,瑞田村,26,183,254,463,7,470,0,470,244,714,65.8263
第15任總統副總統,在南投縣各村(里),南投縣,　中寮鄉,廣興村,15,175,361,551,7,558,0,558,216,774,72.0930
第15任總統副總統,在南投縣各村(里),南投縣,　中寮鄉,崁頂村,16,116,172,304,8,312,0,312,148,460,67.8261
第15任總統副總統,在南投縣各村(里),南投縣,　中寮鄉,八仙村,21,233,281,535,6,541,0,541,210,751,72.0373
第15任總統副總統,在南投縣各村(里),南投縣,　中寮鄉,福盛村,17,227,253,497,3,500,0,500,188,688,72.6744
第15任總統副總統,在南投縣各村(里),南投縣,　中寮鄉,和興村,9,211,202,422,4,426,0,426,201,627,67.9426
第15任總統副總統,在南投縣各村(里),南投縣,　中寮鄉,復興村,13,86,108,207,3,210,0,210,77,287,73.1707
第15任總統副總統,在南投縣各村(里),南投縣,　中寮鄉,永平村,40,532,596,1168,14,1182,0,1182,449,1631,72.4709
第15任總統副總統,在南投縣各村(里),南投縣,　中寮鄉,中寮村,18,217,208,443,9,452,0,452,179,631,71.6323
第15任總統副總統,在南投縣各村(里),南投縣,　中寮鄉,廣福村,16,112,202,330,2,332,0,332,134,466,71.2446
第15任總統副總統,在南投縣各村(里),南投縣,　中寮鄉,永福村,50,391,463,904,13,917,0,917,363,1280,71.6406
第15任總統副總統,在南投縣各村(里),南投縣,　中寮鄉,義和村,39,295,458,792,8,800,0,800,247,1047,76.4088
第15任總統副總統,在南投縣各村(里),南投縣,　中寮鄉,清水村,34,260,307,601,2,603,0,603,253,856,70.4439
第15任總統副總統,在南投縣各村(里),南投縣,　中寮鄉,內城村,17,141,139,297,2,299,0,299,145,444,67.3423
第15任總統副總統,在南投縣各村(里),南投縣,　中寮鄉,龍安村,20,147,300,467,7,474,0,474,192,666,71.1712
第15任總統副總統,在南投縣各村(里),南投縣,　中寮鄉,爽文村,24,145,179,348,2,350,0,350,123,473,73.9958
第15任總統副總統,在南投縣各村(里),南投縣,　中寮鄉,龍岩村,18,192,256,466,5,471,0,471,151,622,75.7235
第15任總統副總統,在南投縣各村(里),南投縣,　中寮鄉,永芳村,15,134,176,325,3,328,0,328,116,444,73.8739
第15任總統副總統,在南投縣各村(里),南投縣,　中寮鄉,永和村,14,146,188,348,6,354,0,354,149,503,70.3777
第15任總統副總統,在南投縣各村(里),南投縣,　魚池鄉,魚池村,51,610,669,1330,16,1346,0,1346,556,1902,70.7676
第15任總統副總統,在南投縣各村(里),南投縣,　魚池鄉,東池村,39,478,544,1061,19,1080,0,1080,445,1525,70.8197
第15任總統副總統,在南投縣各村(里),南投縣,　魚池鄉,大林村,34,272,437,743,9,752,0,752,298,1050,71.6190
第15任總統副總統,在南投縣各村(里),南投縣,　魚池鄉,東光村,36,311,461,808,16,824,0,824,399,1223,67.3753
第15任總統副總統,在南投縣各村(里),南投縣,　魚池鄉,共和村,12,159,186,357,4,361,0,361,117,478,75.5230
第15任總統副總統,在南投縣各村(里),南投縣,　魚池鄉,新城村、共和村,17,162,211,390,6,396,0,396,140,536,73.8806
第15任總統副總統,在南投縣各村(里),南投縣,　魚池鄉,新城村,39,367,502,908,18,926,0,926,396,1322,70.0454
第15任總統副總統,在南投縣各村(里),南投縣,　魚池鄉,大雁村,25,176,237,438,1,439,0,439,210,649,67.6425
第15任總統副總統,在南投縣各村(里),南投縣,　魚池鄉,五城村,13,227,258,498,10,508,0,508,202,710,71.5493
第15任總統副總統,在南投縣各村(里),南投縣,　魚池鄉,中明村,30,314,322,666,10,676,0,676,319,995,67.9397
第15任總統副總統,在南投縣各村(里),南投縣,　魚池鄉,水社村,30,318,237,585,3,588,0,588,223,811,72.5031
第15任總統副總統,在南投縣各村(里),南投縣,　魚池鄉,日月村,24,315,287,626,6,632,0,632,213,845,74.7929
第15任總統副總統,在南投縣各村(里),南投縣,　魚池鄉,頭社村,23,266,320,609,9,618,0,618,301,919,67.2470
第15任總統副總統,在南投縣各村(里),南投縣,　魚池鄉,武登村,24,179,176,379,6,385,0,385,173,558,68.9964
第15任總統副總統,在南投縣各村(里),南投縣,　國姓鄉,國姓村,46,537,567,1150,15,1165,0,1165,431,1596,72.9950
第15任總統副總統,在南投縣各村(里),南投縣,　國姓鄉,石門村,60,588,539,1187,9,1196,0,1196,473,1669,71.6597
第15任總統副總統,在南投縣各村(里),南投縣,　國姓鄉,大旗村,26,188,261,475,0,475,0,475,180,655,72.5191
第15任總統副總統,在南投縣各村(里),南投縣,　國姓鄉,長流村,45,463,423,931,9,940,0,940,391,1331,70.6236
第15任總統副總統,在南投縣各村(里),南投縣,　國姓鄉,長豐村,11,264,203,478,10,488,0,488,251,739,66.0352
第15任總統副總統,在南投縣各村(里),南投縣,　國姓鄉,長福村,15,249,223,487,6,493,0,493,201,694,71.0375
第15任總統副總統,在南投縣各村(里),南投縣,　國姓鄉,北港村,46,585,594,1225,18,1243,0,1243,582,1825,68.1096
第15任總統副總統,在南投縣各村(里),南投縣,　國姓鄉,福龜村,64,645,600,1309,9,1318,0,1318,471,1789,73.6724
第15任總統副總統,在南投縣各村(里),南投縣,　國姓鄉,乾溝村,15,243,287,545,14,559,0,559,235,794,70.4030
第15任總統副總統,在南投縣各村(里),南投縣,　國姓鄉,柑林村,51,397,336,784,10,794,0,794,314,1108,71.6606
第15任總統副總統,在南投縣各村(里),南投縣,　國姓鄉,大石村,25,247,228,500,6,506,0,506,190,696,72.7011
第15任總統副總統,在南投縣各村(里),南投縣,　國姓鄉,北山村,51,482,512,1045,14,1059,0,1059,420,1479,71.6024
第15任總統副總統,在南投縣各村(里),南投縣,　國姓鄉,南港村,44,571,443,1058,19,1077,0,1077,498,1575,68.3810
第15任總統副總統,在南投縣各村(里),南投縣,　水里鄉,水里村,18,239,217,474,8,482,0,482,244,726,66.3912
第15任總統副總統,在南投縣各村(里),南投縣,　水里鄉,新城村,50,422,527,999,12,1011,0,1011,474,1485,68.0808
第15任總統副總統,在南投縣各村(里),南投縣,　水里鄉,中央村,21,214,179,414,7,421,0,421,175,596,70.6376
第15任總統副總統,在南投縣各村(里),南投縣,　水里鄉,城中村,29,290,255,574,9,583,0,583,230,813,71.7097
第15任總統副總統,在南投縣各村(里),南投縣,　水里鄉,農富村,15,169,164,348,2,350,0,350,110,460,76.0870
第15任總統副總統,在南投縣各村(里),南投縣,　水里鄉,車埕村,11,159,137,307,4,311,0,311,124,435,71.4943
第15任總統副總統,在南投縣各村(里),南投縣,　水里鄉,新興村,15,245,159,419,8,427,0,427,195,622,68.6495
第15任總統副總統,在南投縣各村(里),南投縣,　水里鄉,北埔村,20,336,320,676,6,682,0,682,301,983,69.3795
第15任總統副總統,在南投縣各村(里),南投縣,　水里鄉,南光村,57,500,564,1121,10,1131,0,1131,376,1507,75.0498
第15任總統副總統,在南投縣各村(里),南投縣,　水里鄉,鉅工村,27,321,330,678,5,683,0,683,251,934,73.1263
第15任總統副總統,在南投縣各村(里),南投縣,　水里鄉,永豐村,43,412,479,934,9,943,0,943,377,1320,71.4394
第15任總統副總統,在南投縣各村(里),南投縣,　水里鄉,民和村,19,239,299,557,11,568,0,568,289,857,66.2777
第15任總統副總統,在南投縣各村(里),南投縣,　水里鄉,頂崁村,45,359,369,773,4,777,0,777,407,1184,65.6250
第15任總統副總統,在南投縣各村(里),南投縣,　水里鄉,新山村,4,58,78,140,2,142,0,142,55,197,72.0812
第15任總統副總統,在南投縣各村(里),南投縣,　水里鄉,郡坑村,8,131,76,215,3,218,0,218,85,303,71.9472
第15任總統副總統,在南投縣各村(里),南投縣,　水里鄉,上安村,25,371,335,731,17,748,0,748,314,1062,70.4331
第15任總統副總統,在南投縣各村(里),南投縣,　水里鄉,興隆村,6,72,96,174,2,176,0,176,101,277,63.5379
第15任總統副總統,在南投縣各村(里),南投縣,　水里鄉,永興村,8,90,120,218,1,219,0,219,90,309,70.8738
第15任總統副總統,在南投縣各村(里),南投縣,　水里鄉,玉峰村,20,183,337,540,8,548,0,548,239,787,69.6315
第15任總統副總統,在南投縣各村(里),南投縣,　信義鄉,明德村,33,584,386,1003,12,1015,0,1015,441,1456,69.7115
第15任總統副總統,在南投縣各村(里),南投縣,　信義鄉,愛國村,7,181,142,330,3,333,0,333,154,487,68.3778
第15任總統副總統,在南投縣各村(里),南投縣,　信義鄉,自強村,32,229,230,491,5,496,0,496,234,730,67.9452
第15任總統副總統,在南投縣各村(里),南投縣,　信義鄉,豐丘村,20,219,162,401,7,408,0,408,206,614,66.4495
第15任總統副總統,在南投縣各村(里),南投縣,　信義鄉,新鄉村,12,275,116,403,5,408,0,408,165,573,71.2042
第15任總統副總統,在南投縣各村(里),南投縣,　信義鄉,羅娜村,39,670,189,898,9,907,0,907,396,1303,69.6086
第15任總統副總統,在南投縣各村(里),南投縣,　信義鄉,望美村,38,569,347,954,16,970,0,970,479,1449,66.9427
第15任總統副總統,在南投縣各村(里),南投縣,　信義鄉,同富村,38,422,445,905,17,922,0,922,447,1369,67.3484
第15任總統副總統,在南投縣各村(里),南投縣,　信義鄉,神木村,9,242,141,392,4,396,0,396,234,630,62.8571
第15任總統副總統,在南投縣各村(里),南投縣,　信義鄉,東埔村,28,406,223,657,17,674,0,674,311,985,68.4264
第15任總統副總統,在南投縣各村(里),南投縣,　信義鄉,人和村,24,484,204,712,6,718,0,718,422,1140,62.9825
第15任總統副總統,在南投縣各村(里),南投縣,　信義鄉,地利村,20,424,152,596,4,600,0,600,264,864,69.4444
第15任總統副總統,在南投縣各村(里),南投縣,　信義鄉,雙龍村,13,278,86,377,4,381,0,381,210,591,64.4670
第15任總統副總統,在南投縣各村(里),南投縣,　信義鄉,潭南村,7,263,73,343,6,349,0,349,186,535,65.2336
第15任總統副總統,在南投縣各村(里),南投縣,　仁愛鄉,南豐村,43,594,225,862,3,865,0,865,351,1216,71.1349
第15任總統副總統,在南投縣各村(里),南投縣,　仁愛鄉,大同村,33,816,316,1165,7,1172,0,1172,444,1616,72.5248
第15任總統副總統,在南投縣各村(里),南投縣,　仁愛鄉,榮興村,2,28,3,33,0,33,0,33,24,57,57.8947
第15任總統副總統,在南投縣各村(里),南投縣,　仁愛鄉,春陽村,16,496,149,661,3,664,0,664,265,929,71.4747
第15任總統副總統,在南投縣各村(里),南投縣,　仁愛鄉,精英村,19,337,102,458,7,465,0,465,198,663,70.1357
第15任總統副總統,在南投縣各村(里),南投縣,　仁愛鄉,都達村,6,329,58,393,4,397,0,397,211,608,65.2961
第15任總統副總統,在南投縣各村(里),南投縣,　仁愛鄉,合作村,19,279,81,379,2,381,0,381,199,580,65.6897
第15任總統副總統,在南投縣各村(里),南投縣,　仁愛鄉,發祥村,18,347,88,453,0,453,0,453,276,729,62.1399
第15任總統副總統,在南投縣各村(里),南投縣,　仁愛鄉,力行村,8,245,47,300,0,300,0,300,189,489,61.3497
第15任總統副總統,在南投縣各村(里),南投縣,　仁愛鄉,翠華村,7,182,61,250,6,256,0,256,235,491,52.1385
第15任總統副總統,在南投縣各村(里),南投縣,　仁愛鄉,親愛村,17,595,109,721,5,726,0,726,363,1089,66.6667
第15任總統副總統,在南投縣各村(里),南投縣,　仁愛鄉,萬豐村,16,291,78,385,3,388,0,388,217,605,64.1322
第15任總統副總統,在南投縣各村(里),南投縣,　仁愛鄉,法治村,19,355,106,480,6,486,0,486,266,752,64.6277
第15任總統副總統,在南投縣各村(里),南投縣,　仁愛鄉,中正村,17,458,99,574,7,581,0,581,280,861,67.4797
第15任總統副總統,在南投縣各村(里),南投縣,　仁愛鄉,互助村,26,651,125,802,10,812,0,812,280,1092,74.3590
第15任總統副總統,在南投縣各村(里),南投縣,　仁愛鄉,新生村,14,244,38,296,1,297,0,297,90,387,76.7442
第15任總統副總統,在屏東縣各村(里),屏東縣,　屏東市,武廟里、大同里、端正里,24,219,536,779,9,788,0,788,269,1057,74.5506
第15任總統副總統,在屏東縣各村(里),屏東縣,　屏東市,文明里、泰安里,15,229,264,508,3,511,0,511,157,668,76.4970
第15任總統副總統,在屏東縣各村(里),屏東縣,　屏東市,光榮里、民權里,29,318,603,950,14,964,0,964,300,1264,76.2658
第15任總統副總統,在屏東縣各村(里),屏東縣,　屏東市,大埔里、必信里,31,273,642,946,7,953,0,953,301,1254,75.9968
第15任總統副總統,在屏東縣各村(里),屏東縣,　屏東市,崇智里、崇禮里,20,152,352,524,4,528,0,528,144,672,78.5714
第15任總統副總統,在屏東縣各村(里),屏東縣,　屏東市,維新里,68,628,1225,1921,23,1944,0,1944,685,2629,73.9445
第15任總統副總統,在屏東縣各村(里),屏東縣,　屏東市,楠樹里、扶風里、慶春里,22,293,636,951,7,958,0,958,239,1197,80.0334
第15任總統副總統,在屏東縣各村(里),屏東縣,　屏東市,安樂里、平和里,31,262,541,834,4,838,0,838,235,1073,78.0988
第15任總統副總統,在屏東縣各村(里),屏東縣,　屏東市,金泉里、勝豐里,24,239,546,809,11,820,0,820,208,1028,79.7665
第15任總統副總統,在屏東縣各村(里),屏東縣,　屏東市,橋南里,28,397,685,1110,11,1121,0,1121,393,1514,74.0423
第15任總統副總統,在屏東縣各村(里),屏東縣,　屏東市,橋北里,15,230,379,624,11,635,0,635,206,841,75.5054
第15任總統副總統,在屏東縣各村(里),屏東縣,　屏東市,大連里,256,3041,3702,6999,74,7073,1,7074,1903,8977,78.7902
第15任總統副總統,在屏東縣各村(里),屏東縣,　屏東市,豐田里,111,1165,1636,2912,30,2942,0,2942,957,3899,75.4552
第15任總統副總統,在屏東縣各村(里),屏東縣,　屏東市,豐榮里,57,746,1141,1944,13,1957,0,1957,496,2453,79.7799
第15任總統副總統,在屏東縣各村(里),屏東縣,　屏東市,豐源里,76,1158,1431,2665,34,2699,0,2699,739,3438,78.5049
第15任總統副總統,在屏東縣各村(里),屏東縣,　屏東市,長春里,44,524,802,1370,19,1389,0,1389,433,1822,76.2349
第15任總統副總統,在屏東縣各村(里),屏東縣,　屏東市,瑞光里,185,2089,2930,5204,58,5262,0,5262,1749,7011,75.0535
第15任總統副總統,在屏東縣各村(里),屏東縣,　屏東市,湖南里,20,164,605,789,5,794,0,794,224,1018,77.9961
第15任總統副總統,在屏東縣各村(里),屏東縣,　屏東市,湖西里,19,260,862,1141,14,1155,0,1155,337,1492,77.4129
第15任總統副總統,在屏東縣各村(里),屏東縣,　屏東市,歸心里,25,163,623,811,4,815,0,815,268,1083,75.2539
第15任總統副總統,在屏東縣各村(里),屏東縣,　屏東市,清溪里,95,1163,1715,2973,20,2993,0,2993,924,3917,76.4105
第15任總統副總統,在屏東縣各村(里),屏東縣,　屏東市,大武里,178,2282,3460,5920,47,5967,0,5967,1959,7926,75.2839
第15任總統副總統,在屏東縣各村(里),屏東縣,　屏東市,崇武里,89,1348,666,2103,19,2122,0,2122,688,2810,75.5160
第15任總統副總統,在屏東縣各村(里),屏東縣,　屏東市,凌雲里、鵬程里,12,169,241,422,2,424,0,424,157,581,72.9776
第15任總統副總統,在屏東縣各村(里),屏東縣,　屏東市,永順里、永昌里,16,165,205,386,5,391,0,391,125,516,75.7752
第15任總統副總統,在屏東縣各村(里),屏東縣,　屏東市,安鎮里,39,386,1031,1456,19,1475,0,1475,478,1953,75.5248
第15任總統副總統,在屏東縣各村(里),屏東縣,　屏東市,永光里,17,265,485,767,5,772,0,772,242,1014,76.1341
第15任總統副總統,在屏東縣各村(里),屏東縣,　屏東市,長安里,53,372,942,1367,12,1379,0,1379,493,1872,73.6645
第15任總統副總統,在屏東縣各村(里),屏東縣,　屏東市,前進里,69,615,1459,2143,16,2159,0,2159,687,2846,75.8609
第15任總統副總統,在屏東縣各村(里),屏東縣,　屏東市,大洲里,21,191,692,904,11,915,0,915,244,1159,78.9474
第15任總統副總統,在屏東縣各村(里),屏東縣,　屏東市,新興里,62,522,1291,1875,9,1884,0,1884,518,2402,78.4346
第15任總統副總統,在屏東縣各村(里),屏東縣,　屏東市,公館里,35,298,806,1139,14,1153,0,1153,328,1481,77.8528
第15任總統副總統,在屏東縣各村(里),屏東縣,　屏東市,新生里,130,1453,2427,4010,46,4056,0,4056,1244,5300,76.5283
第15任總統副總統,在屏東縣各村(里),屏東縣,　屏東市,頂宅里,15,80,288,383,3,386,0,386,116,502,76.8924
第15任總統副總統,在屏東縣各村(里),屏東縣,　屏東市,頂柳里,20,206,583,809,13,822,0,822,258,1080,76.1111
第15任總統副總統,在屏東縣各村(里),屏東縣,　屏東市,大湖里,36,352,877,1265,20,1285,0,1285,450,1735,74.0634
第15任總統副總統,在屏東縣各村(里),屏東縣,　屏東市,龍華里,41,482,1132,1655,23,1678,0,1678,536,2214,75.7904
第15任總統副總統,在屏東縣各村(里),屏東縣,　屏東市,玉成里,21,234,861,1116,17,1133,0,1133,292,1425,79.5088
第15任總統副總統,在屏東縣各村(里),屏東縣,　屏東市,擇仁里,7,187,389,583,5,588,0,588,232,820,71.7073
第15任總統副總統,在屏東縣各村(里),屏東縣,　屏東市,建國里,22,265,366,653,3,656,0,656,227,883,74.2922
第15任總統副總統,在屏東縣各村(里),屏東縣,　屏東市,萬年里,16,145,324,485,6,491,0,491,181,672,73.0655
第15任總統副總統,在屏東縣各村(里),屏東縣,　屏東市,厚生里,51,607,1411,2069,26,2095,0,2095,689,2784,75.2514
第15任總統副總統,在屏東縣各村(里),屏東縣,　屏東市,一心里,33,380,474,887,9,896,0,896,256,1152,77.7778
第15任總統副總統,在屏東縣各村(里),屏東縣,　屏東市,義勇里,32,422,412,866,8,874,0,874,210,1084,80.6273
第15任總統副總統,在屏東縣各村(里),屏東縣,　屏東市,光華里,24,152,285,461,4,465,0,465,200,665,69.9248
第15任總統副總統,在屏東縣各村(里),屏東縣,　屏東市,永安里,165,1858,3181,5204,48,5252,1,5253,1709,6962,75.4381
第15任總統副總統,在屏東縣各村(里),屏東縣,　屏東市,崇蘭里,323,4228,4383,8934,90,9024,0,9024,2670,11694,77.1678
第15任總統副總統,在屏東縣各村(里),屏東縣,　屏東市,潭墘里,254,4045,3907,8206,82,8288,0,8288,2968,11256,73.6318
第15任總統副總統,在屏東縣各村(里),屏東縣,　屏東市,永城里,40,549,779,1368,20,1388,0,1388,514,1902,72.9758
第15任總統副總統,在屏東縣各村(里),屏東縣,　屏東市,空翔里,41,793,416,1250,9,1259,0,1259,411,1670,75.3892
第15任總統副總統,在屏東縣各村(里),屏東縣,　屏東市,廣興里,48,586,927,1561,9,1570,0,1570,488,2058,76.2877
第15任總統副總統,在屏東縣各村(里),屏東縣,　屏東市,勝利里,133,1649,1862,3644,28,3672,0,3672,1707,5379,68.2655
第15任總統副總統,在屏東縣各村(里),屏東縣,　屏東市,斯文里,45,527,667,1239,11,1250,1,1251,374,1625,76.9231
第15任總統副總統,在屏東縣各村(里),屏東縣,　屏東市,華山里,109,1577,1909,3595,35,3630,0,3630,1025,4655,77.9807
第15任總統副總統,在屏東縣各村(里),屏東縣,　屏東市,溝美里,45,659,900,1604,17,1621,0,1621,595,2216,73.1498
第15任總統副總統,在屏東縣各村(里),屏東縣,　屏東市,三山里,20,289,694,1003,2,1005,0,1005,297,1302,77.1889
第15任總統副總統,在屏東縣各村(里),屏東縣,　屏東市,海豐里,16,175,488,679,2,681,0,681,155,836,81.4593
第15任總統副總統,在屏東縣各村(里),屏東縣,　屏東市,仁義里,17,224,556,797,7,804,0,804,273,1077,74.6518
第15任總統副總統,在屏東縣各村(里),屏東縣,　屏東市,北興里,152,1842,2438,4432,49,4481,0,4481,1384,5865,76.4024
第15任總統副總統,在屏東縣各村(里),屏東縣,　屏東市,北勢里,53,648,1040,1741,12,1753,0,1753,517,2270,77.2247
第15任總統副總統,在屏東縣各村(里),屏東縣,　屏東市,中正里,133,1460,1809,3402,39,3441,0,3441,1029,4470,76.9799
第15任總統副總統,在屏東縣各村(里),屏東縣,　屏東市,興樂里,12,231,315,558,5,563,1,564,161,725,77.6552
第15任總統副總統,在屏東縣各村(里),屏東縣,　屏東市,明正里,15,202,271,488,6,494,0,494,165,659,74.9621
第15任總統副總統,在屏東縣各村(里),屏東縣,　屏東市,太平里,13,197,283,493,5,498,0,498,146,644,77.3292
第15任總統副總統,在屏東縣各村(里),屏東縣,　屏東市,信和里,30,261,841,1132,17,1149,0,1149,363,1512,75.9921
第15任總統副總統,在屏東縣各村(里),屏東縣,　屏東市,和興里,16,170,496,682,10,692,0,692,234,926,74.7300
第15任總統副總統,在屏東縣各村(里),屏東縣,　屏東市,仁愛里,49,615,946,1610,15,1625,0,1625,478,2103,77.2706
第15任總統副總統,在屏東縣各村(里),屏東縣,　潮州鎮,潮州里,12,152,199,363,5,368,0,368,115,483,76.1905
第15任總統副總統,在屏東縣各村(里),屏東縣,　潮州鎮,光華里,106,1228,2010,3344,30,3374,0,3374,1235,4609,73.2046
第15任總統副總統,在屏東縣各村(里),屏東縣,　潮州鎮,同榮里,7,141,327,475,3,478,0,478,103,581,82.2719
第15任總統副總統,在屏東縣各村(里),屏東縣,　潮州鎮,彭城里,13,162,491,666,3,669,0,669,189,858,77.9720
第15任總統副總統,在屏東縣各村(里),屏東縣,　潮州鎮,三星里,110,1529,2286,3925,47,3972,0,3972,1207,5179,76.6943
第15任總統副總統,在屏東縣各村(里),屏東縣,　潮州鎮,三共里,142,1715,2895,4752,45,4797,0,4797,1491,6288,76.2882
第15任總統副總統,在屏東縣各村(里),屏東縣,　潮州鎮,三和里,47,594,885,1526,18,1544,0,1544,502,2046,75.4643
第15任總統副總統,在屏東縣各村(里),屏東縣,　潮州鎮,九塊里,33,298,842,1173,8,1181,0,1181,432,1613,73.2176
第15任總統副總統,在屏東縣各村(里),屏東縣,　潮州鎮,新生里,20,242,465,727,4,731,0,731,237,968,75.5165
第15任總統副總統,在屏東縣各村(里),屏東縣,　潮州鎮,新榮里,16,323,592,931,10,941,0,941,280,1221,77.0680
第15任總統副總統,在屏東縣各村(里),屏東縣,　潮州鎮,五魁里,38,324,637,999,5,1004,0,1004,346,1350,74.3704
第15任總統副總統,在屏東縣各村(里),屏東縣,　潮州鎮,蓬萊里,40,531,1140,1711,11,1722,0,1722,572,2294,75.0654
第15任總統副總統,在屏東縣各村(里),屏東縣,　潮州鎮,八爺里,41,579,1047,1667,15,1682,0,1682,597,2279,73.8043
第15任總統副總統,在屏東縣各村(里),屏東縣,　潮州鎮,永春里,160,1797,3112,5069,46,5115,0,5115,1734,6849,74.6824
第15任總統副總統,在屏東縣各村(里),屏東縣,　潮州鎮,富春里,23,335,488,846,4,850,0,850,302,1152,73.7847
第15任總統副總統,在屏東縣各村(里),屏東縣,　潮州鎮,光春里,31,323,663,1017,5,1022,0,1022,359,1381,74.0043
第15任總統副總統,在屏東縣各村(里),屏東縣,　潮州鎮,興美里,16,188,443,647,2,649,0,649,213,862,75.2900
第15任總統副總統,在屏東縣各村(里),屏東縣,　潮州鎮,檨子里,11,94,185,290,1,291,0,291,150,441,65.9864
第15任總統副總統,在屏東縣各村(里),屏東縣,　潮州鎮,泗林里,29,355,848,1232,16,1248,0,1248,349,1597,78.1465
第15任總統副總統,在屏東縣各村(里),屏東縣,　潮州鎮,四春里,24,338,903,1265,13,1278,0,1278,408,1686,75.8007
第15任總統副總統,在屏東縣各村(里),屏東縣,　潮州鎮,崙東里,31,295,735,1061,15,1076,0,1076,411,1487,72.3605
第15任總統副總統,在屏東縣各村(里),屏東縣,　東港鎮,新勝里,48,446,1062,1556,14,1570,0,1570,400,1970,79.6954
第15任總統副總統,在屏東縣各村(里),屏東縣,　東港鎮,頂新里,10,121,239,370,2,372,0,372,102,474,78.4810
第15任總統副總統,在屏東縣各村(里),屏東縣,　東港鎮,頂中里,9,82,211,302,6,308,0,308,70,378,81.4815
第15任總統副總統,在屏東縣各村(里),屏東縣,　東港鎮,東和里,14,148,299,461,4,465,0,465,162,627,74.1627
第15任總統副總統,在屏東縣各村(里),屏東縣,　東港鎮,興台里,12,115,254,381,5,386,0,386,107,493,78.2961
第15任總統副總統,在屏東縣各村(里),屏東縣,　東港鎮,興東里,196,2026,4368,6590,65,6655,0,6655,2063,8718,76.3363
第15任總統副總統,在屏東縣各村(里),屏東縣,　東港鎮,興農里,15,303,685,1003,11,1014,0,1014,270,1284,78.9720
第15任總統副總統,在屏東縣各村(里),屏東縣,　東港鎮,中興里,15,162,322,499,6,505,0,505,148,653,77.3354
第15任總統副總統,在屏東縣各村(里),屏東縣,　東港鎮,朝安里,29,294,865,1188,5,1193,0,1193,376,1569,76.0357
第15任總統副總統,在屏東縣各村(里),屏東縣,　東港鎮,八德里,14,167,391,572,7,579,0,579,192,771,75.0973
第15任總統副總統,在屏東縣各村(里),屏東縣,　東港鎮,東隆里,24,230,572,826,16,842,0,842,303,1145,73.5371
第15任總統副總統,在屏東縣各村(里),屏東縣,　東港鎮,豐漁里,10,114,321,445,5,450,0,450,124,574,78.3972
第15任總統副總統,在屏東縣各村(里),屏東縣,　東港鎮,盛漁里,23,202,712,937,9,946,0,946,362,1308,72.3242
第15任總統副總統,在屏東縣各村(里),屏東縣,　東港鎮,興漁里,44,289,985,1318,17,1335,0,1335,432,1767,75.5518
第15任總統副總統,在屏東縣各村(里),屏東縣,　東港鎮,鎮海里,47,455,1559,2061,20,2081,0,2081,650,2731,76.1992
第15任總統副總統,在屏東縣各村(里),屏東縣,　東港鎮,嘉蓮里,28,335,871,1234,9,1243,0,1243,415,1658,74.9698
第15任總統副總統,在屏東縣各村(里),屏東縣,　東港鎮,南平里,17,436,725,1178,11,1189,0,1189,382,1571,75.6843
第15任總統副總統,在屏東縣各村(里),屏東縣,　東港鎮,船頭里,98,1168,2639,3905,38,3943,0,3943,1253,5196,75.8853
第15任總統副總統,在屏東縣各村(里),屏東縣,　東港鎮,下廍里,26,264,1177,1467,15,1482,0,1482,440,1922,77.1072
第15任總統副總統,在屏東縣各村(里),屏東縣,　東港鎮,大潭里,36,312,753,1101,5,1106,0,1106,415,1521,72.7153
第15任總統副總統,在屏東縣各村(里),屏東縣,　東港鎮,興和里,12,159,618,789,8,797,0,797,245,1042,76.4875
第15任總統副總統,在屏東縣各村(里),屏東縣,　東港鎮,共和里,27,341,160,528,5,533,0,533,177,710,75.0704
第15任總統副總統,在屏東縣各村(里),屏東縣,　恆春鎮,城南里,18,293,305,616,5,621,0,621,285,906,68.5430
第15任總統副總統,在屏東縣各村(里),屏東縣,　恆春鎮,城北里,39,636,810,1485,12,1497,0,1497,672,2169,69.0180
第15任總統副總統,在屏東縣各村(里),屏東縣,　恆春鎮,城西里,22,332,413,767,8,775,0,775,334,1109,69.8828
第15任總統副總統,在屏東縣各村(里),屏東縣,　恆春鎮,網紗里,45,809,1110,1964,12,1976,0,1976,991,2967,66.5993
第15任總統副總統,在屏東縣各村(里),屏東縣,　恆春鎮,仁壽里,18,210,302,530,4,534,0,534,330,864,61.8056
第15任總統副總統,在屏東縣各村(里),屏東縣,　恆春鎮,茄湖里,3,93,229,325,0,325,0,325,184,509,63.8507
第15任總統副總統,在屏東縣各村(里),屏東縣,　恆春鎮,頭溝里,6,101,194,301,3,304,0,304,165,469,64.8188
第15任總統副總統,在屏東縣各村(里),屏東縣,　恆春鎮,四溝里,15,195,432,642,7,649,0,649,347,996,65.1606
第15任總統副總統,在屏東縣各村(里),屏東縣,　恆春鎮,德和里,15,177,384,576,2,578,0,578,292,870,66.4368
第15任總統副總統,在屏東縣各村(里),屏東縣,　恆春鎮,龍水里,14,244,400,658,8,666,0,666,386,1052,63.3080
第15任總統副總統,在屏東縣各村(里),屏東縣,　恆春鎮,山海里,13,290,636,939,12,951,0,951,576,1527,62.2790
第15任總統副總統,在屏東縣各村(里),屏東縣,　恆春鎮,大光里,26,621,691,1338,14,1352,0,1352,807,2159,62.6216
第15任總統副總統,在屏東縣各村(里),屏東縣,　恆春鎮,水泉里,24,299,511,834,10,844,0,844,509,1353,62.3799
第15任總統副總統,在屏東縣各村(里),屏東縣,　恆春鎮,山腳里,66,1154,1447,2667,16,2683,0,2683,1382,4065,66.0025
第15任總統副總統,在屏東縣各村(里),屏東縣,　恆春鎮,南灣里,29,458,557,1044,12,1056,0,1056,551,1607,65.7125
第15任總統副總統,在屏東縣各村(里),屏東縣,　恆春鎮,墾丁里,19,388,471,878,5,883,0,883,317,1200,73.5833
第15任總統副總統,在屏東縣各村(里),屏東縣,　恆春鎮,鵝鑾里,12,320,381,713,6,719,0,719,359,1078,66.6976
第15任總統副總統,在屏東縣各村(里),屏東縣,　萬丹鄉,香社村,32,325,808,1165,13,1178,0,1178,297,1475,79.8644
第15任總統副總統,在屏東縣各村(里),屏東縣,　萬丹鄉,新庄村,49,497,1037,1583,16,1599,0,1599,445,2044,78.2290
第15任總統副總統,在屏東縣各村(里),屏東縣,　萬丹鄉,新鐘村,48,516,884,1448,17,1465,0,1465,471,1936,75.6715
第15任總統副總統,在屏東縣各村(里),屏東縣,　萬丹鄉,水仙村,12,152,276,440,6,446,0,446,86,532,83.8346
第15任總統副總統,在屏東縣各村(里),屏東縣,　萬丹鄉,興全村,26,298,568,892,4,896,0,896,208,1104,81.1594
第15任總統副總統,在屏東縣各村(里),屏東縣,　萬丹鄉,興安村,11,139,465,615,7,622,0,622,189,811,76.6954
第15任總統副總統,在屏東縣各村(里),屏東縣,　萬丹鄉,甘棠村,12,81,190,283,4,287,0,287,91,378,75.9259
第15任總統副總統,在屏東縣各村(里),屏東縣,　萬丹鄉,萬惠村,28,215,418,661,7,668,0,668,162,830,80.4819
第15任總統副總統,在屏東縣各村(里),屏東縣,　萬丹鄉,萬全村,80,807,1644,2531,23,2554,0,2554,759,3313,77.0903
第15任總統副總統,在屏東縣各村(里),屏東縣,　萬丹鄉,萬後村,19,145,342,506,5,511,0,511,185,696,73.4195
第15任總統副總統,在屏東縣各村(里),屏東縣,　萬丹鄉,萬安村,7,144,295,446,4,450,0,450,123,573,78.5340
第15任總統副總統,在屏東縣各村(里),屏東縣,　萬丹鄉,萬生村,28,383,657,1068,11,1079,0,1079,275,1354,79.6898
第15任總統副總統,在屏東縣各村(里),屏東縣,　萬丹鄉,寶厝村,48,580,1044,1672,12,1684,0,1684,499,2183,77.1415
第15任總統副總統,在屏東縣各村(里),屏東縣,　萬丹鄉,四維村,36,448,1043,1527,20,1547,0,1547,438,1985,77.9345
第15任總統副總統,在屏東縣各村(里),屏東縣,　萬丹鄉,竹林村,37,331,892,1260,19,1279,0,1279,375,1654,77.3277
第15任總統副總統,在屏東縣各村(里),屏東縣,　萬丹鄉,水泉村,36,387,858,1281,13,1294,0,1294,349,1643,78.7584
第15任總統副總統,在屏東縣各村(里),屏東縣,　萬丹鄉,田厝村,20,138,565,723,7,730,0,730,193,923,79.0899
第15任總統副總統,在屏東縣各村(里),屏東縣,　萬丹鄉,崙頂村,31,383,946,1360,15,1375,0,1375,429,1804,76.2195
第15任總統副總統,在屏東縣各村(里),屏東縣,　萬丹鄉,厦北村,14,265,895,1174,19,1193,0,1193,355,1548,77.0672
第15任總統副總統,在屏東縣各村(里),屏東縣,　萬丹鄉,厦南村,18,321,706,1045,6,1051,0,1051,345,1396,75.2865
第15任總統副總統,在屏東縣各村(里),屏東縣,　萬丹鄉,後村村,16,210,547,773,11,784,0,784,203,987,79.4326
第15任總統副總統,在屏東縣各村(里),屏東縣,　萬丹鄉,灣內村,30,201,791,1022,11,1033,0,1033,286,1319,78.3169
第15任總統副總統,在屏東縣各村(里),屏東縣,　萬丹鄉,上村村,13,157,441,611,9,620,0,620,130,750,82.6667
第15任總統副總統,在屏東縣各村(里),屏東縣,　萬丹鄉,加興村,19,213,750,982,9,991,0,991,229,1220,81.2295
第15任總統副總統,在屏東縣各村(里),屏東縣,　萬丹鄉,社口村,24,319,701,1044,17,1061,0,1061,353,1414,75.0354
第15任總統副總統,在屏東縣各村(里),屏東縣,　萬丹鄉,磚寮村,27,215,485,727,6,733,0,733,194,927,79.0723
第15任總統副總統,在屏東縣各村(里),屏東縣,　萬丹鄉,社皮村,36,392,1076,1504,12,1516,0,1516,404,1920,78.9583
第15任總統副總統,在屏東縣各村(里),屏東縣,　萬丹鄉,社中村,32,269,928,1229,17,1246,0,1246,368,1614,77.1995
第15任總統副總統,在屏東縣各村(里),屏東縣,　萬丹鄉,社上村,28,320,892,1240,15,1255,0,1255,391,1646,76.2454
第15任總統副總統,在屏東縣各村(里),屏東縣,　萬丹鄉,廣安村,53,484,1205,1742,23,1765,0,1765,456,2221,79.4687
第15任總統副總統,在屏東縣各村(里),屏東縣,　長治鄉,進興村,62,665,1208,1935,17,1952,0,1952,657,2609,74.8179
第15任總統副總統,在屏東縣各村(里),屏東縣,　長治鄉,新潭村,80,1049,1496,2625,20,2645,0,2645,833,3478,76.0495
第15任總統副總統,在屏東縣各村(里),屏東縣,　長治鄉,潭頭村,56,469,924,1449,22,1471,0,1471,390,1861,79.0435
第15任總統副總統,在屏東縣各村(里),屏東縣,　長治鄉,香楊村,72,725,1111,1908,19,1927,0,1927,554,2481,77.6703
第15任總統副總統,在屏東縣各村(里),屏東縣,　長治鄉,長興村,24,299,472,795,8,803,0,803,239,1042,77.0633
第15任總統副總統,在屏東縣各村(里),屏東縣,　長治鄉,崙上村,26,415,806,1247,6,1253,0,1253,344,1597,78.4596
第15任總統副總統,在屏東縣各村(里),屏東縣,　長治鄉,德榮村,25,235,607,867,6,873,0,873,279,1152,75.7813
第15任總統副總統,在屏東縣各村(里),屏東縣,　長治鄉,德和村,8,123,410,541,4,545,0,545,187,732,74.4536
第15任總統副總統,在屏東縣各村(里),屏東縣,　長治鄉,復興村,26,365,724,1115,11,1126,0,1126,342,1468,76.7030
第15任總統副總統,在屏東縣各村(里),屏東縣,　長治鄉,德成村,15,231,421,667,9,676,0,676,175,851,79.4360
第15任總統副總統,在屏東縣各村(里),屏東縣,　長治鄉,德協村,10,229,572,811,3,814,0,814,244,1058,76.9376
第15任總統副總統,在屏東縣各村(里),屏東縣,　長治鄉,繁榮村,18,317,673,1008,11,1019,0,1019,384,1403,72.6301
第15任總統副總統,在屏東縣各村(里),屏東縣,　長治鄉,繁昌村,43,336,925,1304,12,1316,1,1317,397,1714,76.7795
第15任總統副總統,在屏東縣各村(里),屏東縣,　長治鄉,繁隆村,27,306,476,809,8,817,0,817,294,1111,73.5374
第15任總統副總統,在屏東縣各村(里),屏東縣,　長治鄉,繁華村,49,427,1251,1727,25,1752,0,1752,591,2343,74.7759
第15任總統副總統,在屏東縣各村(里),屏東縣,　長治鄉,榮華村,16,302,177,495,0,495,0,495,177,672,73.6607
第15任總統副總統,在屏東縣各村(里),屏東縣,　麟洛鄉,新田村,44,505,1134,1683,12,1695,0,1695,389,2084,81.3340
第15任總統副總統,在屏東縣各村(里),屏東縣,　麟洛鄉,麟頂村,24,221,469,714,9,723,0,723,184,907,79.7133
第15任總統副總統,在屏東縣各村(里),屏東縣,　麟洛鄉,麟蹄村,25,343,830,1198,9,1207,0,1207,294,1501,80.4131
第15任總統副總統,在屏東縣各村(里),屏東縣,　麟洛鄉,麟趾村,53,580,1334,1967,17,1984,0,1984,493,2477,80.0969
第15任總統副總統,在屏東縣各村(里),屏東縣,　麟洛鄉,田中村,29,263,642,934,7,941,0,941,233,1174,80.1533
第15任總統副總統,在屏東縣各村(里),屏東縣,　麟洛鄉,田心村,15,195,440,650,2,652,0,652,169,821,79.4153
第15任總統副總統,在屏東縣各村(里),屏東縣,　麟洛鄉,田道村,11,149,354,514,3,517,0,517,150,667,77.5112
第15任總統副總統,在屏東縣各村(里),屏東縣,　九如鄉,九清村,24,229,874,1127,12,1139,0,1139,302,1441,79.0423
第15任總統副總統,在屏東縣各村(里),屏東縣,　九如鄉,九塊村,26,236,790,1052,6,1058,0,1058,276,1334,79.3103
第15任總統副總統,在屏東縣各村(里),屏東縣,　九如鄉,九明村,35,285,947,1267,18,1285,0,1285,361,1646,78.0680
第15任總統副總統,在屏東縣各村(里),屏東縣,　九如鄉,大坵村,18,236,596,850,8,858,0,858,249,1107,77.5068
第15任總統副總統,在屏東縣各村(里),屏東縣,　九如鄉,玉水村,16,244,636,896,14,910,0,910,289,1199,75.8966
第15任總統副總統,在屏東縣各村(里),屏東縣,　九如鄉,玉泉村,47,345,771,1163,12,1175,0,1175,379,1554,75.6113
第15任總統副總統,在屏東縣各村(里),屏東縣,　九如鄉,東寧村,83,921,2356,3360,32,3392,0,3392,996,4388,77.3017
第15任總統副總統,在屏東縣各村(里),屏東縣,　九如鄉,三塊村,35,202,903,1140,4,1144,0,1144,402,1546,73.9974
第15任總統副總統,在屏東縣各村(里),屏東縣,　九如鄉,耆老村,15,241,671,927,7,934,0,934,286,1220,76.5574
第15任總統副總統,在屏東縣各村(里),屏東縣,　九如鄉,後庄村,32,281,1051,1364,19,1383,0,1383,349,1732,79.8499
第15任總統副總統,在屏東縣各村(里),屏東縣,　九如鄉,洽興村,29,289,751,1069,14,1083,0,1083,347,1430,75.7343
第15任總統副總統,在屏東縣各村(里),屏東縣,　里港鄉,玉田村,55,610,1670,2335,25,2360,0,2360,623,2983,79.1150
第15任總統副總統,在屏東縣各村(里),屏東縣,　里港鄉,塔樓村,34,264,875,1173,18,1191,0,1191,305,1496,79.6123
第15任總統副總統,在屏東縣各村(里),屏東縣,　里港鄉,潮厝村,26,257,879,1162,15,1177,0,1177,345,1522,77.3325
第15任總統副總統,在屏東縣各村(里),屏東縣,　里港鄉,大平村,26,271,548,845,4,849,0,849,252,1101,77.1117
第15任總統副總統,在屏東縣各村(里),屏東縣,　里港鄉,永春村,18,187,437,642,10,652,0,652,162,814,80.0983
第15任總統副總統,在屏東縣各村(里),屏東縣,　里港鄉,春林村,26,250,664,940,10,950,0,950,286,1236,76.8608
第15任總統副總統,在屏東縣各村(里),屏東縣,　里港鄉,過江村,40,413,1046,1499,13,1512,0,1512,445,1957,77.2611
第15任總統副總統,在屏東縣各村(里),屏東縣,　里港鄉,鐵店村,24,283,784,1091,11,1102,0,1102,296,1398,78.8269
第15任總統副總統,在屏東縣各村(里),屏東縣,　里港鄉,茄苳村,29,253,896,1178,10,1188,0,1188,309,1497,79.3587
第15任總統副總統,在屏東縣各村(里),屏東縣,　里港鄉,載興村,34,395,1370,1799,22,1821,0,1821,499,2320,78.4914
第15任總統副總統,在屏東縣各村(里),屏東縣,　里港鄉,土庫村,35,640,784,1459,16,1475,0,1475,511,1986,74.2699
第15任總統副總統,在屏東縣各村(里),屏東縣,　里港鄉,三廍村,29,429,897,1355,8,1363,0,1363,399,1762,77.3553
第15任總統副總統,在屏東縣各村(里),屏東縣,　里港鄉,中和村,22,224,453,699,6,705,0,705,230,935,75.4011
第15任總統副總統,在屏東縣各村(里),屏東縣,　里港鄉,瀰力村,7,120,278,405,3,408,0,408,90,498,81.9277
第15任總統副總統,在屏東縣各村(里),屏東縣,　鹽埔鄉,鹽北村,30,558,690,1278,13,1291,0,1291,467,1758,73.4357
第15任總統副總統,在屏東縣各村(里),屏東縣,　鹽埔鄉,鹽中村,39,653,950,1642,19,1661,0,1661,632,2293,72.4379
第15任總統副總統,在屏東縣各村(里),屏東縣,　鹽埔鄉,鹽南村,32,537,643,1212,16,1228,0,1228,440,1668,73.6211
第15任總統副總統,在屏東縣各村(里),屏東縣,　鹽埔鄉,仕絨村,27,335,380,742,7,749,3,752,261,1013,73.9388
第15任總統副總統,在屏東縣各村(里),屏東縣,　鹽埔鄉,高朗村,52,650,1273,1975,19,1994,0,1994,766,2760,72.2464
第15任總統副總統,在屏東縣各村(里),屏東縣,　鹽埔鄉,振興村,31,439,766,1236,19,1255,0,1255,538,1793,69.9944
第15任總統副總統,在屏東縣各村(里),屏東縣,　鹽埔鄉,久愛村,8,263,367,638,5,643,0,643,237,880,73.0682
第15任總統副總統,在屏東縣各村(里),屏東縣,　鹽埔鄉,新圍村,58,558,1592,2208,16,2224,0,2224,834,3058,72.7273
第15任總統副總統,在屏東縣各村(里),屏東縣,　鹽埔鄉,新二村,75,852,1541,2468,38,2506,0,2506,909,3415,73.3821
第15任總統副總統,在屏東縣各村(里),屏東縣,　鹽埔鄉,彭厝村,11,257,456,724,12,736,0,736,212,948,77.6371
第15任總統副總統,在屏東縣各村(里),屏東縣,　鹽埔鄉,洛陽村,34,387,712,1133,15,1148,1,1149,373,1522,75.4271
第15任總統副總統,在屏東縣各村(里),屏東縣,　鹽埔鄉,永隆村,16,108,270,394,6,400,0,400,136,536,74.6269
第15任總統副總統,在屏東縣各村(里),屏東縣,　高樹鄉,高樹村,26,371,1152,1549,11,1560,0,1560,502,2062,75.6547
第15任總統副總統,在屏東縣各村(里),屏東縣,　高樹鄉,長榮村,19,191,702,912,6,918,0,918,293,1211,75.8051
第15任總統副總統,在屏東縣各村(里),屏東縣,　高樹鄉,東興村,14,96,413,523,7,530,0,530,183,713,74.3338
第15任總統副總統,在屏東縣各村(里),屏東縣,　高樹鄉,東振村,6,129,298,433,6,439,0,439,141,580,75.6897
第15任總統副總統,在屏東縣各村(里),屏東縣,　高樹鄉,源泉村,25,201,509,735,13,748,0,748,233,981,76.2487
第15任總統副總統,在屏東縣各村(里),屏東縣,　高樹鄉,建興村,18,165,597,780,9,789,0,789,318,1107,71.2737
第15任總統副總統,在屏東縣各村(里),屏東縣,　高樹鄉,大埔村,10,127,271,408,3,411,0,411,174,585,70.2564
第15任總統副總統,在屏東縣各村(里),屏東縣,　高樹鄉,菜寮村,13,93,448,554,17,571,0,571,165,736,77.5815
第15任總統副總統,在屏東縣各村(里),屏東縣,　高樹鄉,司馬村,12,158,255,425,4,429,0,429,196,625,68.6400
第15任總統副總統,在屏東縣各村(里),屏東縣,　高樹鄉,舊寮村,20,248,575,843,7,850,0,850,350,1200,70.8333
第15任總統副總統,在屏東縣各村(里),屏東縣,　高樹鄉,新豐村,21,295,654,970,19,989,0,989,416,1405,70.3915
第15任總統副總統,在屏東縣各村(里),屏東縣,　高樹鄉,泰山村,21,369,820,1210,21,1231,0,1231,557,1788,68.8479
第15任總統副總統,在屏東縣各村(里),屏東縣,　高樹鄉,南華村,22,211,627,860,14,874,0,874,337,1211,72.1718
第15任總統副總統,在屏東縣各村(里),屏東縣,　高樹鄉,廣福村,23,204,543,770,4,774,0,774,255,1029,75.2187
第15任總統副總統,在屏東縣各村(里),屏東縣,　高樹鄉,廣興村,15,202,507,724,7,731,0,731,331,1062,68.8324
第15任總統副總統,在屏東縣各村(里),屏東縣,　高樹鄉,舊庄村,14,177,515,706,9,715,0,715,269,984,72.6626
第15任總統副總統,在屏東縣各村(里),屏東縣,　高樹鄉,田子村,16,193,507,716,16,732,0,732,296,1028,71.2062
第15任總統副總統,在屏東縣各村(里),屏東縣,　高樹鄉,鹽樹村,21,268,592,881,8,889,0,889,281,1170,75.9829
第15任總統副總統,在屏東縣各村(里),屏東縣,　高樹鄉,新南村,16,274,800,1090,4,1094,0,1094,381,1475,74.1695
第15任總統副總統,在屏東縣各村(里),屏東縣,　萬巒鄉,萬巒村,10,226,636,872,7,879,0,879,321,1200,73.2500
第15任總統副總統,在屏東縣各村(里),屏東縣,　萬巒鄉,萬全村,9,144,378,531,8,539,0,539,193,732,73.6339
第15任總統副總統,在屏東縣各村(里),屏東縣,　萬巒鄉,萬和村,25,346,861,1232,5,1237,0,1237,396,1633,75.7502
第15任總統副總統,在屏東縣各村(里),屏東縣,　萬巒鄉,鹿寮村,11,162,485,658,12,670,0,670,227,897,74.6934
第15任總統副總統,在屏東縣各村(里),屏東縣,　萬巒鄉,硫黃村,10,104,304,418,5,423,0,423,114,537,78.7709
第15任總統副總統,在屏東縣各村(里),屏東縣,　萬巒鄉,泗溝村,20,243,556,819,6,825,0,825,255,1080,76.3889
第15任總統副總統,在屏東縣各村(里),屏東縣,　萬巒鄉,五溝村,21,260,479,760,1,761,0,761,245,1006,75.6461
第15任總統副總統,在屏東縣各村(里),屏東縣,　萬巒鄉,成德村,22,327,691,1040,9,1049,0,1049,343,1392,75.3592
第15任總統副總統,在屏東縣各村(里),屏東縣,　萬巒鄉,赤山村,18,364,713,1095,4,1099,1,1100,515,1615,68.0495
第15任總統副總統,在屏東縣各村(里),屏東縣,　萬巒鄉,萬金村,28,375,1077,1480,9,1489,0,1489,477,1966,75.7375
第15任總統副總統,在屏東縣各村(里),屏東縣,　萬巒鄉,佳佐村,26,292,921,1239,8,1247,0,1247,382,1629,76.5500
第15任總統副總統,在屏東縣各村(里),屏東縣,　萬巒鄉,佳和村,22,357,688,1067,11,1078,0,1078,292,1370,78.6861
第15任總統副總統,在屏東縣各村(里),屏東縣,　萬巒鄉,新厝村,14,202,687,903,9,912,0,912,304,1216,75.0000
第15任總統副總統,在屏東縣各村(里),屏東縣,　萬巒鄉,新置村,16,282,551,849,5,854,0,854,304,1158,73.7478
第15任總統副總統,在屏東縣各村(里),屏東縣,　內埔鄉,內埔村,86,933,1724,2743,17,2760,1,2761,1114,3875,71.2258
第15任總統副總統,在屏東縣各村(里),屏東縣,　內埔鄉,內田村,47,714,1457,2218,25,2243,0,2243,814,3057,73.3726
第15任總統副總統,在屏東縣各村(里),屏東縣,　內埔鄉,興南村,24,292,660,976,8,984,0,984,295,1279,76.9351
第15任總統副總統,在屏東縣各村(里),屏東縣,　內埔鄉,義亭村,15,124,284,423,5,428,0,428,132,560,76.4286
第15任總統副總統,在屏東縣各村(里),屏東縣,　內埔鄉,美和村,46,503,993,1542,19,1561,0,1561,582,2143,72.8418
第15任總統副總統,在屏東縣各村(里),屏東縣,　內埔鄉,和興村,54,707,1280,2041,20,2061,0,2061,629,2690,76.6171
第15任總統副總統,在屏東縣各村(里),屏東縣,　內埔鄉,東寧村,106,1023,2101,3230,37,3267,0,3267,1052,4319,75.6425
第15任總統副總統,在屏東縣各村(里),屏東縣,　內埔鄉,豐田村,72,683,1440,2195,22,2217,0,2217,668,2885,76.8458
第15任總統副總統,在屏東縣各村(里),屏東縣,　內埔鄉,振豐村,31,379,822,1232,13,1245,0,1245,354,1599,77.8612
第15任總統副總統,在屏東縣各村(里),屏東縣,　內埔鄉,富田村,38,334,991,1363,16,1379,1,1380,455,1835,75.1499
第15任總統副總統,在屏東縣各村(里),屏東縣,　內埔鄉,竹圍村,29,363,905,1297,16,1313,0,1313,433,1746,75.2005
第15任總統副總統,在屏東縣各村(里),屏東縣,　內埔鄉,東勢村,54,500,1558,2112,18,2130,0,2130,700,2830,75.2650
第15任總統副總統,在屏東縣各村(里),屏東縣,　內埔鄉,東片村,21,181,512,714,5,719,0,719,187,906,79.3598
第15任總統副總統,在屏東縣各村(里),屏東縣,　內埔鄉,上樹村,19,195,602,816,7,823,0,823,242,1065,77.2770
第15任總統副總統,在屏東縣各村(里),屏東縣,　內埔鄉,老埤村,34,400,1114,1548,17,1565,0,1565,732,2297,68.1323
第15任總統副總統,在屏東縣各村(里),屏東縣,　內埔鄉,中林村,23,270,752,1045,13,1058,0,1058,429,1487,71.1500
第15任總統副總統,在屏東縣各村(里),屏東縣,　內埔鄉,龍泉村,50,692,943,1685,22,1707,0,1707,637,2344,72.8242
第15任總統副總統,在屏東縣各村(里),屏東縣,　內埔鄉,龍潭村,52,787,782,1621,13,1634,0,1634,678,2312,70.6747
第15任總統副總統,在屏東縣各村(里),屏東縣,　內埔鄉,建興村,14,177,367,558,11,569,0,569,250,819,69.4750
第15任總統副總統,在屏東縣各村(里),屏東縣,　內埔鄉,大新村,46,426,780,1252,13,1265,0,1265,440,1705,74.1935
第15任總統副總統,在屏東縣各村(里),屏東縣,　內埔鄉,黎明村,42,499,1154,1695,17,1712,0,1712,633,2345,73.0064
第15任總統副總統,在屏東縣各村(里),屏東縣,　內埔鄉,隘寮村,27,347,508,882,6,888,0,888,382,1270,69.9213
第15任總統副總統,在屏東縣各村(里),屏東縣,　內埔鄉,水門村,18,250,339,607,7,614,0,614,173,787,78.0178
第15任總統副總統,在屏東縣各村(里),屏東縣,　竹田鄉,竹田村,17,330,734,1081,7,1088,0,1088,333,1421,76.5658
第15任總統副總統,在屏東縣各村(里),屏東縣,　竹田鄉,竹南村,16,163,498,677,4,681,0,681,190,871,78.1860
第15任總統副總統,在屏東縣各村(里),屏東縣,　竹田鄉,糶糴村,14,174,366,554,1,555,0,555,125,680,81.6176
第15任總統副總統,在屏東縣各村(里),屏東縣,　竹田鄉,履豐村,9,122,321,452,6,458,0,458,105,563,81.3499
第15任總統副總統,在屏東縣各村(里),屏東縣,　竹田鄉,頭崙村,18,274,693,985,8,993,0,993,292,1285,77.2763
第15任總統副總統,在屏東縣各村(里),屏東縣,　竹田鄉,二崙村,23,229,512,764,7,771,0,771,192,963,80.0623
第15任總統副總統,在屏東縣各村(里),屏東縣,　竹田鄉,美崙村,13,137,351,501,4,505,0,505,131,636,79.4025
第15任總統副總統,在屏東縣各村(里),屏東縣,　竹田鄉,南勢村,6,93,272,371,4,375,0,375,77,452,82.9646
第15任總統副總統,在屏東縣各村(里),屏東縣,　竹田鄉,西勢村,40,587,1216,1843,23,1866,0,1866,542,2408,77.4917
第15任總統副總統,在屏東縣各村(里),屏東縣,　竹田鄉,福田村,8,100,284,392,4,396,0,396,74,470,84.2553
第15任總統副總統,在屏東縣各村(里),屏東縣,　竹田鄉,永豐村,11,162,386,559,4,563,0,563,279,842,66.8646
第15任總統副總統,在屏東縣各村(里),屏東縣,　竹田鄉,六巷村,13,172,430,615,6,621,0,621,150,771,80.5447
第15任總統副總統,在屏東縣各村(里),屏東縣,　竹田鄉,泗洲村,23,234,500,757,8,765,0,765,328,1093,69.9909
第15任總統副總統,在屏東縣各村(里),屏東縣,　竹田鄉,大湖村,13,278,629,920,10,930,0,930,258,1188,78.2828
第15任總統副總統,在屏東縣各村(里),屏東縣,　竹田鄉,鳳明村,28,302,537,867,8,875,0,875,272,1147,76.2860
第15任總統副總統,在屏東縣各村(里),屏東縣,　新埤鄉,新埤村,32,518,898,1448,14,1462,0,1462,483,1945,75.1671
第15任總統副總統,在屏東縣各村(里),屏東縣,　新埤鄉,建功村,16,290,506,812,10,822,0,822,237,1059,77.6204
第15任總統副總統,在屏東縣各村(里),屏東縣,　新埤鄉,打鐵村,13,246,412,671,2,673,0,673,216,889,75.7030
第15任總統副總統,在屏東縣各村(里),屏東縣,　新埤鄉,南豐村,11,175,332,518,3,521,0,521,204,725,71.8621
第15任總統副總統,在屏東縣各村(里),屏東縣,　新埤鄉,萬隆村,36,439,718,1193,10,1203,0,1203,477,1680,71.6071
第15任總統副總統,在屏東縣各村(里),屏東縣,　新埤鄉,餉潭村,37,239,594,870,10,880,0,880,376,1256,70.0637
第15任總統副總統,在屏東縣各村(里),屏東縣,　新埤鄉,箕湖村,28,247,453,728,10,738,0,738,346,1084,68.0812
第15任總統副總統,在屏東縣各村(里),屏東縣,　枋寮鄉,枋寮村,21,354,432,807,10,817,0,817,345,1162,70.3098
第15任總統副總統,在屏東縣各村(里),屏東縣,　枋寮鄉,新龍村,20,301,272,593,5,598,0,598,247,845,70.7692
第15任總統副總統,在屏東縣各村(里),屏東縣,　枋寮鄉,保生村,17,206,470,693,3,696,0,696,234,930,74.8387
第15任總統副總統,在屏東縣各村(里),屏東縣,　枋寮鄉,中寮村,13,130,290,433,1,434,0,434,162,596,72.8188
第15任總統副總統,在屏東縣各村(里),屏東縣,　枋寮鄉,安樂村,37,343,771,1151,9,1160,0,1160,400,1560,74.3590
第15任總統副總統,在屏東縣各村(里),屏東縣,　枋寮鄉,隆山村,61,841,1992,2894,21,2915,0,2915,1102,4017,72.5666
第15任總統副總統,在屏東縣各村(里),屏東縣,　枋寮鄉,天時村,44,367,1004,1415,18,1433,0,1433,462,1895,75.6201
第15任總統副總統,在屏東縣各村(里),屏東縣,　枋寮鄉,地利村,27,361,701,1089,5,1094,0,1094,329,1423,76.8798
第15任總統副總統,在屏東縣各村(里),屏東縣,　枋寮鄉,人和村,42,518,945,1505,10,1515,0,1515,516,2031,74.5938
第15任總統副總統,在屏東縣各村(里),屏東縣,　枋寮鄉,內寮村,5,96,348,449,1,450,0,450,234,684,65.7895
第15任總統副總統,在屏東縣各村(里),屏東縣,　枋寮鄉,新開村,11,198,359,568,1,569,0,569,295,864,65.8565
第15任總統副總統,在屏東縣各村(里),屏東縣,　枋寮鄉,東海村,39,759,1192,1990,17,2007,0,2007,667,2674,75.0561
第15任總統副總統,在屏東縣各村(里),屏東縣,　枋寮鄉,大庄村,8,153,304,465,4,469,0,469,141,610,76.8852
第15任總統副總統,在屏東縣各村(里),屏東縣,　枋寮鄉,太源村,21,234,377,632,5,637,0,637,294,931,68.4211
第15任總統副總統,在屏東縣各村(里),屏東縣,　枋寮鄉,玉泉村,7,129,164,300,3,303,0,303,119,422,71.8009
第15任總統副總統,在屏東縣各村(里),屏東縣,　新園鄉,瓦磘村,33,281,956,1270,10,1280,0,1280,331,1611,79.4538
第15任總統副總統,在屏東縣各村(里),屏東縣,　新園鄉,仙吉村,50,516,1282,1848,22,1870,0,1870,563,2433,76.8598
第15任總統副總統,在屏東縣各村(里),屏東縣,　新園鄉,田洋村,48,397,1223,1668,14,1682,1,1683,415,2098,80.1716
第15任總統副總統,在屏東縣各村(里),屏東縣,　新園鄉,港墘村,15,161,451,627,9,636,0,636,164,800,79.5000
第15任總統副總統,在屏東縣各村(里),屏東縣,　新園鄉,內庄村,20,181,423,624,8,632,0,632,178,810,78.0247
第15任總統副總統,在屏東縣各村(里),屏東縣,　新園鄉,新東村,65,541,1109,1715,18,1733,0,1733,525,2258,76.7493
第15任總統副總統,在屏東縣各村(里),屏東縣,　新園鄉,新園村,49,496,1119,1664,10,1674,0,1674,503,2177,76.8948
第15任總統副總統,在屏東縣各村(里),屏東縣,　新園鄉,港西村,31,483,1089,1603,7,1610,0,1610,458,2068,77.8530
第15任總統副總統,在屏東縣各村(里),屏東縣,　新園鄉,烏龍村,23,221,696,940,17,957,0,957,240,1197,79.9499
第15任總統副總統,在屏東縣各村(里),屏東縣,　新園鄉,興龍村,57,353,1258,1668,21,1689,0,1689,420,2109,80.0853
第15任總統副總統,在屏東縣各村(里),屏東縣,　新園鄉,中洲村,24,198,1002,1224,12,1236,0,1236,328,1564,79.0281
第15任總統副總統,在屏東縣各村(里),屏東縣,　新園鄉,南龍村,29,200,844,1073,8,1081,0,1081,287,1368,79.0205
第15任總統副總統,在屏東縣各村(里),屏東縣,　新園鄉,五房村,54,606,1374,2034,18,2052,0,2052,661,2713,75.6358
第15任總統副總統,在屏東縣各村(里),屏東縣,　新園鄉,鹽埔村,73,703,2360,3136,35,3171,0,3171,1061,4232,74.9291
第15任總統副總統,在屏東縣各村(里),屏東縣,　新園鄉,共和村,30,333,1275,1638,17,1655,0,1655,558,2213,74.7854
第15任總統副總統,在屏東縣各村(里),屏東縣,　崁頂鄉,崁頂村,50,543,1065,1658,15,1673,0,1673,486,2159,77.4896
第15任總統副總統,在屏東縣各村(里),屏東縣,　崁頂鄉,園寮村,49,448,955,1452,10,1462,0,1462,491,1953,74.8592
第15任總統副總統,在屏東縣各村(里),屏東縣,　崁頂鄉,力社村,30,252,682,964,10,974,1,975,294,1269,76.7533
第15任總統副總統,在屏東縣各村(里),屏東縣,　崁頂鄉,圍內村,25,258,609,892,12,904,0,904,281,1185,76.2869
第15任總統副總統,在屏東縣各村(里),屏東縣,　崁頂鄉,洲子村,16,187,538,741,12,753,0,753,259,1012,74.4071
第15任總統副總統,在屏東縣各村(里),屏東縣,　崁頂鄉,北勢村,23,295,773,1091,16,1107,0,1107,372,1479,74.8479
第15任總統副總統,在屏東縣各村(里),屏東縣,　崁頂鄉,越溪村,13,203,484,700,4,704,0,704,213,917,76.7721
第15任總統副總統,在屏東縣各村(里),屏東縣,　崁頂鄉,港東村,39,290,1055,1384,17,1401,0,1401,417,1818,77.0627
第15任總統副總統,在屏東縣各村(里),屏東縣,　林邊鄉,林邊村,20,275,762,1057,12,1069,0,1069,315,1384,77.2399
第15任總統副總統,在屏東縣各村(里),屏東縣,　林邊鄉,光林村,24,321,817,1162,17,1179,1,1180,336,1516,77.7704
第15任總統副總統,在屏東縣各村(里),屏東縣,　林邊鄉,永樂村,63,629,1697,2389,23,2412,0,2412,639,3051,79.0560
第15任總統副總統,在屏東縣各村(里),屏東縣,　林邊鄉,中林村,11,192,349,552,5,557,0,557,144,701,79.4579
第15任總統副總統,在屏東縣各村(里),屏東縣,　林邊鄉,仁和村,26,348,865,1239,16,1255,0,1255,352,1607,78.0958
第15任總統副總統,在屏東縣各村(里),屏東縣,　林邊鄉,田厝村,14,176,476,666,7,673,0,673,209,882,76.3039
第15任總統副總統,在屏東縣各村(里),屏東縣,　林邊鄉,崎峯村,31,250,600,881,7,888,0,888,349,1237,71.7866
第15任總統副總統,在屏東縣各村(里),屏東縣,　林邊鄉,水利村,16,408,841,1265,11,1276,0,1276,476,1752,72.8311
第15任總統副總統,在屏東縣各村(里),屏東縣,　林邊鄉,竹林村,39,397,952,1388,14,1402,1,1403,479,1882,74.4952
第15任總統副總統,在屏東縣各村(里),屏東縣,　林邊鄉,鎮安村,20,239,595,854,8,862,1,863,234,1097,78.5779
第15任總統副總統,在屏東縣各村(里),屏東縣,　南州鄉,溪洲村,30,361,825,1216,3,1219,0,1219,404,1623,75.1078
第15任總統副總統,在屏東縣各村(里),屏東縣,　南州鄉,溪南村,18,236,474,728,6,734,0,734,193,927,79.1802
第15任總統副總統,在屏東縣各村(里),屏東縣,　南州鄉,七塊村,34,222,495,751,2,753,0,753,239,992,75.9073
第15任總統副總統,在屏東縣各村(里),屏東縣,　南州鄉,萬華村,24,218,473,715,9,724,0,724,243,967,74.8707
第15任總統副總統,在屏東縣各村(里),屏東縣,　南州鄉,仁里村,10,105,246,361,5,366,0,366,105,471,77.7070
第15任總統副總統,在屏東縣各村(里),屏東縣,　南州鄉,溪北村,19,264,270,553,5,558,0,558,125,683,81.6984
第15任總統副總統,在屏東縣各村(里),屏東縣,　南州鄉,米崙村,19,243,509,771,7,778,0,778,239,1017,76.4995
第15任總統副總統,在屏東縣各村(里),屏東縣,　南州鄉,壽元村,5,137,627,769,7,776,0,776,275,1051,73.8344
第15任總統副總統,在屏東縣各村(里),屏東縣,　南州鄉,同安村,13,185,515,713,6,719,0,719,216,935,76.8984
第15任總統副總統,在屏東縣各村(里),屏東縣,　南州鄉,南安村,13,96,288,397,3,400,0,400,121,521,76.7754
第15任總統副總統,在屏東縣各村(里),屏東縣,　佳冬鄉,佳冬村,19,341,703,1063,6,1069,0,1069,361,1430,74.7552
第15任總統副總統,在屏東縣各村(里),屏東縣,　佳冬鄉,六根村,16,312,622,950,5,955,0,955,340,1295,73.7452
第15任總統副總統,在屏東縣各村(里),屏東縣,　佳冬鄉,賴家村,12,157,415,584,5,589,0,589,176,765,76.9935
第15任總統副總統,在屏東縣各村(里),屏東縣,　佳冬鄉,萬建村,28,385,852,1265,14,1279,0,1279,457,1736,73.6751
第15任總統副總統,在屏東縣各村(里),屏東縣,　佳冬鄉,石光村,18,332,1089,1439,22,1461,0,1461,457,1918,76.1731
第15任總統副總統,在屏東縣各村(里),屏東縣,　佳冬鄉,玉光村,26,353,1131,1510,11,1521,0,1521,550,2071,73.4428
第15任總統副總統,在屏東縣各村(里),屏東縣,　佳冬鄉,昌隆村,12,240,462,714,11,725,0,725,225,950,76.3158
第15任總統副總統,在屏東縣各村(里),屏東縣,　佳冬鄉,豐隆村,10,144,376,530,5,535,0,535,164,699,76.5379
第15任總統副總統,在屏東縣各村(里),屏東縣,　佳冬鄉,大同村,22,212,631,865,9,874,0,874,256,1130,77.3451
第15任總統副總統,在屏東縣各村(里),屏東縣,　佳冬鄉,羌園村,10,178,592,780,9,789,0,789,249,1038,76.0116
第15任總統副總統,在屏東縣各村(里),屏東縣,　佳冬鄉,燄溫村,17,250,496,763,13,776,0,776,278,1054,73.6243
第15任總統副總統,在屏東縣各村(里),屏東縣,　佳冬鄉,塭豐村,29,619,1039,1687,8,1695,0,1695,650,2345,72.2814
第15任總統副總統,在屏東縣各村(里),屏東縣,　琉球鄉,本福村,33,563,711,1307,13,1320,0,1320,709,2029,65.0567
第15任總統副總統,在屏東縣各村(里),屏東縣,　琉球鄉,中福村,20,365,391,776,6,782,0,782,445,1227,63.7327
第15任總統副總統,在屏東縣各村(里),屏東縣,　琉球鄉,漁福村,13,358,207,578,5,583,0,583,354,937,62.2199
第15任總統副總統,在屏東縣各村(里),屏東縣,　琉球鄉,大福村,39,518,372,929,6,935,0,935,671,1606,58.2192
第15任總統副總統,在屏東縣各村(里),屏東縣,　琉球鄉,南福村,15,346,291,652,10,662,0,662,444,1106,59.8553
第15任總統副總統,在屏東縣各村(里),屏東縣,　琉球鄉,天福村,25,309,284,618,6,624,0,624,415,1039,60.0577
第15任總統副總統,在屏東縣各村(里),屏東縣,　琉球鄉,上福村,28,491,367,886,10,896,0,896,665,1561,57.3991
第15任總統副總統,在屏東縣各村(里),屏東縣,　琉球鄉,杉福村,11,246,247,504,4,508,0,508,322,830,61.2048
第15任總統副總統,在屏東縣各村(里),屏東縣,　車城鄉,海口村,7,172,276,455,4,459,0,459,260,719,63.8387
第15任總統副總統,在屏東縣各村(里),屏東縣,　車城鄉,田中村,14,124,241,379,3,382,0,382,231,613,62.3165
第15任總統副總統,在屏東縣各村(里),屏東縣,　車城鄉,福興村,25,305,549,879,8,887,0,887,395,1282,69.1888
第15任總統副總統,在屏東縣各村(里),屏東縣,　車城鄉,福安村,7,89,281,377,4,381,0,381,147,528,72.1591
第15任總統副總統,在屏東縣各村(里),屏東縣,　車城鄉,統埔村,7,86,148,241,1,242,0,242,135,377,64.1910
第15任總統副總統,在屏東縣各村(里),屏東縣,　車城鄉,溫泉村,21,188,350,559,10,569,0,569,296,865,65.7803
第15任總統副總統,在屏東縣各村(里),屏東縣,　車城鄉,保力村,10,290,454,754,11,765,0,765,412,1177,64.9958
第15任總統副總統,在屏東縣各村(里),屏東縣,　車城鄉,新街村,7,71,220,298,1,299,0,299,120,419,71.3604
第15任總統副總統,在屏東縣各村(里),屏東縣,　車城鄉,埔墘村,4,108,154,266,4,270,0,270,140,410,65.8537
第15任總統副總統,在屏東縣各村(里),屏東縣,　車城鄉,射寮村,6,107,197,310,4,314,0,314,151,465,67.5269
第15任總統副總統,在屏東縣各村(里),屏東縣,　車城鄉,後灣村,5,76,171,252,2,254,0,254,142,396,64.1414
第15任總統副總統,在屏東縣各村(里),屏東縣,　滿州鄉,滿州村,23,350,548,921,5,926,0,926,495,1421,65.1654
第15任總統副總統,在屏東縣各村(里),屏東縣,　滿州鄉,里德村,10,82,136,228,5,233,0,233,164,397,58.6902
第15任總統副總統,在屏東縣各村(里),屏東縣,　滿州鄉,响林村,15,77,237,329,1,330,0,330,235,565,58.4071
第15任總統副總統,在屏東縣各村(里),屏東縣,　滿州鄉,永靖村,25,323,387,735,8,743,0,743,480,1223,60.7522
第15任總統副總統,在屏東縣各村(里),屏東縣,　滿州鄉,港口村,13,236,538,787,6,793,0,793,413,1206,65.7546
第15任總統副總統,在屏東縣各村(里),屏東縣,　滿州鄉,長樂村,26,354,326,706,16,722,0,722,535,1257,57.4383
第15任總統副總統,在屏東縣各村(里),屏東縣,　滿州鄉,九棚村,4,72,117,193,1,194,0,194,157,351,55.2707
第15任總統副總統,在屏東縣各村(里),屏東縣,　滿州鄉,港仔村,2,65,112,179,4,183,0,183,114,297,61.6162
第15任總統副總統,在屏東縣各村(里),屏東縣,　枋山鄉,枋山村,20,300,372,692,10,702,0,702,268,970,72.3711
第15任總統副總統,在屏東縣各村(里),屏東縣,　枋山鄉,加祿村,24,455,906,1385,11,1396,0,1396,420,1816,76.8722
第15任總統副總統,在屏東縣各村(里),屏東縣,　枋山鄉,楓港村,7,135,478,620,4,624,0,624,356,980,63.6735
第15任總統副總統,在屏東縣各村(里),屏東縣,　枋山鄉,善餘村,2,146,368,516,4,520,0,520,319,839,61.9785
第15任總統副總統,在屏東縣各村(里),屏東縣,　三地門鄉,大社村,12,341,100,453,5,458,0,458,140,598,76.5886
第15任總統副總統,在屏東縣各村(里),屏東縣,　三地門鄉,德文村,17,231,149,397,4,401,0,401,156,557,71.9928
第15任總統副總統,在屏東縣各村(里),屏東縣,　三地門鄉,達來村,9,159,57,225,0,225,0,225,96,321,70.0935
第15任總統副總統,在屏東縣各村(里),屏東縣,　三地門鄉,三地村,30,805,300,1135,11,1146,0,1146,260,1406,81.5078
第15任總統副總統,在屏東縣各村(里),屏東縣,　三地門鄉,賽嘉村,12,373,113,498,7,505,0,505,202,707,71.4286
第15任總統副總統,在屏東縣各村(里),屏東縣,　三地門鄉,口社村,19,297,103,419,2,421,0,421,110,531,79.2844
第15任總統副總統,在屏東縣各村(里),屏東縣,　三地門鄉,馬兒村,9,174,78,261,5,266,0,266,71,337,78.9318
第15任總統副總統,在屏東縣各村(里),屏東縣,　三地門鄉,安坡村,10,245,87,342,1,343,0,343,110,453,75.7174
第15任總統副總統,在屏東縣各村(里),屏東縣,　三地門鄉,青山村,10,409,127,546,7,553,0,553,122,675,81.9259
第15任總統副總統,在屏東縣各村(里),屏東縣,　三地門鄉,青葉村,13,314,125,452,3,455,0,455,155,610,74.5902
第15任總統副總統,在屏東縣各村(里),屏東縣,　霧臺鄉,霧台村,23,569,296,888,4,892,0,892,221,1113,80.1438
第15任總統副總統,在屏東縣各村(里),屏東縣,　霧臺鄉,吉露村,5,103,29,137,0,137,0,137,38,175,78.2857
第15任總統副總統,在屏東縣各村(里),屏東縣,　霧臺鄉,阿禮村,7,172,58,237,1,238,0,238,54,292,81.5068
第15任總統副總統,在屏東縣各村(里),屏東縣,　霧臺鄉,好茶村,13,227,156,396,3,399,0,399,85,484,82.4380
第15任總統副總統,在屏東縣各村(里),屏東縣,　霧臺鄉,佳暮村,12,200,51,263,3,266,0,266,71,337,78.9318
第15任總統副總統,在屏東縣各村(里),屏東縣,　霧臺鄉,大武村,9,225,79,313,2,315,0,315,123,438,71.9178
第15任總統副總統,在屏東縣各村(里),屏東縣,　瑪家鄉,瑪家村,13,216,114,343,5,348,0,348,89,437,79.6339
第15任總統副總統,在屏東縣各村(里),屏東縣,　瑪家鄉,北葉村,12,432,144,588,3,591,0,591,167,758,77.9683
第15任總統副總統,在屏東縣各村(里),屏東縣,　瑪家鄉,三和村,49,1147,361,1557,10,1567,0,1567,408,1975,79.3418
第15任總統副總統,在屏東縣各村(里),屏東縣,　瑪家鄉,凉山村,11,542,194,747,8,755,0,755,262,1017,74.2380
第15任總統副總統,在屏東縣各村(里),屏東縣,　瑪家鄉,佳義村,32,425,221,678,5,683,0,683,176,859,79.5111
第15任總統副總統,在屏東縣各村(里),屏東縣,　瑪家鄉,排灣村,13,227,78,318,2,320,0,320,93,413,77.4818
第15任總統副總統,在屏東縣各村(里),屏東縣,　泰武鄉,佳平村,15,494,148,657,6,663,0,663,161,824,80.4612
第15任總統副總統,在屏東縣各村(里),屏東縣,　泰武鄉,武潭村,20,524,144,688,2,690,0,690,205,895,77.0950
第15任總統副總統,在屏東縣各村(里),屏東縣,　泰武鄉,平和村,13,246,232,491,6,497,0,497,87,584,85.1027
第15任總統副總統,在屏東縣各村(里),屏東縣,　泰武鄉,萬安村,25,454,103,582,3,585,0,585,164,749,78.1041
第15任總統副總統,在屏東縣各村(里),屏東縣,　泰武鄉,佳興村,3,224,53,280,1,281,0,281,124,405,69.3827
第15任總統副總統,在屏東縣各村(里),屏東縣,　泰武鄉,泰武村,19,450,117,586,6,592,0,592,181,773,76.5847
第15任總統副總統,在屏東縣各村(里),屏東縣,　來義鄉,來義村,20,474,149,643,4,647,0,647,248,895,72.2905
第15任總統副總統,在屏東縣各村(里),屏東縣,　來義鄉,義林村,11,313,112,436,3,439,0,439,128,567,77.4250
第15任總統副總統,在屏東縣各村(里),屏東縣,　來義鄉,丹林村,17,423,87,527,5,532,0,532,166,698,76.2178
第15任總統副總統,在屏東縣各村(里),屏東縣,　來義鄉,古樓村,34,552,199,785,6,791,0,791,274,1065,74.2723
第15任總統副總統,在屏東縣各村(里),屏東縣,　來義鄉,文樂村,18,445,130,593,6,599,0,599,204,803,74.5953
第15任總統副總統,在屏東縣各村(里),屏東縣,　來義鄉,望嘉村,15,518,128,661,4,665,0,665,195,860,77.3256
第15任總統副總統,在屏東縣各村(里),屏東縣,　來義鄉,南和村,39,650,196,885,9,894,0,894,292,1186,75.3794
第15任總統副總統,在屏東縣各村(里),屏東縣,　春日鄉,春日村,23,431,137,591,4,595,0,595,294,889,66.9291
第15任總統副總統,在屏東縣各村(里),屏東縣,　春日鄉,古華村,16,336,126,478,5,483,0,483,163,646,74.7678
第15任總統副總統,在屏東縣各村(里),屏東縣,　春日鄉,士文村,3,149,31,183,2,185,0,185,113,298,62.0805
第15任總統副總統,在屏東縣各村(里),屏東縣,　春日鄉,七佳村,15,472,161,648,5,653,0,653,245,898,72.7171
第15任總統副總統,在屏東縣各村(里),屏東縣,　春日鄉,歸崇村,12,363,78,453,4,457,0,457,174,631,72.4247
第15任總統副總統,在屏東縣各村(里),屏東縣,　春日鄉,力里村,11,249,76,336,7,343,0,343,128,471,72.8238
第15任總統副總統,在屏東縣各村(里),屏東縣,　獅子鄉,楓林村,14,358,134,506,1,507,0,507,198,705,71.9149
第15任總統副總統,在屏東縣各村(里),屏東縣,　獅子鄉,丹路村,17,407,113,537,3,540,0,540,217,757,71.3342
第15任總統副總統,在屏東縣各村(里),屏東縣,　獅子鄉,草埔村,13,385,72,470,1,471,0,471,185,656,71.7988
第15任總統副總統,在屏東縣各村(里),屏東縣,　獅子鄉,內文村,6,131,34,171,1,172,0,172,59,231,74.4589
第15任總統副總統,在屏東縣各村(里),屏東縣,　獅子鄉,竹坑村,7,155,55,217,3,220,0,220,78,298,73.8255
第15任總統副總統,在屏東縣各村(里),屏東縣,　獅子鄉,獅子村,5,233,89,327,4,331,0,331,136,467,70.8779
第15任總統副總統,在屏東縣各村(里),屏東縣,　獅子鄉,內獅村,14,357,77,448,6,454,0,454,133,587,77.3424
第15任總統副總統,在屏東縣各村(里),屏東縣,　獅子鄉,南世村,7,213,48,268,2,270,0,270,75,345,78.2609
第15任總統副總統,在屏東縣各村(里),屏東縣,　牡丹鄉,石門村,37,785,281,1103,8,1111,0,1111,448,1559,71.2636
第15任總統副總統,在屏東縣各村(里),屏東縣,　牡丹鄉,牡丹村,10,344,95,449,4,453,0,453,197,650,69.6923
第15任總統副總統,在屏東縣各村(里),屏東縣,　牡丹鄉,東源村,10,220,74,304,4,308,0,308,110,418,73.6842
第15任總統副總統,在屏東縣各村(里),屏東縣,　牡丹鄉,旭海村,14,151,63,228,1,229,0,229,133,362,63.2597
第15任總統副總統,在屏東縣各村(里),屏東縣,　牡丹鄉,高士村,12,301,79,392,4,396,0,396,165,561,70.5882
第15任總統副總統,在屏東縣各村(里),屏東縣,　牡丹鄉,四林村,17,205,53,275,4,279,0,279,256,535,52.1495
第15任總統副總統,在宜蘭縣各村(里),宜蘭縣,　宜蘭市,民族里,68,679,869,1616,17,1633,0,1633,518,2151,75.9182
第15任總統副總統,在宜蘭縣各村(里),宜蘭縣,　宜蘭市,建軍里,48,453,682,1183,18,1201,0,1201,360,1561,76.9379
第15任總統副總統,在宜蘭縣各村(里),宜蘭縣,　宜蘭市,泰山里,50,568,749,1367,16,1383,0,1383,555,1938,71.3622
第15任總統副總統,在宜蘭縣各村(里),宜蘭縣,　宜蘭市,負郭里,93,776,1217,2086,28,2114,0,2114,703,2817,75.0444
第15任總統副總統,在宜蘭縣各村(里),宜蘭縣,　宜蘭市,思源里,156,1318,1719,3193,32,3225,0,3225,922,4147,77.7671
第15任總統副總統,在宜蘭縣各村(里),宜蘭縣,　宜蘭市,七結里,81,778,979,1838,28,1866,0,1866,546,2412,77.3632
第15任總統副總統,在宜蘭縣各村(里),宜蘭縣,　宜蘭市,文化里,85,824,1215,2124,27,2151,0,2151,747,2898,74.2236
第15任總統副總統,在宜蘭縣各村(里),宜蘭縣,　宜蘭市,復興里,75,903,964,1942,19,1961,0,1961,637,2598,75.4811
第15任總統副總統,在宜蘭縣各村(里),宜蘭縣,　宜蘭市,民權里,39,465,546,1050,17,1067,0,1067,651,1718,62.1071
第15任總統副總統,在宜蘭縣各村(里),宜蘭縣,　宜蘭市,神農里,76,790,1022,1888,27,1915,0,1915,628,2543,75.3048
第15任總統副總統,在宜蘭縣各村(里),宜蘭縣,　宜蘭市,大新里,32,198,323,553,8,561,0,561,183,744,75.4032
第15任總統副總統,在宜蘭縣各村(里),宜蘭縣,　宜蘭市,新民里,53,374,698,1125,12,1137,0,1137,356,1493,76.1554
第15任總統副總統,在宜蘭縣各村(里),宜蘭縣,　宜蘭市,進士里,72,608,885,1565,17,1582,0,1582,473,2055,76.9830
第15任總統副總統,在宜蘭縣各村(里),宜蘭縣,　宜蘭市,南橋里,30,296,575,901,11,912,0,912,278,1190,76.6387
第15任總統副總統,在宜蘭縣各村(里),宜蘭縣,　宜蘭市,凱旋里,35,284,617,936,9,945,0,945,306,1251,75.5396
第15任總統副總統,在宜蘭縣各村(里),宜蘭縣,　宜蘭市,南津里,52,704,736,1492,21,1513,0,1513,487,2000,75.6500
第15任總統副總統,在宜蘭縣各村(里),宜蘭縣,　宜蘭市,建業里,57,425,796,1278,17,1295,0,1295,390,1685,76.8546
第15任總統副總統,在宜蘭縣各村(里),宜蘭縣,　宜蘭市,擺厘里,87,842,1216,2145,20,2165,0,2165,690,2855,75.8319
第15任總統副總統,在宜蘭縣各村(里),宜蘭縣,　宜蘭市,延平里,115,884,1393,2392,24,2416,0,2416,716,3132,77.1392
第15任總統副總統,在宜蘭縣各村(里),宜蘭縣,　宜蘭市,成功里,94,785,1297,2176,26,2202,0,2202,753,2955,74.5178
第15任總統副總統,在宜蘭縣各村(里),宜蘭縣,　宜蘭市,東村里,71,574,1002,1647,17,1664,0,1664,463,2127,78.2323
第15任總統副總統,在宜蘭縣各村(里),宜蘭縣,　宜蘭市,新東里,89,800,1336,2225,17,2242,0,2242,781,3023,74.1647
第15任總統副總統,在宜蘭縣各村(里),宜蘭縣,　宜蘭市,黎明里,55,418,855,1328,14,1342,0,1342,422,1764,76.0771
第15任總統副總統,在宜蘭縣各村(里),宜蘭縣,　宜蘭市,七張里,41,284,740,1065,9,1074,0,1074,360,1434,74.8954
第15任總統副總統,在宜蘭縣各村(里),宜蘭縣,　宜蘭市,孝廉里,40,251,556,847,11,858,0,858,300,1158,74.0933
第15任總統副總統,在宜蘭縣各村(里),宜蘭縣,　宜蘭市,東門里,26,221,451,698,9,707,0,707,216,923,76.5980
第15任總統副總統,在宜蘭縣各村(里),宜蘭縣,　宜蘭市,小東里,46,430,741,1217,8,1225,0,1225,348,1573,77.8767
第15任總統副總統,在宜蘭縣各村(里),宜蘭縣,　宜蘭市,菜園里,35,341,570,946,11,957,0,957,339,1296,73.8426
第15任總統副總統,在宜蘭縣各村(里),宜蘭縣,　宜蘭市,慈安里,61,422,727,1210,8,1218,0,1218,535,1753,69.4809
第15任總統副總統,在宜蘭縣各村(里),宜蘭縣,　宜蘭市,中興里,100,732,1121,1953,23,1976,0,1976,817,2793,70.7483
第15任總統副總統,在宜蘭縣各村(里),宜蘭縣,　宜蘭市,新生里,69,529,1269,1867,19,1886,0,1886,659,2545,74.1061
第15任總統副總統,在宜蘭縣各村(里),宜蘭縣,　宜蘭市,茭白里,71,473,914,1458,18,1476,0,1476,519,1995,73.9850
第15任總統副總統,在宜蘭縣各村(里),宜蘭縣,　宜蘭市,北津里,65,475,1081,1621,13,1634,0,1634,533,2167,75.4038
第15任總統副總統,在宜蘭縣各村(里),宜蘭縣,　宜蘭市,梅洲里,95,642,1518,2255,21,2276,0,2276,753,3029,75.1403
第15任總統副總統,在宜蘭縣各村(里),宜蘭縣,　宜蘭市,南門里,44,321,647,1012,13,1025,0,1025,316,1341,76.4355
第15任總統副總統,在宜蘭縣各村(里),宜蘭縣,　宜蘭市,中山里,29,244,375,648,10,658,0,658,251,909,72.3872
第15任總統副總統,在宜蘭縣各村(里),宜蘭縣,　宜蘭市,西門里,60,384,845,1289,12,1301,0,1301,381,1682,77.3484
第15任總統副總統,在宜蘭縣各村(里),宜蘭縣,　宜蘭市,北門里,37,245,568,850,8,858,0,858,254,1112,77.1583
第15任總統副總統,在宜蘭縣各村(里),宜蘭縣,　羅東鎮,開明里,30,279,712,1021,9,1030,0,1030,319,1349,76.3529
第15任總統副總統,在宜蘭縣各村(里),宜蘭縣,　羅東鎮,大新里,52,328,666,1046,18,1064,0,1064,386,1450,73.3793
第15任總統副總統,在宜蘭縣各村(里),宜蘭縣,　羅東鎮,東安里,99,746,1698,2543,19,2562,0,2562,825,3387,75.6422
第15任總統副總統,在宜蘭縣各村(里),宜蘭縣,　羅東鎮,新群里,83,509,1344,1936,20,1956,0,1956,618,2574,75.9907
第15任總統副總統,在宜蘭縣各村(里),宜蘭縣,　羅東鎮,羅莊里,79,709,1389,2177,17,2194,0,2194,721,2915,75.2659
第15任總統副總統,在宜蘭縣各村(里),宜蘭縣,　羅東鎮,南昌里,83,590,1040,1713,11,1724,0,1724,571,2295,75.1198
第15任總統副總統,在宜蘭縣各村(里),宜蘭縣,　羅東鎮,南豪里,33,316,608,957,7,964,0,964,310,1274,75.6672
第15任總統副總統,在宜蘭縣各村(里),宜蘭縣,　羅東鎮,成功里,42,360,718,1120,14,1134,0,1134,288,1422,79.7468
第15任總統副總統,在宜蘭縣各村(里),宜蘭縣,　羅東鎮,仁德里,26,270,511,807,9,816,0,816,295,1111,73.4473
第15任總統副總統,在宜蘭縣各村(里),宜蘭縣,　羅東鎮,仁和里,31,228,458,717,9,726,0,726,248,974,74.5380
第15任總統副總統,在宜蘭縣各村(里),宜蘭縣,　羅東鎮,中山里,35,309,676,1020,11,1031,0,1031,304,1335,77.2285
第15任總統副總統,在宜蘭縣各村(里),宜蘭縣,　羅東鎮,漢民里,115,859,1641,2615,17,2632,0,2632,900,3532,74.5187
第15任總統副總統,在宜蘭縣各村(里),宜蘭縣,　羅東鎮,維揚里,78,740,1364,2182,20,2202,0,2202,657,2859,77.0199
第15任總統副總統,在宜蘭縣各村(里),宜蘭縣,　羅東鎮,西安里,81,653,1322,2056,20,2076,0,2076,671,2747,75.5734
第15任總統副總統,在宜蘭縣各村(里),宜蘭縣,　羅東鎮,北成里,88,581,1340,2009,11,2020,0,2020,661,2681,75.3450
第15任總統副總統,在宜蘭縣各村(里),宜蘭縣,　羅東鎮,國華里,117,1110,1909,3136,36,3172,0,3172,975,4147,76.4890
第15任總統副總統,在宜蘭縣各村(里),宜蘭縣,　羅東鎮,賢文里,97,883,1576,2556,31,2587,0,2587,886,3473,74.4889
第15任總統副總統,在宜蘭縣各村(里),宜蘭縣,　羅東鎮,公正里,60,643,1273,1976,30,2006,0,2006,613,2619,76.5941
第15任總統副總統,在宜蘭縣各村(里),宜蘭縣,　羅東鎮,集祥里,26,219,425,670,5,675,0,675,459,1134,59.5238
第15任總統副總統,在宜蘭縣各村(里),宜蘭縣,　羅東鎮,信義里,81,656,1364,2101,20,2121,0,2121,636,2757,76.9314
第15任總統副總統,在宜蘭縣各村(里),宜蘭縣,　羅東鎮,樹林里,93,959,1563,2615,25,2640,0,2640,640,3280,80.4878
第15任總統副總統,在宜蘭縣各村(里),宜蘭縣,　羅東鎮,竹林里,62,625,1425,2112,15,2127,0,2127,685,2812,75.6401
第15任總統副總統,在宜蘭縣各村(里),宜蘭縣,　羅東鎮,仁愛里,91,811,1702,2604,27,2631,0,2631,794,3425,76.8175
第15任總統副總統,在宜蘭縣各村(里),宜蘭縣,　蘇澳鎮,龍德里,89,659,1682,2430,37,2467,0,2467,834,3301,74.7349
第15任總統副總統,在宜蘭縣各村(里),宜蘭縣,　蘇澳鎮,頂寮里,24,170,539,733,9,742,0,742,221,963,77.0509
第15任總統副總統,在宜蘭縣各村(里),宜蘭縣,　蘇澳鎮,永榮里,120,746,1755,2621,23,2644,0,2644,934,3578,73.8960
第15任總統副總統,在宜蘭縣各村(里),宜蘭縣,　蘇澳鎮,存仁里,15,163,445,623,8,631,0,631,234,865,72.9480
第15任總統副總統,在宜蘭縣各村(里),宜蘭縣,　蘇澳鎮,港邊里,27,244,573,844,9,853,0,853,392,1245,68.5141
第15任總統副總統,在宜蘭縣各村(里),宜蘭縣,　蘇澳鎮,隘丁里,81,619,1467,2167,22,2189,0,2189,720,2909,75.2492
第15任總統副總統,在宜蘭縣各村(里),宜蘭縣,　蘇澳鎮,新城里,41,271,610,922,10,932,0,932,333,1265,73.6759
第15任總統副總統,在宜蘭縣各村(里),宜蘭縣,　蘇澳鎮,聖愛里,71,639,1172,1882,17,1899,0,1899,792,2691,70.5686
第15任總統副總統,在宜蘭縣各村(里),宜蘭縣,　蘇澳鎮,聖湖里,78,673,887,1638,19,1657,1,1658,566,2224,74.5054
第15任總統副總統,在宜蘭縣各村(里),宜蘭縣,　蘇澳鎮,蘇西里,56,632,958,1646,22,1668,0,1668,661,2329,71.6187
第15任總統副總統,在宜蘭縣各村(里),宜蘭縣,　蘇澳鎮,蘇北里,36,280,392,708,8,716,0,716,261,977,73.2856
第15任總統副總統,在宜蘭縣各村(里),宜蘭縣,　蘇澳鎮,蘇南里,12,108,214,334,4,338,0,338,102,440,76.8182
第15任總統副總統,在宜蘭縣各村(里),宜蘭縣,　蘇澳鎮,蘇東里,16,134,207,357,3,360,0,360,147,507,71.0059
第15任總統副總統,在宜蘭縣各村(里),宜蘭縣,　蘇澳鎮,長安里,15,132,216,363,10,373,0,373,147,520,71.7308
第15任總統副總統,在宜蘭縣各村(里),宜蘭縣,　蘇澳鎮,永光里,13,127,180,320,6,326,0,326,112,438,74.4292
第15任總統副總統,在宜蘭縣各村(里),宜蘭縣,　蘇澳鎮,永春里,14,152,231,397,8,405,0,405,167,572,70.8042
第15任總統副總統,在宜蘭縣各村(里),宜蘭縣,　蘇澳鎮,永樂里,18,102,184,304,2,306,0,306,126,432,70.8333
第15任總統副總統,在宜蘭縣各村(里),宜蘭縣,　蘇澳鎮,南安里,28,258,388,674,10,684,0,684,233,917,74.5911
第15任總統副總統,在宜蘭縣各村(里),宜蘭縣,　蘇澳鎮,南正里,21,191,421,633,8,641,0,641,284,925,69.2973
第15任總統副總統,在宜蘭縣各村(里),宜蘭縣,　蘇澳鎮,南成里,37,231,442,710,6,716,0,716,364,1080,66.2963
第15任總統副總統,在宜蘭縣各村(里),宜蘭縣,　蘇澳鎮,南興里,45,338,533,916,12,928,0,928,508,1436,64.6240
第15任總統副總統,在宜蘭縣各村(里),宜蘭縣,　蘇澳鎮,南寧里,28,245,397,670,9,679,0,679,357,1036,65.5405
第15任總統副總統,在宜蘭縣各村(里),宜蘭縣,　蘇澳鎮,南建里,33,245,547,825,8,833,0,833,350,1183,70.4142
第15任總統副總統,在宜蘭縣各村(里),宜蘭縣,　蘇澳鎮,東澳里,9,93,123,225,1,226,0,226,108,334,67.6647
第15任總統副總統,在宜蘭縣各村(里),宜蘭縣,　蘇澳鎮,南強里,12,129,321,462,8,470,0,470,232,702,66.9516
第15任總統副總統,在宜蘭縣各村(里),宜蘭縣,　蘇澳鎮,朝陽里,13,86,256,355,10,365,0,365,218,583,62.6072
第15任總統副總統,在宜蘭縣各村(里),宜蘭縣,　頭城鎮,石城里,9,57,125,191,1,192,0,192,105,297,64.6465
第15任總統副總統,在宜蘭縣各村(里),宜蘭縣,　頭城鎮,大里里,25,179,232,436,5,441,0,441,218,659,66.9196
第15任總統副總統,在宜蘭縣各村(里),宜蘭縣,　頭城鎮,龜山里,17,196,224,437,8,445,0,445,232,677,65.7312
第15任總統副總統,在宜蘭縣各村(里),宜蘭縣,　頭城鎮,大溪里,31,167,337,535,11,546,0,546,330,876,62.3288
第15任總統副總統,在宜蘭縣各村(里),宜蘭縣,　頭城鎮,合興里,7,87,110,204,7,211,0,211,135,346,60.9827
第15任總統副總統,在宜蘭縣各村(里),宜蘭縣,　頭城鎮,更新里,42,363,441,846,7,853,0,853,458,1311,65.0648
第15任總統副總統,在宜蘭縣各村(里),宜蘭縣,　頭城鎮,外澳里,28,212,286,526,9,535,0,535,322,857,62.4271
第15任總統副總統,在宜蘭縣各村(里),宜蘭縣,　頭城鎮,港口里,16,155,288,459,5,464,0,464,211,675,68.7407
第15任總統副總統,在宜蘭縣各村(里),宜蘭縣,　頭城鎮,武營里,59,469,562,1090,16,1106,0,1106,416,1522,72.6675
第15任總統副總統,在宜蘭縣各村(里),宜蘭縣,　頭城鎮,大坑里,49,322,508,879,9,888,0,888,406,1294,68.6244
第15任總統副總統,在宜蘭縣各村(里),宜蘭縣,　頭城鎮,城東里,21,242,268,531,6,537,0,537,158,695,77.2662
第15任總統副總統,在宜蘭縣各村(里),宜蘭縣,　頭城鎮,城北里,7,173,179,359,5,364,0,364,117,481,75.6757
第15任總統副總統,在宜蘭縣各村(里),宜蘭縣,　頭城鎮,城西里,21,186,204,411,3,414,0,414,133,547,75.6856
第15任總統副總統,在宜蘭縣各村(里),宜蘭縣,　頭城鎮,城南里,22,197,237,456,2,458,0,458,161,619,73.9903
第15任總統副總統,在宜蘭縣各村(里),宜蘭縣,　頭城鎮,竹安里,64,500,837,1401,15,1416,0,1416,665,2081,68.0442
第15任總統副總統,在宜蘭縣各村(里),宜蘭縣,　頭城鎮,新建里,77,542,786,1405,18,1423,0,1423,542,1965,72.4173
第15任總統副總統,在宜蘭縣各村(里),宜蘭縣,　頭城鎮,拔雅里,81,493,835,1409,20,1429,0,1429,552,1981,72.1353
第15任總統副總統,在宜蘭縣各村(里),宜蘭縣,　頭城鎮,福成里,34,224,386,644,6,650,0,650,263,913,71.1939
第15任總統副總統,在宜蘭縣各村(里),宜蘭縣,　頭城鎮,金面里,47,502,631,1180,16,1196,0,1196,507,1703,70.2290
第15任總統副總統,在宜蘭縣各村(里),宜蘭縣,　頭城鎮,金盈里,23,200,246,469,7,476,0,476,190,666,71.4715
第15任總統副總統,在宜蘭縣各村(里),宜蘭縣,　頭城鎮,頂埔里,47,356,562,965,10,975,0,975,349,1324,73.6405
第15任總統副總統,在宜蘭縣各村(里),宜蘭縣,　頭城鎮,下埔里,22,231,375,628,6,634,0,634,248,882,71.8821
第15任總統副總統,在宜蘭縣各村(里),宜蘭縣,　頭城鎮,中崙里,28,273,403,704,11,715,0,715,293,1008,70.9325
第15任總統副總統,在宜蘭縣各村(里),宜蘭縣,　頭城鎮,二城里,35,243,461,739,10,749,0,749,338,1087,68.9052
第15任總統副總統,在宜蘭縣各村(里),宜蘭縣,　礁溪鄉,白雲村,50,377,685,1112,12,1124,0,1124,459,1583,71.0044
第15任總統副總統,在宜蘭縣各村(里),宜蘭縣,　礁溪鄉,玉石村,63,478,802,1343,13,1356,0,1356,562,1918,70.6986
第15任總統副總統,在宜蘭縣各村(里),宜蘭縣,　礁溪鄉,德陽村,131,1182,1505,2818,33,2851,0,2851,1081,3932,72.5076
第15任總統副總統,在宜蘭縣各村(里),宜蘭縣,　礁溪鄉,大忠村,70,685,947,1702,15,1717,0,1717,772,2489,68.9835
第15任總統副總統,在宜蘭縣各村(里),宜蘭縣,　礁溪鄉,大義村,21,146,301,468,5,473,0,473,141,614,77.0358
第15任總統副總統,在宜蘭縣各村(里),宜蘭縣,　礁溪鄉,六結村,42,432,596,1070,14,1084,0,1084,310,1394,77.7618
第15任總統副總統,在宜蘭縣各村(里),宜蘭縣,　礁溪鄉,二龍村,45,242,546,833,9,842,0,842,342,1184,71.1149
第15任總統副總統,在宜蘭縣各村(里),宜蘭縣,　礁溪鄉,時潮村,49,268,709,1026,21,1047,0,1047,362,1409,74.3080
第15任總統副總統,在宜蘭縣各村(里),宜蘭縣,　礁溪鄉,玉田村,61,343,1138,1542,19,1561,0,1561,498,2059,75.8135
第15任總統副總統,在宜蘭縣各村(里),宜蘭縣,　礁溪鄉,三民村,64,527,1106,1697,22,1719,0,1719,633,2352,73.0867
第15任總統副總統,在宜蘭縣各村(里),宜蘭縣,　礁溪鄉,林美村,35,238,515,788,14,802,0,802,338,1140,70.3509
第15任總統副總統,在宜蘭縣各村(里),宜蘭縣,　礁溪鄉,白鵝村,18,181,371,570,4,574,0,574,233,807,71.1276
第15任總統副總統,在宜蘭縣各村(里),宜蘭縣,　礁溪鄉,玉光村,21,206,527,754,12,766,0,766,256,1022,74.9511
第15任總統副總統,在宜蘭縣各村(里),宜蘭縣,　礁溪鄉,光武村,38,236,681,955,17,972,0,972,334,1306,74.4257
第15任總統副總統,在宜蘭縣各村(里),宜蘭縣,　礁溪鄉,吳沙村,68,575,1260,1903,15,1918,0,1918,558,2476,77.4637
第15任總統副總統,在宜蘭縣各村(里),宜蘭縣,　礁溪鄉,龍潭村,90,580,1730,2400,26,2426,0,2426,804,3230,75.1084
第15任總統副總統,在宜蘭縣各村(里),宜蘭縣,　礁溪鄉,匏崙村,22,205,447,674,8,682,0,682,245,927,73.5707
第15任總統副總統,在宜蘭縣各村(里),宜蘭縣,　礁溪鄉,二結村,8,71,228,307,5,312,0,312,98,410,76.0976
第15任總統副總統,在宜蘭縣各村(里),宜蘭縣,　壯圍鄉,吉祥村,86,578,1217,1881,17,1898,0,1898,613,2511,75.5874
第15任總統副總統,在宜蘭縣各村(里),宜蘭縣,　壯圍鄉,古結村,41,222,519,782,14,796,0,796,262,1058,75.2363
第15任總統副總統,在宜蘭縣各村(里),宜蘭縣,　壯圍鄉,美福村,48,424,851,1323,18,1341,0,1341,504,1845,72.6829
第15任總統副總統,在宜蘭縣各村(里),宜蘭縣,　壯圍鄉,新南村,32,187,471,690,7,697,0,697,227,924,75.4329
第15任總統副總統,在宜蘭縣各村(里),宜蘭縣,　壯圍鄉,東港村,13,173,459,645,5,650,0,650,298,948,68.5654
第15任總統副總統,在宜蘭縣各村(里),宜蘭縣,　壯圍鄉,復興村,22,296,801,1119,11,1130,0,1130,430,1560,72.4359
第15任總統副總統,在宜蘭縣各村(里),宜蘭縣,　壯圍鄉,過嶺村,32,271,704,1007,7,1014,0,1014,467,1481,68.4673
第15任總統副總統,在宜蘭縣各村(里),宜蘭縣,　壯圍鄉,永鎮村,20,135,403,558,4,562,0,562,216,778,72.2365
第15任總統副總統,在宜蘭縣各村(里),宜蘭縣,　壯圍鄉,忠孝村,53,474,1139,1666,22,1688,0,1688,599,2287,73.8085
第15任總統副總統,在宜蘭縣各村(里),宜蘭縣,　壯圍鄉,古亭村,47,309,728,1084,14,1098,0,1098,420,1518,72.3320
第15任總統副總統,在宜蘭縣各村(里),宜蘭縣,　壯圍鄉,功勞村,36,254,623,913,11,924,0,924,276,1200,77.0000
第15任總統副總統,在宜蘭縣各村(里),宜蘭縣,　壯圍鄉,美城村,75,446,1029,1550,17,1567,0,1567,608,2175,72.0460
第15任總統副總統,在宜蘭縣各村(里),宜蘭縣,　壯圍鄉,新社村,30,224,484,738,7,745,0,745,297,1042,71.4971
第15任總統副總統,在宜蘭縣各村(里),宜蘭縣,　壯圍鄉,大福村,40,355,795,1190,16,1206,0,1206,536,1742,69.2308
第15任總統副總統,在宜蘭縣各村(里),宜蘭縣,　員山鄉,員山村,155,1365,2554,4074,58,4132,0,4132,1434,5566,74.2364
第15任總統副總統,在宜蘭縣各村(里),宜蘭縣,　員山鄉,尚德村,55,432,1010,1497,26,1523,0,1523,617,2140,71.1682
第15任總統副總統,在宜蘭縣各村(里),宜蘭縣,　員山鄉,惠好村,51,290,846,1187,18,1205,0,1205,351,1556,77.4422
第15任總統副總統,在宜蘭縣各村(里),宜蘭縣,　員山鄉,七賢村,43,317,679,1039,12,1051,0,1051,376,1427,73.6510
第15任總統副總統,在宜蘭縣各村(里),宜蘭縣,　員山鄉,深溝村,44,379,949,1372,13,1385,0,1385,479,1864,74.3026
第15任總統副總統,在宜蘭縣各村(里),宜蘭縣,　員山鄉,蓁巷村,39,202,607,848,5,853,0,853,330,1183,72.1048
第15任總統副總統,在宜蘭縣各村(里),宜蘭縣,　員山鄉,內城村,52,382,555,989,14,1003,0,1003,432,1435,69.8955
第15任總統副總統,在宜蘭縣各村(里),宜蘭縣,　員山鄉,中華村,12,124,290,426,6,432,0,432,193,625,69.1200
第15任總統副總統,在宜蘭縣各村(里),宜蘭縣,　員山鄉,永和村,61,371,833,1265,17,1282,0,1282,482,1764,72.6757
第15任總統副總統,在宜蘭縣各村(里),宜蘭縣,　員山鄉,頭分村,35,285,652,972,15,987,0,987,339,1326,74.4344
第15任總統副總統,在宜蘭縣各村(里),宜蘭縣,　員山鄉,枕山村,38,370,1229,1637,21,1658,0,1658,580,2238,74.0840
第15任總統副總統,在宜蘭縣各村(里),宜蘭縣,　員山鄉,同樂村,42,485,1148,1675,23,1698,0,1698,652,2350,72.2553
第15任總統副總統,在宜蘭縣各村(里),宜蘭縣,　員山鄉,湖東村,24,169,424,617,10,627,0,627,218,845,74.2012
第15任總統副總統,在宜蘭縣各村(里),宜蘭縣,　員山鄉,逸仙村,29,140,458,627,7,634,0,634,227,861,73.6353
第15任總統副總統,在宜蘭縣各村(里),宜蘭縣,　員山鄉,湖北村,18,197,473,688,7,695,0,695,287,982,70.7739
第15任總統副總統,在宜蘭縣各村(里),宜蘭縣,　員山鄉,湖西村,28,239,643,910,9,919,0,919,421,1340,68.5821
第15任總統副總統,在宜蘭縣各村(里),宜蘭縣,　冬山鄉,珍珠村,48,294,915,1257,8,1265,0,1265,312,1577,80.2156
第15任總統副總統,在宜蘭縣各村(里),宜蘭縣,　冬山鄉,補城村,27,210,611,848,6,854,0,854,278,1132,75.4417
第15任總統副總統,在宜蘭縣各村(里),宜蘭縣,　冬山鄉,三奇村,21,135,479,635,6,641,0,641,229,870,73.6782
第15任總統副總統,在宜蘭縣各村(里),宜蘭縣,　冬山鄉,大興村,33,145,480,658,5,663,0,663,203,866,76.5589
第15任總統副總統,在宜蘭縣各村(里),宜蘭縣,　冬山鄉,東城村,38,297,710,1045,11,1056,0,1056,308,1364,77.4194
第15任總統副總統,在宜蘭縣各村(里),宜蘭縣,　冬山鄉,香和村,76,542,1513,2131,27,2158,0,2158,699,2857,75.5338
第15任總統副總統,在宜蘭縣各村(里),宜蘭縣,　冬山鄉,南興村,83,568,1480,2131,28,2159,0,2159,739,2898,74.4997
第15任總統副總統,在宜蘭縣各村(里),宜蘭縣,　冬山鄉,安平村,13,86,413,512,7,519,0,519,190,709,73.2017
第15任總統副總統,在宜蘭縣各村(里),宜蘭縣,　冬山鄉,冬山村,28,138,330,496,4,500,0,500,168,668,74.8503
第15任總統副總統,在宜蘭縣各村(里),宜蘭縣,　冬山鄉,太和村,24,319,786,1129,17,1146,0,1146,324,1470,77.9592
第15任總統副總統,在宜蘭縣各村(里),宜蘭縣,　冬山鄉,八寶村,22,147,440,609,10,619,0,619,233,852,72.6526
第15任總統副總統,在宜蘭縣各村(里),宜蘭縣,　冬山鄉,丸山村,29,244,758,1031,14,1045,0,1045,411,1456,71.7720
第15任總統副總統,在宜蘭縣各村(里),宜蘭縣,　冬山鄉,中山村,7,79,288,374,7,381,0,381,93,474,80.3797
第15任總統副總統,在宜蘭縣各村(里),宜蘭縣,　冬山鄉,順安村,135,917,2476,3528,32,3560,0,3560,1271,4831,73.6907
第15任總統副總統,在宜蘭縣各村(里),宜蘭縣,　冬山鄉,永美村,80,596,1587,2263,23,2286,0,2286,708,2994,76.3527
第15任總統副總統,在宜蘭縣各村(里),宜蘭縣,　冬山鄉,武淵村,27,219,677,923,6,929,0,929,267,1196,77.6756
第15任總統副總統,在宜蘭縣各村(里),宜蘭縣,　冬山鄉,群英村,132,967,2272,3371,34,3405,0,3405,1120,4525,75.2486
第15任總統副總統,在宜蘭縣各村(里),宜蘭縣,　冬山鄉,清溝村,104,814,1847,2765,28,2793,0,2793,847,3640,76.7308
第15任總統副總統,在宜蘭縣各村(里),宜蘭縣,　冬山鄉,鹿埔村,56,408,1349,1813,15,1828,1,1829,622,2451,74.5818
第15任總統副總統,在宜蘭縣各村(里),宜蘭縣,　冬山鄉,得安村,24,220,473,717,16,733,0,733,341,1074,68.2495
第15任總統副總統,在宜蘭縣各村(里),宜蘭縣,　冬山鄉,廣興村,63,482,1256,1801,17,1818,0,1818,649,2467,73.6927
第15任總統副總統,在宜蘭縣各村(里),宜蘭縣,　冬山鄉,廣安村,54,353,843,1250,6,1256,0,1256,376,1632,76.9608
第15任總統副總統,在宜蘭縣各村(里),宜蘭縣,　冬山鄉,柯林村,41,325,900,1266,13,1279,0,1279,408,1687,75.8151
第15任總統副總統,在宜蘭縣各村(里),宜蘭縣,　冬山鄉,大進村,14,125,438,577,7,584,2,586,184,770,75.8442
第15任總統副總統,在宜蘭縣各村(里),宜蘭縣,　五結鄉,三興村,50,359,1064,1473,11,1484,0,1484,496,1980,74.9495
第15任總統副總統,在宜蘭縣各村(里),宜蘭縣,　五結鄉,二結村,43,423,845,1311,10,1321,0,1321,422,1743,75.7889
第15任總統副總統,在宜蘭縣各村(里),宜蘭縣,　五結鄉,鎮安村,70,530,1279,1879,13,1892,0,1892,611,2503,75.5893
第15任總統副總統,在宜蘭縣各村(里),宜蘭縣,　五結鄉,上四村,46,379,781,1206,13,1219,0,1219,366,1585,76.9085
第15任總統副總統,在宜蘭縣各村(里),宜蘭縣,　五結鄉,中興村,30,256,639,925,8,933,0,933,367,1300,71.7692
第15任總統副總統,在宜蘭縣各村(里),宜蘭縣,　五結鄉,四結村,67,610,1186,1863,15,1878,0,1878,595,2473,75.9402
第15任總統副總統,在宜蘭縣各村(里),宜蘭縣,　五結鄉,福興村,49,367,906,1322,9,1331,0,1331,419,1750,76.0571
第15任總統副總統,在宜蘭縣各村(里),宜蘭縣,　五結鄉,五結村,98,775,1759,2632,25,2657,0,2657,958,3615,73.4993
第15任總統副總統,在宜蘭縣各村(里),宜蘭縣,　五結鄉,協和村,81,625,1626,2332,23,2355,0,2355,820,3175,74.1732
第15任總統副總統,在宜蘭縣各村(里),宜蘭縣,　五結鄉,大吉村,90,759,1783,2632,25,2657,0,2657,844,3501,75.8926
第15任總統副總統,在宜蘭縣各村(里),宜蘭縣,　五結鄉,孝威村,32,258,810,1100,7,1107,0,1107,410,1517,72.9730
第15任總統副總統,在宜蘭縣各村(里),宜蘭縣,　五結鄉,錦眾村,24,267,699,990,9,999,0,999,406,1405,71.1032
第15任總統副總統,在宜蘭縣各村(里),宜蘭縣,　五結鄉,利澤村,51,343,970,1364,18,1382,0,1382,565,1947,70.9810
第15任總統副總統,在宜蘭縣各村(里),宜蘭縣,　五結鄉,成興村,72,473,1709,2254,24,2278,0,2278,789,3067,74.2745
第15任總統副總統,在宜蘭縣各村(里),宜蘭縣,　五結鄉,季新村,63,473,1425,1961,16,1977,0,1977,781,2758,71.6824
第15任總統副總統,在宜蘭縣各村(里),宜蘭縣,　三星鄉,員山村,8,55,84,147,3,150,0,150,65,215,69.7674
第15任總統副總統,在宜蘭縣各村(里),宜蘭縣,　三星鄉,天山村,13,103,211,327,4,331,0,331,162,493,67.1400
第15任總統副總統,在宜蘭縣各村(里),宜蘭縣,　三星鄉,天福村,21,136,339,496,6,502,0,502,220,722,69.5291
第15任總統副總統,在宜蘭縣各村(里),宜蘭縣,　三星鄉,萬德村,17,129,244,390,3,393,0,393,208,601,65.3910
第15任總統副總統,在宜蘭縣各村(里),宜蘭縣,　三星鄉,貴林村,18,132,175,325,6,331,0,331,174,505,65.5446
第15任總統副總統,在宜蘭縣各村(里),宜蘭縣,　三星鄉,萬富村,26,144,337,507,3,510,0,510,204,714,71.4286
第15任總統副總統,在宜蘭縣各村(里),宜蘭縣,　三星鄉,雙賢村,11,94,295,400,7,407,0,407,162,569,71.5290
第15任總統副總統,在宜蘭縣各村(里),宜蘭縣,　三星鄉,人和村,14,121,174,309,5,314,0,314,127,441,71.2018
第15任總統副總統,在宜蘭縣各村(里),宜蘭縣,　三星鄉,義德村,41,281,463,785,5,790,0,790,354,1144,69.0559
第15任總統副總統,在宜蘭縣各村(里),宜蘭縣,　三星鄉,集慶村,28,297,489,814,17,831,0,831,311,1142,72.7671
第15任總統副總統,在宜蘭縣各村(里),宜蘭縣,　三星鄉,月眉村,33,191,384,608,6,614,0,614,235,849,72.3204
第15任總統副總統,在宜蘭縣各村(里),宜蘭縣,　三星鄉,拱照村,25,253,484,762,12,774,0,774,510,1284,60.2804
第15任總統副總統,在宜蘭縣各村(里),宜蘭縣,　三星鄉,行健村,21,173,444,638,7,645,0,645,208,853,75.6155
第15任總統副總統,在宜蘭縣各村(里),宜蘭縣,　三星鄉,大隱村,114,876,2054,3044,28,3072,0,3072,1120,4192,73.2824
第15任總統副總統,在宜蘭縣各村(里),宜蘭縣,　三星鄉,大義村,45,222,646,913,16,929,0,929,301,1230,75.5285
第15任總統副總統,在宜蘭縣各村(里),宜蘭縣,　三星鄉,尚武村,20,152,384,556,7,563,0,563,192,755,74.5695
第15任總統副總統,在宜蘭縣各村(里),宜蘭縣,　三星鄉,大洲村,24,262,862,1148,17,1165,0,1165,340,1505,77.4086
第15任總統副總統,在宜蘭縣各村(里),宜蘭縣,　三星鄉,尾塹村,36,232,756,1024,15,1039,0,1039,351,1390,74.7482
第15任總統副總統,在宜蘭縣各村(里),宜蘭縣,　大同鄉,寒溪村,17,487,109,613,10,623,0,623,235,858,72.6107
第15任總統副總統,在宜蘭縣各村(里),宜蘭縣,　大同鄉,崙埤村,21,335,70,426,2,428,0,428,159,587,72.9131
第15任總統副總統,在宜蘭縣各村(里),宜蘭縣,　大同鄉,松羅村,23,313,147,483,2,485,0,485,188,673,72.0654
第15任總統副總統,在宜蘭縣各村(里),宜蘭縣,　大同鄉,復興村,8,90,77,175,4,179,0,179,78,257,69.6498
第15任總統副總統,在宜蘭縣各村(里),宜蘭縣,　大同鄉,英士村,11,176,50,237,1,238,0,238,86,324,73.4568
第15任總統副總統,在宜蘭縣各村(里),宜蘭縣,　大同鄉,樂水村,5,224,33,262,4,266,0,266,124,390,68.2051
第15任總統副總統,在宜蘭縣各村(里),宜蘭縣,　大同鄉,太平村,4,18,15,37,0,37,0,37,27,64,57.8125
第15任總統副總統,在宜蘭縣各村(里),宜蘭縣,　大同鄉,茂安村,4,124,21,149,0,149,0,149,53,202,73.7624
第15任總統副總統,在宜蘭縣各村(里),宜蘭縣,　大同鄉,四季村,18,440,67,525,3,528,0,528,225,753,70.1195
第15任總統副總統,在宜蘭縣各村(里),宜蘭縣,　大同鄉,南山村,17,361,103,481,5,486,0,486,155,641,75.8190
第15任總統副總統,在宜蘭縣各村(里),宜蘭縣,　南澳鄉,東岳村,7,272,57,336,1,337,0,337,90,427,78.9227
第15任總統副總統,在宜蘭縣各村(里),宜蘭縣,　南澳鄉,南澳村,22,636,143,801,4,805,0,805,315,1120,71.8750
第15任總統副總統,在宜蘭縣各村(里),宜蘭縣,　南澳鄉,碧候村,15,562,80,657,10,667,0,667,248,915,72.8962
第15任總統副總統,在宜蘭縣各村(里),宜蘭縣,　南澳鄉,金岳村,0,243,28,271,1,272,0,272,128,400,68.0000
第15任總統副總統,在宜蘭縣各村(里),宜蘭縣,　南澳鄉,武塔村,11,230,65,306,3,309,0,309,117,426,72.5352
第15任總統副總統,在宜蘭縣各村(里),宜蘭縣,　南澳鄉,金洋村,6,267,37,310,2,312,0,312,134,446,69.9552
第15任總統副總統,在宜蘭縣各村(里),宜蘭縣,　南澳鄉,澳花村,15,426,60,501,4,505,0,505,177,682,74.0469
第15任總統副總統,在連江縣各村(里),連江縣,　南竿鄉,介壽村,40,915,247,1202,20,1222,0,1222,696,1918,63.7122
第15任總統副總統,在連江縣各村(里),連江縣,　南竿鄉,復興村、福沃村,27,765,196,988,19,1007,0,1007,715,1722,58.4785
第15任總統副總統,在連江縣各村(里),連江縣,　南竿鄉,清水村、珠螺村,25,495,170,690,7,697,0,697,420,1117,62.3993
第15任總統副總統,在連江縣各村(里),連江縣,　南竿鄉,仁愛村、津沙村、馬祖村、四維村,22,700,171,893,7,900,0,900,600,1500,60.0000
第15任總統副總統,在連江縣各村(里),連江縣,　北竿鄉,塘岐村、后沃村,15,487,121,623,6,629,0,629,592,1221,51.5152
第15任總統副總統,在連江縣各村(里),連江縣,　北竿鄉,橋仔村、芹壁村、坂里村、白沙村,10,396,80,486,8,494,0,494,474,968,51.0331
第15任總統副總統,在連江縣各村(里),連江縣,　莒光鄉,青帆村、田沃村、西坵村,9,228,43,280,3,283,0,283,357,640,44.2188
第15任總統副總統,在連江縣各村(里),連江縣,　莒光鄉,福正村、大坪村,5,285,62,352,6,358,0,358,376,734,48.7738
第15任總統副總統,在連江縣各村(里),連江縣,　東引鄉,中柳村、樂華村,35,505,136,676,6,682,0,682,437,1119,60.9473
第15任總統副總統,在新竹市各村(里),新竹市,　東區,育賢里,32,290,355,677,9,686,0,686,846,1532,44.7781
第15任總統副總統,在新竹市各村(里),新竹市,　東區,親仁里,34,326,328,688,12,700,0,700,196,896,78.1250
第15任總統副總統,在新竹市各村(里),新竹市,　東區,榮光里、親仁里,25,333,357,715,12,727,0,727,283,1010,71.9802
第15任總統副總統,在新竹市各村(里),新竹市,　東區,東門里,14,133,264,411,5,416,0,416,115,531,78.3427
第15任總統副總統,在新竹市各村(里),新竹市,　東區,成功里,21,169,260,450,6,456,0,456,160,616,74.0260
第15任總統副總統,在新竹市各村(里),新竹市,　東區,中正里,18,144,257,419,3,422,0,422,116,538,78.4387
第15任總統副總統,在新竹市各村(里),新竹市,　東區,錦華里,76,582,668,1326,23,1349,1,1350,408,1758,76.7349
第15任總統副總統,在新竹市各村(里),新竹市,　東區,文華里,187,1437,1742,3366,38,3404,0,3404,941,4345,78.3429
第15任總統副總統,在新竹市各村(里),新竹市,　東區,復中里,136,1288,1655,3079,41,3120,0,3120,889,4009,77.8249
第15任總統副總統,在新竹市各村(里),新竹市,　東區,復興里,196,1422,1953,3571,40,3611,0,3611,1090,4701,76.8134
第15任總統副總統,在新竹市各村(里),新竹市,　東區,三民里,159,1358,1926,3443,47,3490,0,3490,1018,4508,77.4179
第15任總統副總統,在新竹市各村(里),新竹市,　東區,東園里,267,1529,2541,4337,64,4401,2,4403,1114,5517,79.7716
第15任總統副總統,在新竹市各村(里),新竹市,　東區,公園里,123,943,1221,2287,36,2323,0,2323,707,3030,76.6667
第15任總統副總統,在新竹市各村(里),新竹市,　東區,建華里,88,697,962,1747,33,1780,0,1780,548,2328,76.4605
第15任總統副總統,在新竹市各村(里),新竹市,　東區,東山里,132,1085,1163,2380,36,2416,0,2416,635,3051,79.1872
第15任總統副總統,在新竹市各村(里),新竹市,　東區,綠水里,281,1871,2370,4522,60,4582,0,4582,1303,5885,77.8590
第15任總統副總統,在新竹市各村(里),新竹市,　東區,東勢里,107,646,1000,1753,25,1778,0,1778,458,2236,79.5170
第15任總統副總統,在新竹市各村(里),新竹市,　東區,光復里,96,702,1210,2008,32,2040,0,2040,537,2577,79.1618
第15任總統副總統,在新竹市各村(里),新竹市,　東區,前溪里,112,709,1210,2031,29,2060,0,2060,609,2669,77.1825
第15任總統副總統,在新竹市各村(里),新竹市,　東區,水源里,123,864,1485,2472,34,2506,0,2506,731,3237,77.4174
第15任總統副總統,在新竹市各村(里),新竹市,　東區,千甲里,104,691,754,1549,23,1572,0,1572,466,2038,77.1344
第15任總統副總統,在新竹市各村(里),新竹市,　東區,豐功里,191,1507,1581,3279,52,3331,0,3331,837,4168,79.9184
第15任總統副總統,在新竹市各村(里),新竹市,　東區,武功里,185,1906,964,3055,49,3104,0,3104,779,3883,79.9382
第15任總統副總統,在新竹市各村(里),新竹市,　東區,軍功里,104,1109,812,2025,26,2051,0,2051,597,2648,77.4547
第15任總統副總統,在新竹市各村(里),新竹市,　東區,立功里,33,422,189,644,7,651,0,651,233,884,73.6425
第15任總統副總統,在新竹市各村(里),新竹市,　東區,建功里,158,1736,874,2768,37,2805,0,2805,715,3520,79.6875
第15任總統副總統,在新竹市各村(里),新竹市,　東區,光明里,122,1092,998,2212,38,2250,0,2250,642,2892,77.8008
第15任總統副總統,在新竹市各村(里),新竹市,　東區,龍山里,443,2210,4049,6702,91,6793,1,6794,1564,8358,81.2754
第15任總統副總統,在新竹市各村(里),新竹市,　東區,科園里,270,2199,2442,4911,71,4982,0,4982,1105,6087,81.8466
第15任總統副總統,在新竹市各村(里),新竹市,　東區,埔頂里,211,1234,2433,3878,62,3940,0,3940,971,4911,80.2281
第15任總統副總統,在新竹市各村(里),新竹市,　東區,新莊里,251,1630,2079,3960,55,4015,0,4015,1131,5146,78.0218
第15任總統副總統,在新竹市各村(里),新竹市,　東區,關新里,241,917,1834,2992,52,3044,0,3044,661,3705,82.1592
第15任總統副總統,在新竹市各村(里),新竹市,　東區,關東里,223,1552,1732,3507,47,3554,0,3554,1005,4559,77.9557
第15任總統副總統,在新竹市各村(里),新竹市,　東區,金山里,197,1676,1745,3618,39,3657,0,3657,1214,4871,75.0770
第15任總統副總統,在新竹市各村(里),新竹市,　東區,仙水里,227,1313,1703,3243,39,3282,0,3282,856,4138,79.3137
第15任總統副總統,在新竹市各村(里),新竹市,　東區,仙宮里,66,362,528,956,13,969,0,969,232,1201,80.6828
第15任總統副總統,在新竹市各村(里),新竹市,　東區,關帝里,16,115,240,371,4,375,0,375,111,486,77.1605
第15任總統副總統,在新竹市各村(里),新竹市,　東區,南門里,25,176,327,528,7,535,0,535,166,701,76.3195
第15任總統副總統,在新竹市各村(里),新竹市,　東區,南市里,23,197,419,639,8,647,0,647,216,863,74.9710
第15任總統副總統,在新竹市各村(里),新竹市,　東區,福德里,46,446,567,1059,16,1075,0,1075,321,1396,77.0057
第15任總統副總統,在新竹市各村(里),新竹市,　東區,振興里,221,1543,2182,3946,37,3983,0,3983,1362,5345,74.5182
第15任總統副總統,在新竹市各村(里),新竹市,　東區,新興里,112,848,1274,2234,25,2259,0,2259,639,2898,77.9503
第15任總統副總統,在新竹市各村(里),新竹市,　東區,下竹里、寺前里,46,315,474,835,14,849,0,849,299,1148,73.9547
第15任總統副總統,在新竹市各村(里),新竹市,　東區,竹蓮里,20,173,341,534,10,544,0,544,175,719,75.6606
第15任總統副總統,在新竹市各村(里),新竹市,　東區,頂竹里,102,744,1260,2106,31,2137,0,2137,635,2772,77.0924
第15任總統副總統,在新竹市各村(里),新竹市,　東區,南大里,48,362,661,1071,16,1087,0,1087,311,1398,77.7539
第15任總統副總統,在新竹市各村(里),新竹市,　東區,新光里,124,944,1380,2448,33,2481,0,2481,830,3311,74.9320
第15任總統副總統,在新竹市各村(里),新竹市,　東區,光鎮里,128,975,1423,2526,34,2560,0,2560,774,3334,76.7846
第15任總統副總統,在新竹市各村(里),新竹市,　東區,高峰里,197,1685,2223,4105,50,4155,0,4155,1355,5510,75.4083
第15任總統副總統,在新竹市各村(里),新竹市,　東區,湖濱里,140,1050,1480,2670,36,2706,0,2706,699,3405,79.4714
第15任總統副總統,在新竹市各村(里),新竹市,　東區,柴橋里,194,1544,2029,3767,48,3815,0,3815,1093,4908,77.7302
第15任總統副總統,在新竹市各村(里),新竹市,　東區,明湖里,219,1492,1683,3394,38,3432,0,3432,1305,4737,72.4509
第15任總統副總統,在新竹市各村(里),新竹市,　北區,西門里、中央里,30,225,482,737,12,749,0,749,243,992,75.5040
第15任總統副總統,在新竹市各村(里),新竹市,　北區,潛園里,18,200,338,556,5,561,0,561,168,729,76.9547
第15任總統副總統,在新竹市各村(里),新竹市,　北區,石坊里、興南里,16,183,327,526,6,532,0,532,159,691,76.9899
第15任總統副總統,在新竹市各村(里),新竹市,　北區,仁德里,20,176,340,536,9,545,0,545,142,687,79.3304
第15任總統副總統,在新竹市各村(里),新竹市,　北區,崇禮里,51,237,527,815,13,828,0,828,279,1107,74.7967
第15任總統副總統,在新竹市各村(里),新竹市,　北區,興南里,39,292,533,864,9,873,0,873,281,1154,75.6499
第15任總統副總統,在新竹市各村(里),新竹市,　北區,育英里,143,901,1583,2627,34,2661,0,2661,793,3454,77.0411
第15任總統副總統,在新竹市各村(里),新竹市,　北區,台溪里,36,445,601,1082,18,1100,0,1100,475,1575,69.8413
第15任總統副總統,在新竹市各村(里),新竹市,　北區,曲溪里,213,1476,1875,3564,40,3604,0,3604,1388,4992,72.1955
第15任總統副總統,在新竹市各村(里),新竹市,　北區,西雅里,107,735,1313,2155,37,2192,0,2192,630,2822,77.6754
第15任總統副總統,在新竹市各村(里),新竹市,　北區,客雅里,62,446,776,1284,22,1306,0,1306,400,1706,76.5533
第15任總統副總統,在新竹市各村(里),新竹市,　北區,中雅里,127,1306,1038,2471,33,2504,0,2504,714,3218,77.8123
第15任總統副總統,在新竹市各村(里),新竹市,　北區,南勢里,132,705,1769,2606,35,2641,0,2641,666,3307,79.8609
第15任總統副總統,在新竹市各村(里),新竹市,　北區,南勢里、大鵬里,30,269,416,715,6,721,0,721,280,1001,72.0280
第15任總統副總統,在新竹市各村(里),新竹市,　北區,大同里,34,243,307,584,8,592,0,592,160,752,78.7234
第15任總統副總統,在新竹市各村(里),新竹市,　北區,中山里,31,165,398,594,7,601,0,601,178,779,77.1502
第15任總統副總統,在新竹市各村(里),新竹市,　北區,中興里,26,188,356,570,7,577,0,577,155,732,78.8251
第15任總統副總統,在新竹市各村(里),新竹市,　北區,新民里,64,395,673,1132,20,1152,0,1152,358,1510,76.2914
第15任總統副總統,在新竹市各村(里),新竹市,　北區,長和里,46,345,626,1017,19,1036,0,1036,328,1364,75.9531
第15任總統副總統,在新竹市各村(里),新竹市,　北區,北門里,30,224,444,698,15,713,0,713,230,943,75.6098
第15任總統副總統,在新竹市各村(里),新竹市,　北區,民富里,166,1186,2026,3378,42,3420,0,3420,1293,4713,72.5652
第15任總統副總統,在新竹市各村(里),新竹市,　北區,磐石里,171,1434,2351,3956,44,4000,0,4000,1192,5192,77.0416
第15任總統副總統,在新竹市各村(里),新竹市,　北區,新雅里,156,1093,1950,3199,32,3231,0,3231,1091,4322,74.7571
第15任總統副總統,在新竹市各村(里),新竹市,　北區,文雅里,157,1127,1698,2982,27,3009,0,3009,851,3860,77.9534
第15任總統副總統,在新竹市各村(里),新竹市,　北區,水田里,117,833,1234,2184,23,2207,0,2207,676,2883,76.5522
第15任總統副總統,在新竹市各村(里),新竹市,　北區,光田里,74,632,883,1589,21,1610,0,1610,465,2075,77.5904
第15任總統副總統,在新竹市各村(里),新竹市,　北區,光華里,138,1101,1378,2617,31,2648,0,2648,1389,4037,65.5933
第15任總統副總統,在新竹市各村(里),新竹市,　北區,金華里,174,1424,1974,3572,40,3612,0,3612,1072,4684,77.1136
第15任總統副總統,在新竹市各村(里),新竹市,　北區,湳雅里,111,849,1060,2020,39,2059,0,2059,573,2632,78.2295
第15任總統副總統,在新竹市各村(里),新竹市,　北區,金雅里,86,647,993,1726,18,1744,0,1744,389,2133,81.7628
第15任總統副總統,在新竹市各村(里),新竹市,　北區,湳中里,293,2079,2482,4854,69,4923,1,4924,1354,6278,78.4167
第15任總統副總統,在新竹市各村(里),新竹市,　北區,舊社里,228,1666,2448,4342,60,4402,0,4402,1333,5735,76.7568
第15任總統副總統,在新竹市各村(里),新竹市,　北區,金竹里,253,1751,2261,4265,45,4310,0,4310,1313,5623,76.6495
第15任總統副總統,在新竹市各村(里),新竹市,　北區,武陵里,178,2330,980,3488,37,3525,0,3525,994,4519,78.0040
第15任總統副總統,在新竹市各村(里),新竹市,　北區,福林里,152,1234,1482,2868,40,2908,0,2908,821,3729,77.9834
第15任總統副總統,在新竹市各村(里),新竹市,　北區,境福里,200,1358,1932,3490,46,3536,0,3536,1032,4568,77.4081
第15任總統副總統,在新竹市各村(里),新竹市,　北區,士林里,79,397,831,1307,16,1323,0,1323,363,1686,78.4698
第15任總統副總統,在新竹市各村(里),新竹市,　北區,古賢里,25,189,439,653,5,658,0,658,170,828,79.4686
第15任總統副總統,在新竹市各村(里),新竹市,　北區,南寮里,193,1518,2308,4019,41,4060,0,4060,1540,5600,72.5000
第15任總統副總統,在新竹市各村(里),新竹市,　北區,康樂里,111,795,1242,2148,16,2164,0,2164,651,2815,76.8739
第15任總統副總統,在新竹市各村(里),新竹市,　北區,中寮里,130,897,1428,2455,33,2488,3,2491,852,3343,74.4242
第15任總統副總統,在新竹市各村(里),新竹市,　北區,海濱里,152,1016,1585,2753,40,2793,0,2793,1030,3823,73.0578
第15任總統副總統,在新竹市各村(里),新竹市,　北區,港北里,71,400,768,1239,19,1258,0,1258,441,1699,74.0436
第15任總統副總統,在新竹市各村(里),新竹市,　北區,舊港里,15,144,247,406,8,414,0,414,158,572,72.3776
第15任總統副總統,在新竹市各村(里),新竹市,　香山區,頂埔里,211,1247,2137,3595,37,3632,0,3632,1214,4846,74.9484
第15任總統副總統,在新竹市各村(里),新竹市,　香山區,頂福里,168,1162,1809,3139,28,3167,0,3167,951,4118,76.9063
第15任總統副總統,在新竹市各村(里),新竹市,　香山區,中埔里,100,823,1264,2187,23,2210,0,2210,625,2835,77.9541
第15任總統副總統,在新竹市各村(里),新竹市,　香山區,牛埔里,179,1199,1732,3110,38,3148,0,3148,1265,4413,71.3347
第15任總統副總統,在新竹市各村(里),新竹市,　香山區,埔前里,134,767,1501,2402,30,2432,0,2432,673,3105,78.3253
第15任總統副總統,在新竹市各村(里),新竹市,　香山區,樹下里,70,388,1126,1584,26,1610,0,1610,462,2072,77.7027
第15任總統副總統,在新竹市各村(里),新竹市,　香山區,浸水里,100,505,1148,1753,19,1772,0,1772,526,2298,77.1105
第15任總統副總統,在新竹市各村(里),新竹市,　香山區,虎林里,82,543,996,1621,29,1650,0,1650,552,2202,74.9319
第15任總統副總統,在新竹市各村(里),新竹市,　香山區,虎山里,194,1253,2331,3778,52,3830,0,3830,1358,5188,73.8242
第15任總統副總統,在新竹市各村(里),新竹市,　香山區,港南里,98,591,1206,1895,19,1914,0,1914,599,2513,76.1639
第15任總統副總統,在新竹市各村(里),新竹市,　香山區,東香里,159,1274,1489,2922,42,2964,0,2964,835,3799,78.0205
第15任總統副總統,在新竹市各村(里),新竹市,　香山區,香村里,136,1032,1331,2499,32,2531,0,2531,838,3369,75.1262
第15任總統副總統,在新竹市各村(里),新竹市,　香山區,香山里,191,1071,1829,3091,32,3123,0,3123,992,4115,75.8931
第15任總統副總統,在新竹市各村(里),新竹市,　香山區,大庄里,99,614,1334,2047,22,2069,0,2069,642,2711,76.3187
第15任總統副總統,在新竹市各村(里),新竹市,　香山區,美山里,26,241,505,772,14,786,0,786,310,1096,71.7153
第15任總統副總統,在新竹市各村(里),新竹市,　香山區,朝山里,89,538,911,1538,12,1550,0,1550,491,2041,75.9432
第15任總統副總統,在新竹市各村(里),新竹市,　香山區,海山里,95,688,928,1711,23,1734,0,1734,572,2306,75.1951
第15任總統副總統,在新竹市各村(里),新竹市,　香山區,鹽水里,61,348,614,1023,15,1038,0,1038,333,1371,75.7112
第15任總統副總統,在新竹市各村(里),新竹市,　香山區,內湖里,152,1109,1700,2961,39,3000,0,3000,1162,4162,72.0807
第15任總統副總統,在新竹市各村(里),新竹市,　香山區,南港里,21,160,386,567,8,575,0,575,201,776,74.0979
第15任總統副總統,在新竹市各村(里),新竹市,　香山區,中隘里,58,518,643,1219,11,1230,0,1230,506,1736,70.8525
第15任總統副總統,在新竹市各村(里),新竹市,　香山區,南隘里,27,229,304,560,14,574,0,574,180,754,76.1273
第15任總統副總統,在新竹市各村(里),新竹市,　香山區,大湖里,32,228,395,655,8,663,0,663,193,856,77.4533
第15任總統副總統,在新竹市各村(里),新竹市,　香山區,茄苳里,22,248,346,616,10,626,0,626,259,885,70.7345
第15任總統副總統,在新竹縣各村(里),新竹縣,　竹北市,鹿場里,536,2938,4071,7545,104,7649,0,7649,1825,9474,80.7368
第15任總統副總統,在新竹縣各村(里),新竹縣,　竹北市,東平里,615,2911,5044,8570,125,8695,0,8695,2105,10800,80.5093
第15任總統副總統,在新竹縣各村(里),新竹縣,　竹北市,中興里,367,2143,3075,5585,95,5680,0,5680,1374,7054,80.5217
第15任總統副總統,在新竹縣各村(里),新竹縣,　竹北市,隘口里,134,829,1041,2004,27,2031,0,2031,514,2545,79.8035
第15任總統副總統,在新竹縣各村(里),新竹縣,　竹北市,東海里,95,1115,929,2139,21,2160,0,2160,794,2954,73.1212
第15任總統副總統,在新竹縣各村(里),新竹縣,　竹北市,東興里,292,1698,2740,4730,55,4785,0,4785,1269,6054,79.0387
第15任總統副總統,在新竹縣各村(里),新竹縣,　竹北市,北興里,251,1076,2047,3374,40,3414,0,3414,883,4297,79.4508
第15任總統副總統,在新竹縣各村(里),新竹縣,　竹北市,十興里,376,1788,2691,4855,59,4914,0,4914,1243,6157,79.8116
第15任總統副總統,在新竹縣各村(里),新竹縣,　竹北市,興安里,155,1111,1220,2486,25,2511,0,2511,704,3215,78.1026
第15任總統副總統,在新竹縣各村(里),新竹縣,　竹北市,文化里,153,1092,1224,2469,32,2501,0,2501,649,3150,79.3968
第15任總統副總統,在新竹縣各村(里),新竹縣,　竹北市,斗崙里,314,1962,2594,4870,67,4937,0,4937,1218,6155,80.2112
第15任總統副總統,在新竹縣各村(里),新竹縣,　竹北市,中崙里,266,1869,2391,4526,63,4589,0,4589,1110,5699,80.5229
第15任總統副總統,在新竹縣各村(里),新竹縣,　竹北市,北崙里,185,1242,1348,2775,41,2816,0,2816,815,3631,77.5544
第15任總統副總統,在新竹縣各村(里),新竹縣,　竹北市,新崙里,284,1856,2457,4597,65,4662,0,4662,1348,6010,77.5707
第15任總統副總統,在新竹縣各村(里),新竹縣,　竹北市,竹北里,321,2123,2519,4963,62,5025,0,5025,1606,6631,75.7804
第15任總統副總統,在新竹縣各村(里),新竹縣,　竹北市,竹仁里,358,3055,3037,6450,75,6525,1,6526,1938,8464,77.0912
第15任總統副總統,在新竹縣各村(里),新竹縣,　竹北市,福德里,118,1102,1145,2365,20,2385,0,2385,755,3140,75.9554
第15任總統副總統,在新竹縣各村(里),新竹縣,　竹北市,竹義里,210,1792,1956,3958,35,3993,0,3993,1658,5651,70.6601
第15任總統副總統,在新竹縣各村(里),新竹縣,　竹北市,泰和里,239,1885,1964,4088,55,4143,0,4143,1405,5548,74.6756
第15任總統副總統,在新竹縣各村(里),新竹縣,　竹北市,新社里,310,2040,2511,4861,61,4922,0,4922,1668,6590,74.6889
第15任總統副總統,在新竹縣各村(里),新竹縣,　竹北市,新國里,248,1620,2346,4214,48,4262,0,4262,1336,5598,76.1343
第15任總統副總統,在新竹縣各村(里),新竹縣,　竹北市,聯興里,195,1392,1689,3276,38,3314,0,3314,997,4311,76.8731
第15任總統副總統,在新竹縣各村(里),新竹縣,　竹北市,麻園里,86,541,791,1418,22,1440,0,1440,479,1919,75.0391
第15任總統副總統,在新竹縣各村(里),新竹縣,　竹北市,溪州里,70,740,994,1804,23,1827,0,1827,553,2380,76.7647
第15任總統副總統,在新竹縣各村(里),新竹縣,　竹北市,新庄里,38,317,403,758,12,770,0,770,253,1023,75.2688
第15任總統副總統,在新竹縣各村(里),新竹縣,　竹北市,白地里,82,520,950,1552,26,1578,0,1578,499,2077,75.9750
第15任總統副總統,在新竹縣各村(里),新竹縣,　竹北市,新港里,41,228,600,869,14,883,0,883,293,1176,75.0850
第15任總統副總統,在新竹縣各村(里),新竹縣,　竹北市,大眉里,60,497,682,1239,16,1255,0,1255,435,1690,74.2604
第15任總統副總統,在新竹縣各村(里),新竹縣,　竹北市,大義里,57,334,739,1130,11,1141,0,1141,412,1553,73.4707
第15任總統副總統,在新竹縣各村(里),新竹縣,　竹北市,尚義里,53,349,794,1196,13,1209,0,1209,410,1619,74.6757
第15任總統副總統,在新竹縣各村(里),新竹縣,　竹北市,崇義里,67,426,900,1393,14,1407,0,1407,447,1854,75.8900
第15任總統副總統,在新竹縣各村(里),新竹縣,　竹東鎮,上坪里,12,138,63,213,2,215,0,215,88,303,70.9571
第15任總統副總統,在新竹縣各村(里),新竹縣,　竹東鎮,瑞峰里,10,156,116,282,5,287,0,287,111,398,72.1106
第15任總統副總統,在新竹縣各村(里),新竹縣,　竹東鎮,軟橋里,15,167,89,271,1,272,0,272,97,369,73.7127
第15任總統副總統,在新竹縣各村(里),新竹縣,　竹東鎮,員崠里,84,926,540,1550,16,1566,0,1566,593,2159,72.5336
第15任總統副總統,在新竹縣各村(里),新竹縣,　竹東鎮,上舘里,367,3616,2475,6458,63,6521,0,6521,2391,8912,73.1710
第15任總統副總統,在新竹縣各村(里),新竹縣,　竹東鎮,東寧里,136,1334,866,2336,27,2363,0,2363,808,3171,74.5191
第15任總統副總統,在新竹縣各村(里),新竹縣,　竹東鎮,中正里,89,739,604,1432,21,1453,0,1453,455,1908,76.1530
第15任總統副總統,在新竹縣各村(里),新竹縣,　竹東鎮,大鄉里,154,1737,1278,3169,45,3214,0,3214,1189,4403,72.9957
第15任總統副總統,在新竹縣各村(里),新竹縣,　竹東鎮,中山里,77,719,446,1242,14,1256,0,1256,391,1647,76.2599
第15任總統副總統,在新竹縣各村(里),新竹縣,　竹東鎮,南華里,40,406,317,763,5,768,0,768,259,1027,74.7809
第15任總統副總統,在新竹縣各村(里),新竹縣,　竹東鎮,東華里,21,281,211,513,3,516,0,516,151,667,77.3613
第15任總統副總統,在新竹縣各村(里),新竹縣,　竹東鎮,商華里,98,1136,698,1932,19,1951,0,1951,1031,2982,65.4259
第15任總統副總統,在新竹縣各村(里),新竹縣,　竹東鎮,竹東里,41,491,476,1008,9,1017,0,1017,287,1304,77.9908
第15任總統副總統,在新竹縣各村(里),新竹縣,　竹東鎮,忠孝里,56,590,455,1101,18,1119,0,1119,395,1514,73.9102
第15任總統副總統,在新竹縣各村(里),新竹縣,　竹東鎮,鷄林里,149,1559,1027,2735,37,2772,0,2772,938,3710,74.7170
第15任總統副總統,在新竹縣各村(里),新竹縣,　竹東鎮,仁愛里,121,1301,946,2368,29,2397,0,2397,772,3169,75.6390
第15任總統副總統,在新竹縣各村(里),新竹縣,　竹東鎮,榮樂里,62,582,374,1018,14,1032,0,1032,320,1352,76.3314
第15任總統副總統,在新竹縣各村(里),新竹縣,　竹東鎮,榮華里,248,2781,1980,5009,81,5090,0,5090,1579,6669,76.3233
第15任總統副總統,在新竹縣各村(里),新竹縣,　竹東鎮,五豐里,294,2629,2096,5019,54,5073,0,5073,2129,7202,70.4388
第15任總統副總統,在新竹縣各村(里),新竹縣,　竹東鎮,陸豐里,18,229,175,422,3,425,0,425,124,549,77.4135
第15任總統副總統,在新竹縣各村(里),新竹縣,　竹東鎮,三重里,277,2204,1992,4473,46,4519,0,4519,1561,6080,74.3257
第15任總統副總統,在新竹縣各村(里),新竹縣,　竹東鎮,二重里,539,3642,3884,8065,95,8160,0,8160,2797,10957,74.4729
第15任總統副總統,在新竹縣各村(里),新竹縣,　竹東鎮,頭重里,186,1581,1498,3265,49,3314,0,3314,955,4269,77.6294
第15任總統副總統,在新竹縣各村(里),新竹縣,　竹東鎮,員山里,84,721,640,1445,15,1460,0,1460,403,1863,78.3682
第15任總統副總統,在新竹縣各村(里),新竹縣,　竹東鎮,柯湖里,24,227,199,450,6,456,0,456,125,581,78.4854
第15任總統副總統,在新竹縣各村(里),新竹縣,　新埔鎮,新埔里,26,372,317,715,5,720,0,720,223,943,76.3521
第15任總統副總統,在新竹縣各村(里),新竹縣,　新埔鎮,新生里,14,189,229,432,1,433,0,433,132,565,76.6372
第15任總統副總統,在新竹縣各村(里),新竹縣,　新埔鎮,新民里,49,407,308,764,8,772,0,772,254,1026,75.2437
第15任總統副總統,在新竹縣各村(里),新竹縣,　新埔鎮,田新里,87,961,848,1896,27,1923,0,1923,600,2523,76.2188
第15任總統副總統,在新竹縣各村(里),新竹縣,　新埔鎮,旱坑里,63,635,553,1251,11,1262,0,1262,489,1751,72.0731
第15任總統副總統,在新竹縣各村(里),新竹縣,　新埔鎮,五埔里,60,633,656,1349,16,1365,0,1365,552,1917,71.2050
第15任總統副總統,在新竹縣各村(里),新竹縣,　新埔鎮,四座里,131,1010,1267,2408,21,2429,0,2429,798,3227,75.2711
第15任總統副總統,在新竹縣各村(里),新竹縣,　新埔鎮,照門里,40,409,487,936,10,946,0,946,420,1366,69.2533
第15任總統副總統,在新竹縣各村(里),新竹縣,　新埔鎮,清水里,7,123,189,319,3,322,0,322,90,412,78.1553
第15任總統副總統,在新竹縣各村(里),新竹縣,　新埔鎮,鹿鳴里,18,196,310,524,5,529,0,529,175,704,75.1420
第15任總統副總統,在新竹縣各村(里),新竹縣,　新埔鎮,新北里,17,179,240,436,6,442,0,442,131,573,77.1379
第15任總統副總統,在新竹縣各村(里),新竹縣,　新埔鎮,巨埔里,29,325,490,844,15,859,0,859,259,1118,76.8336
第15任總統副總統,在新竹縣各村(里),新竹縣,　新埔鎮,內立里,23,373,374,770,14,784,0,784,299,1083,72.3915
第15任總統副總統,在新竹縣各村(里),新竹縣,　新埔鎮,寶石里,23,288,316,627,6,633,0,633,214,847,74.7344
第15任總統副總統,在新竹縣各村(里),新竹縣,　新埔鎮,文山里,164,1471,1401,3036,41,3077,0,3077,1086,4163,73.9130
第15任總統副總統,在新竹縣各村(里),新竹縣,　新埔鎮,上寮里,66,563,666,1295,17,1312,0,1312,470,1782,73.6251
第15任總統副總統,在新竹縣各村(里),新竹縣,　新埔鎮,下寮里,107,790,916,1813,25,1838,0,1838,638,2476,74.2326
第15任總統副總統,在新竹縣各村(里),新竹縣,　新埔鎮,南平里,35,323,374,732,13,745,0,745,218,963,77.3624
第15任總統副總統,在新竹縣各村(里),新竹縣,　新埔鎮,北平里,34,199,241,474,5,479,0,479,132,611,78.3961
第15任總統副總統,在新竹縣各村(里),新竹縣,　關西鎮,東興里,11,187,152,350,1,351,0,351,98,449,78.1737
第15任總統副總統,在新竹縣各村(里),新竹縣,　關西鎮,西安里,77,832,515,1424,14,1438,0,1438,400,1838,78.2372
第15任總統副總統,在新竹縣各村(里),新竹縣,　關西鎮,南雄里,22,250,240,512,8,520,0,520,155,675,77.0370
第15任總統副總統,在新竹縣各村(里),新竹縣,　關西鎮,北斗里,111,1373,1100,2584,28,2612,1,2613,883,3496,74.7140
第15任總統副總統,在新竹縣各村(里),新竹縣,　關西鎮,北山里,27,282,261,570,10,580,0,580,178,758,76.5172
第15任總統副總統,在新竹縣各村(里),新竹縣,　關西鎮,仁安里,36,331,347,714,12,726,0,726,262,988,73.4818
第15任總統副總統,在新竹縣各村(里),新竹縣,　關西鎮,南山里,32,369,334,735,15,750,0,750,254,1004,74.7012
第15任總統副總統,在新竹縣各村(里),新竹縣,　關西鎮,東安里,114,1300,1155,2569,30,2599,0,2599,934,3533,73.5635
第15任總統副總統,在新竹縣各村(里),新竹縣,　關西鎮,東山里,30,288,296,614,7,621,0,621,188,809,76.7614
第15任總統副總統,在新竹縣各村(里),新竹縣,　關西鎮,東光里,30,454,418,902,13,915,0,915,343,1258,72.7345
第15任總統副總統,在新竹縣各村(里),新竹縣,　關西鎮,南新里,32,347,231,610,6,616,0,616,248,864,71.2963
第15任總統副總統,在新竹縣各村(里),新竹縣,　關西鎮,新富里,20,149,186,355,5,360,0,360,157,517,69.6325
第15任總統副總統,在新竹縣各村(里),新竹縣,　關西鎮,玉山里,12,141,124,277,6,283,0,283,157,440,64.3182
第15任總統副總統,在新竹縣各村(里),新竹縣,　關西鎮,金山里,12,218,149,379,2,381,0,381,156,537,70.9497
第15任總統副總統,在新竹縣各村(里),新竹縣,　關西鎮,錦山里,21,358,235,614,8,622,0,622,273,895,69.4972
第15任總統副總統,在新竹縣各村(里),新竹縣,　關西鎮,大同里,25,266,314,605,11,616,0,616,165,781,78.8732
第15任總統副總統,在新竹縣各村(里),新竹縣,　關西鎮,石光里,56,667,586,1309,12,1321,0,1321,424,1745,75.7020
第15任總統副總統,在新竹縣各村(里),新竹縣,　關西鎮,東平里,31,337,311,679,9,688,0,688,250,938,73.3475
第15任總統副總統,在新竹縣各村(里),新竹縣,　關西鎮,上林里,24,332,238,594,6,600,0,600,187,787,76.2389
第15任總統副總統,在新竹縣各村(里),新竹縣,　關西鎮,新力里,21,224,184,429,2,431,0,431,113,544,79.2279
第15任總統副總統,在新竹縣各村(里),新竹縣,　關西鎮,南和里,28,311,297,636,9,645,0,645,175,820,78.6585
第15任總統副總統,在新竹縣各村(里),新竹縣,　湖口鄉,和興村,84,930,1027,2041,18,2059,0,2059,721,2780,74.0647
第15任總統副總統,在新竹縣各村(里),新竹縣,　湖口鄉,東興村,180,1328,1390,2898,26,2924,0,2924,1077,4001,73.0817
第15任總統副總統,在新竹縣各村(里),新竹縣,　湖口鄉,德盛村,183,1554,1519,3256,45,3301,0,3301,1311,4612,71.5742
第15任總統副總統,在新竹縣各村(里),新竹縣,　湖口鄉,愛勢村,158,1428,1330,2916,37,2953,0,2953,866,3819,77.3239
第15任總統副總統,在新竹縣各村(里),新竹縣,　湖口鄉,仁勢村,38,299,298,635,7,642,0,642,197,839,76.5197
第15任總統副總統,在新竹縣各村(里),新竹縣,　湖口鄉,孝勢村,45,497,405,947,12,959,0,959,258,1217,78.8003
第15任總統副總統,在新竹縣各村(里),新竹縣,　湖口鄉,中勢村,148,1018,1058,2224,26,2250,0,2250,671,2921,77.0284
第15任總統副總統,在新竹縣各村(里),新竹縣,　湖口鄉,中正村,126,1073,1080,2279,21,2300,0,2300,656,2956,77.8078
第15任總統副總統,在新竹縣各村(里),新竹縣,　湖口鄉,信勢村,232,1658,1652,3542,34,3576,0,3576,1470,5046,70.8680
第15任總統副總統,在新竹縣各村(里),新竹縣,　湖口鄉,信義村,154,1213,1108,2475,30,2505,0,2505,810,3315,75.5656
第15任總統副總統,在新竹縣各村(里),新竹縣,　湖口鄉,波羅村,90,668,749,1507,26,1533,0,1533,605,2138,71.7025
第15任總統副總統,在新竹縣各村(里),新竹縣,　湖口鄉,長嶺村,131,1090,966,2187,22,2209,0,2209,854,3063,72.1188
第15任總統副總統,在新竹縣各村(里),新竹縣,　湖口鄉,長安村,43,333,414,790,13,803,0,803,257,1060,75.7547
第15任總統副總統,在新竹縣各村(里),新竹縣,　湖口鄉,湖口村,116,1006,902,2024,28,2052,0,2052,643,2695,76.1410
第15任總統副總統,在新竹縣各村(里),新竹縣,　湖口鄉,湖鏡村,85,978,659,1722,18,1740,0,1740,537,2277,76.4163
第15任總統副總統,在新竹縣各村(里),新竹縣,　湖口鄉,湖南村,64,606,426,1096,10,1106,0,1106,369,1475,74.9831
第15任總統副總統,在新竹縣各村(里),新竹縣,　湖口鄉,中興村,263,2248,1522,4033,51,4084,0,4084,1744,5828,70.0755
第15任總統副總統,在新竹縣各村(里),新竹縣,　湖口鄉,鳳凰村,189,1651,1533,3373,55,3428,0,3428,1507,4935,69.4630
第15任總統副總統,在新竹縣各村(里),新竹縣,　湖口鄉,勝利村,161,1528,1070,2759,28,2787,0,2787,1188,3975,70.1132
第15任總統副總統,在新竹縣各村(里),新竹縣,　湖口鄉,鳳山村,140,1248,841,2229,22,2251,0,2251,862,3113,72.3097
第15任總統副總統,在新竹縣各村(里),新竹縣,　新豐鄉,福興村,43,315,394,752,12,764,0,764,276,1040,73.4615
第15任總統副總統,在新竹縣各村(里),新竹縣,　新豐鄉,青埔村,61,618,621,1300,17,1317,0,1317,476,1793,73.4523
第15任總統副總統,在新竹縣各村(里),新竹縣,　新豐鄉,中崙村,127,1032,1024,2183,30,2213,0,2213,882,3095,71.5024
第15任總統副總統,在新竹縣各村(里),新竹縣,　新豐鄉,瑞興村,68,502,649,1219,18,1237,0,1237,529,1766,70.0453
第15任總統副總統,在新竹縣各村(里),新竹縣,　新豐鄉,後湖村,75,593,596,1264,19,1283,0,1283,477,1760,72.8977
第15任總統副總統,在新竹縣各村(里),新竹縣,　新豐鄉,坡頭村,13,195,371,579,7,586,0,586,235,821,71.3764
第15任總統副總統,在新竹縣各村(里),新竹縣,　新豐鄉,埔和村,114,628,1182,1924,16,1940,0,1940,729,2669,72.6864
第15任總統副總統,在新竹縣各村(里),新竹縣,　新豐鄉,新豐村,84,499,898,1481,24,1505,0,1505,523,2028,74.2110
第15任總統副總統,在新竹縣各村(里),新竹縣,　新豐鄉,員山村,109,890,773,1772,24,1796,0,1796,662,2458,73.0675
第15任總統副總統,在新竹縣各村(里),新竹縣,　新豐鄉,忠孝村,146,1315,1136,2597,27,2624,0,2624,787,3411,76.9276
第15任總統副總統,在新竹縣各村(里),新竹縣,　新豐鄉,山崎村,194,1484,1488,3166,34,3200,0,3200,989,4189,76.3905
第15任總統副總統,在新竹縣各村(里),新竹縣,　新豐鄉,上坑村,51,523,496,1070,20,1090,0,1090,389,1479,73.6984
第15任總統副總統,在新竹縣各村(里),新竹縣,　新豐鄉,鳳坑村,29,319,375,723,12,735,0,735,271,1006,73.0616
第15任總統副總統,在新竹縣各村(里),新竹縣,　新豐鄉,重興村,194,1680,1617,3491,37,3528,0,3528,1479,5007,70.4614
第15任總統副總統,在新竹縣各村(里),新竹縣,　新豐鄉,崎頂村,103,939,903,1945,16,1961,0,1961,665,2626,74.6763
第15任總統副總統,在新竹縣各村(里),新竹縣,　新豐鄉,松林村,192,1526,1408,3126,30,3156,0,3156,1048,4204,75.0714
第15任總統副總統,在新竹縣各村(里),新竹縣,　新豐鄉,松柏村,263,1759,1950,3972,46,4018,0,4018,1344,5362,74.9347
第15任總統副總統,在新竹縣各村(里),新竹縣,　芎林鄉,華龍村,6,173,107,286,3,289,0,289,103,392,73.7245
第15任總統副總統,在新竹縣各村(里),新竹縣,　芎林鄉,五龍村,15,232,132,379,5,384,0,384,110,494,77.7328
第15任總統副總統,在新竹縣各村(里),新竹縣,　芎林鄉,秀湖村,43,394,253,690,13,703,0,703,210,913,76.9989
第15任總統副總統,在新竹縣各村(里),新竹縣,　芎林鄉,永興村,10,174,108,292,3,295,0,295,108,403,73.2010
第15任總統副總統,在新竹縣各村(里),新竹縣,　芎林鄉,石潭村,101,990,786,1877,18,1895,0,1895,676,2571,73.7067
第15任總統副總統,在新竹縣各村(里),新竹縣,　芎林鄉,新鳳村,64,589,501,1154,17,1171,0,1171,396,1567,74.7288
第15任總統副總統,在新竹縣各村(里),新竹縣,　芎林鄉,中坑村,30,269,142,441,6,447,0,447,154,601,74.3760
第15任總統副總統,在新竹縣各村(里),新竹縣,　芎林鄉,水坑村,29,281,237,547,9,556,0,556,196,752,73.9362
第15任總統副總統,在新竹縣各村(里),新竹縣,　芎林鄉,文林村,90,971,659,1720,19,1739,0,1739,582,2321,74.9246
第15任總統副總統,在新竹縣各村(里),新竹縣,　芎林鄉,芎林村,74,544,551,1169,14,1183,0,1183,333,1516,78.0343
第15任總統副總統,在新竹縣各村(里),新竹縣,　芎林鄉,上山村,209,1535,1551,3295,53,3348,0,3348,931,4279,78.2426
第15任總統副總統,在新竹縣各村(里),新竹縣,　芎林鄉,下山村,41,402,366,809,12,821,0,821,237,1058,77.5992
第15任總統副總統,在新竹縣各村(里),新竹縣,　橫山鄉,橫山村,110,1384,873,2367,29,2396,0,2396,870,3266,73.3619
第15任總統副總統,在新竹縣各村(里),新竹縣,　橫山鄉,田寮村,22,347,257,626,9,635,0,635,206,841,75.5054
第15任總統副總統,在新竹縣各村(里),新竹縣,　橫山鄉,南昌村,7,93,41,141,0,141,0,141,54,195,72.3077
第15任總統副總統,在新竹縣各村(里),新竹縣,　橫山鄉,豐鄉村,8,80,67,155,3,158,0,158,54,212,74.5283
第15任總統副總統,在新竹縣各村(里),新竹縣,　橫山鄉,豐田村,8,125,111,244,1,245,0,245,81,326,75.1534
第15任總統副總統,在新竹縣各村(里),新竹縣,　橫山鄉,內灣村,34,371,216,621,7,628,0,628,245,873,71.9359
第15任總統副總統,在新竹縣各村(里),新竹縣,　橫山鄉,力行村,31,347,222,600,8,608,0,608,192,800,76.0000
第15任總統副總統,在新竹縣各村(里),新竹縣,　橫山鄉,福興村,13,144,146,303,10,313,0,313,122,435,71.9540
第15任總統副總統,在新竹縣各村(里),新竹縣,　橫山鄉,沙坑村,30,396,304,730,9,739,0,739,216,955,77.3822
第15任總統副總統,在新竹縣各村(里),新竹縣,　橫山鄉,新興村,58,684,396,1138,12,1150,0,1150,353,1503,76.5136
第15任總統副總統,在新竹縣各村(里),新竹縣,　橫山鄉,大肚村,68,714,390,1172,12,1184,0,1184,370,1554,76.1905
第15任總統副總統,在新竹縣各村(里),新竹縣,　北埔鄉,北埔村,46,462,346,854,11,865,0,865,243,1108,78.0686
第15任總統副總統,在新竹縣各村(里),新竹縣,　北埔鄉,南興村,42,514,306,862,15,877,0,877,282,1159,75.6687
第15任總統副總統,在新竹縣各村(里),新竹縣,　北埔鄉,大湖村,19,226,148,393,2,395,0,395,154,549,71.9490
第15任總統副總統,在新竹縣各村(里),新竹縣,　北埔鄉,埔尾村,86,991,759,1836,18,1854,0,1854,664,2518,73.6299
第15任總統副總統,在新竹縣各村(里),新竹縣,　北埔鄉,水磜村,25,293,274,592,4,596,0,596,224,820,72.6829
第15任總統副總統,在新竹縣各村(里),新竹縣,　北埔鄉,南埔村,19,154,85,258,1,259,0,259,103,362,71.5470
第15任總統副總統,在新竹縣各村(里),新竹縣,　北埔鄉,大林村,33,323,212,568,7,575,0,575,153,728,78.9835
第15任總統副總統,在新竹縣各村(里),新竹縣,　北埔鄉,南坑村,10,146,101,257,2,259,0,259,76,335,77.3134
第15任總統副總統,在新竹縣各村(里),新竹縣,　北埔鄉,外坪村,7,111,92,210,2,212,0,212,74,286,74.1259
第15任總統副總統,在新竹縣各村(里),新竹縣,　寶山鄉,雙溪村,150,837,921,1908,19,1927,0,1927,642,2569,75.0097
第15任總統副總統,在新竹縣各村(里),新竹縣,　寶山鄉,雙新村,98,871,901,1870,15,1885,0,1885,684,2569,73.3749
第15任總統副總統,在新竹縣各村(里),新竹縣,　寶山鄉,大崎村,107,686,665,1458,19,1477,0,1477,416,1893,78.0243
第15任總統副總統,在新竹縣各村(里),新竹縣,　寶山鄉,三峰村,35,382,292,709,3,712,0,712,283,995,71.5578
第15任總統副總統,在新竹縣各村(里),新竹縣,　寶山鄉,新城村,38,420,398,856,6,862,0,862,292,1154,74.6967
第15任總統副總統,在新竹縣各村(里),新竹縣,　寶山鄉,寶斗村,26,267,246,539,3,542,0,542,189,731,74.1450
第15任總統副總統,在新竹縣各村(里),新竹縣,　寶山鄉,深井村,20,349,238,607,5,612,0,612,178,790,77.4684
第15任總統副總統,在新竹縣各村(里),新竹縣,　寶山鄉,寶山村,44,330,232,606,7,613,0,613,177,790,77.5949
第15任總統副總統,在新竹縣各村(里),新竹縣,　寶山鄉,油田村,17,244,193,454,4,458,0,458,125,583,78.5592
第15任總統副總統,在新竹縣各村(里),新竹縣,　寶山鄉,山湖村,28,208,167,403,12,415,0,415,123,538,77.1375
第15任總統副總統,在新竹縣各村(里),新竹縣,　峨眉鄉,峨眉村,31,372,235,638,9,647,0,647,182,829,78.0458
第15任總統副總統,在新竹縣各村(里),新竹縣,　峨眉鄉,中盛村,15,231,259,505,8,513,0,513,145,658,77.9635
第15任總統副總統,在新竹縣各村(里),新竹縣,　峨眉鄉,石井村,16,236,184,436,4,440,0,440,139,579,75.9931
第15任總統副總統,在新竹縣各村(里),新竹縣,　峨眉鄉,七星村,12,231,212,455,3,458,0,458,136,594,77.1044
第15任總統副總統,在新竹縣各村(里),新竹縣,　峨眉鄉,富興村,44,495,418,957,5,962,0,962,392,1354,71.0487
第15任總統副總統,在新竹縣各村(里),新竹縣,　峨眉鄉,湖光村,26,317,285,628,9,637,0,637,196,833,76.4706
第15任總統副總統,在新竹縣各村(里),新竹縣,　尖石鄉,嘉樂村,37,367,166,570,2,572,0,572,220,792,72.2222
第15任總統副總統,在新竹縣各村(里),新竹縣,　尖石鄉,義興村,14,258,105,377,8,385,0,385,186,571,67.4256
第15任總統副總統,在新竹縣各村(里),新竹縣,　尖石鄉,新樂村,36,645,154,835,10,845,0,845,365,1210,69.8347
第15任總統副總統,在新竹縣各村(里),新竹縣,　尖石鄉,錦屏村,30,585,136,751,7,758,0,758,353,1111,68.2268
第15任總統副總統,在新竹縣各村(里),新竹縣,　尖石鄉,梅花村,10,312,96,418,9,427,0,427,171,598,71.4047
第15任總統副總統,在新竹縣各村(里),新竹縣,　尖石鄉,玉峰村,52,517,268,837,3,840,0,840,437,1277,65.7792
第15任總統副總統,在新竹縣各村(里),新竹縣,　尖石鄉,秀巒村,29,607,260,896,14,910,0,910,596,1506,60.4250
第15任總統副總統,在新竹縣各村(里),新竹縣,　五峰鄉,大隘村,35,725,153,913,14,927,0,927,362,1289,71.9162
第15任總統副總統,在新竹縣各村(里),新竹縣,　五峰鄉,桃山村,27,644,233,904,7,911,0,911,475,1386,65.7287
第15任總統副總統,在新竹縣各村(里),新竹縣,　五峰鄉,花園村,20,324,149,493,5,498,0,498,198,696,71.5517
第15任總統副總統,在新竹縣各村(里),新竹縣,　五峰鄉,竹林村,11,189,53,253,4,257,0,257,116,373,68.9008
第15任總統副總統,在新北市各村(里),新北市,　板橋區,留侯里,58,430,557,1045,24,1069,0,1069,304,1373,77.8587
第15任總統副總統,在新北市各村(里),新北市,　板橋區,流芳里,50,345,534,929,6,935,0,935,311,1246,75.0401
第15任總統副總統,在新北市各村(里),新北市,　板橋區,赤松里,24,218,336,578,15,593,0,593,153,746,79.4906
第15任總統副總統,在新北市各村(里),新北市,　板橋區,黃石里,35,248,423,706,13,719,0,719,230,949,75.7640
第15任總統副總統,在新北市各村(里),新北市,　板橋區,挹秀里,68,566,594,1228,17,1245,0,1245,360,1605,77.5701
第15任總統副總統,在新北市各村(里),新北市,　板橋區,湳興里,153,1275,1935,3363,54,3417,0,3417,1138,4555,75.0165
第15任總統副總統,在新北市各村(里),新北市,　板橋區,新興里,91,769,1196,2056,17,2073,0,2073,767,2840,72.9930
第15任總統副總統,在新北市各村(里),新北市,　板橋區,社後里,201,1481,2363,4045,58,4103,0,4103,4301,8404,48.8220
第15任總統副總統,在新北市各村(里),新北市,　板橋區,香社里,110,945,1759,2814,34,2848,0,2848,838,3686,77.2653
第15任總統副總統,在新北市各村(里),新北市,　板橋區,香雅里,74,599,1025,1698,16,1714,0,1714,515,2229,76.8955
第15任總統副總統,在新北市各村(里),新北市,　板橋區,中正里,116,944,1726,2786,26,2812,0,2812,908,3720,75.5914
第15任總統副總統,在新北市各村(里),新北市,　板橋區,自強里,166,1642,1758,3566,40,3606,0,3606,853,4459,80.8702
第15任總統副總統,在新北市各村(里),新北市,　板橋區,自立里,81,668,1141,1890,21,1911,0,1911,526,2437,78.4161
第15任總統副總統,在新北市各村(里),新北市,　板橋區,光華里,62,734,1021,1817,23,1840,0,1840,532,2372,77.5717
第15任總統副總統,在新北市各村(里),新北市,　板橋區,光榮里,65,708,918,1691,20,1711,0,1711,552,2263,75.6076
第15任總統副總統,在新北市各村(里),新北市,　板橋區,國光里,140,1520,940,2600,32,2632,0,2632,657,3289,80.0243
第15任總統副總統,在新北市各村(里),新北市,　板橋區,港尾里,89,724,1105,1918,30,1948,0,1948,467,2415,80.6625
第15任總統副總統,在新北市各村(里),新北市,　板橋區,新生里,107,1015,1764,2886,31,2917,0,2917,834,3751,77.7659
第15任總統副總統,在新北市各村(里),新北市,　板橋區,金華里,123,867,1619,2609,30,2639,0,2639,820,3459,76.2937
第15任總統副總統,在新北市各村(里),新北市,　板橋區,港德里,160,1023,1905,3088,30,3118,0,3118,1018,4136,75.3868
第15任總統副總統,在新北市各村(里),新北市,　板橋區,民權里,69,763,990,1822,25,1847,0,1847,454,2301,80.2694
第15任總統副總統,在新北市各村(里),新北市,　板橋區,民安里,50,564,765,1379,12,1391,0,1391,363,1754,79.3044
第15任總統副總統,在新北市各村(里),新北市,　板橋區,建國里,110,835,1442,2387,32,2419,0,2419,653,3072,78.7435
第15任總統副總統,在新北市各村(里),新北市,　板橋區,漢生里,130,1102,1542,2774,41,2815,0,2815,737,3552,79.2511
第15任總統副總統,在新北市各村(里),新北市,　板橋區,公舘里,86,839,1556,2481,30,2511,0,2511,687,3198,78.5178
第15任總統副總統,在新北市各村(里),新北市,　板橋區,新民里,115,1053,1608,2776,26,2802,0,2802,790,3592,78.0067
第15任總統副總統,在新北市各村(里),新北市,　板橋區,幸福里,128,856,1526,2510,31,2541,1,2542,829,3371,75.3782
第15任總統副總統,在新北市各村(里),新北市,　板橋區,文德里,100,722,1217,2039,17,2056,0,2056,611,2667,77.0904
第15任總統副總統,在新北市各村(里),新北市,　板橋區,忠誠里,112,1673,1033,2818,26,2844,0,2844,675,3519,80.8184
第15任總統副總統,在新北市各村(里),新北市,　板橋區,陽明里,77,607,1176,1860,16,1876,0,1876,520,2396,78.2972
第15任總統副總統,在新北市各村(里),新北市,　板橋區,百壽里,80,669,1034,1783,19,1802,0,1802,479,2281,79.0004
第15任總統副總統,在新北市各村(里),新北市,　板橋區,介壽里,74,723,1170,1967,25,1992,0,1992,598,2590,76.9112
第15任總統副總統,在新北市各村(里),新北市,　板橋區,新埔里,64,512,880,1456,14,1470,0,1470,394,1864,78.8627
第15任總統副總統,在新北市各村(里),新北市,　板橋區,華江里,225,1796,2660,4681,65,4746,0,4746,1334,6080,78.0592
第15任總統副總統,在新北市各村(里),新北市,　板橋區,江翠里,136,1046,2089,3271,31,3302,0,3302,1011,4313,76.5592
第15任總統副總統,在新北市各村(里),新北市,　板橋區,純翠里,133,1092,2307,3532,45,3577,0,3577,1092,4669,76.6117
第15任總統副總統,在新北市各村(里),新北市,　板橋區,溪頭里,171,1227,2430,3828,48,3876,0,3876,1173,5049,76.7677
第15任總統副總統,在新北市各村(里),新北市,　板橋區,聯翠里,113,871,1382,2366,24,2390,0,2390,812,3202,74.6408
第15任總統副總統,在新北市各村(里),新北市,　板橋區,文化里,113,742,1380,2235,20,2255,0,2255,661,2916,77.3320
第15任總統副總統,在新北市各村(里),新北市,　板橋區,宏翠里,181,1180,1957,3318,37,3355,0,3355,1033,4388,76.4585
第15任總統副總統,在新北市各村(里),新北市,　板橋區,仁翠里,83,549,1277,1909,26,1935,0,1935,555,2490,77.7108
第15任總統副總統,在新北市各村(里),新北市,　板橋區,新翠里,257,1774,3212,5243,61,5304,5,5309,1476,6785,78.1724
第15任總統副總統,在新北市各村(里),新北市,　板橋區,朝陽里,96,633,1486,2215,27,2242,0,2242,715,2957,75.8201
第15任總統副總統,在新北市各村(里),新北市,　板橋區,吉翠里,113,747,1642,2502,26,2528,0,2528,700,3228,78.3147
第15任總統副總統,在新北市各村(里),新北市,　板橋區,德翠里,223,1700,2798,4721,48,4769,0,4769,1298,6067,78.6056
第15任總統副總統,在新北市各村(里),新北市,　板橋區,新海里,84,730,1525,2339,27,2366,0,2366,706,3072,77.0182
第15任總統副總統,在新北市各村(里),新北市,　板橋區,滿翠里,82,565,1317,1964,26,1990,0,1990,605,2595,76.6859
第15任總統副總統,在新北市各村(里),新北市,　板橋區,明翠里,119,1023,1982,3124,26,3150,0,3150,981,4131,76.2527
第15任總統副總統,在新北市各村(里),新北市,　板橋區,松翠里,99,746,1356,2201,25,2226,0,2226,693,2919,76.2590
第15任總統副總統,在新北市各村(里),新北市,　板橋區,柏翠里,143,962,1751,2856,32,2888,0,2888,911,3799,76.0200
第15任總統副總統,在新北市各村(里),新北市,　板橋區,龍翠里,153,1061,2129,3343,44,3387,0,3387,976,4363,77.6301
第15任總統副總統,在新北市各村(里),新北市,　板橋區,松柏里,75,458,967,1500,28,1528,0,1528,428,1956,78.1186
第15任總統副總統,在新北市各村(里),新北市,　板橋區,華翠里,108,730,1505,2343,30,2373,0,2373,638,3011,78.8110
第15任總統副總統,在新北市各村(里),新北市,　板橋區,莒光里,85,585,1211,1881,21,1902,0,1902,559,2461,77.2857
第15任總統副總統,在新北市各村(里),新北市,　板橋區,忠翠里,320,2516,3983,6819,78,6897,0,6897,1840,8737,78.9401
第15任總統副總統,在新北市各村(里),新北市,　板橋區,嵐翠里,70,498,1050,1618,16,1634,0,1634,513,2147,76.1062
第15任總統副總統,在新北市各村(里),新北市,　板橋區,文聖里,109,819,1634,2562,33,2595,0,2595,771,3366,77.0945
第15任總統副總統,在新北市各村(里),新北市,　板橋區,文翠里,137,916,1665,2718,31,2749,0,2749,781,3530,77.8754
第15任總統副總統,在新北市各村(里),新北市,　板橋區,青翠里,80,605,1246,1931,21,1952,0,1952,672,2624,74.3902
第15任總統副總統,在新北市各村(里),新北市,　板橋區,懷翠里,166,1201,2515,3882,51,3933,0,3933,1314,5247,74.9571
第15任總統副總統,在新北市各村(里),新北市,　板橋區,福翠里,40,325,486,851,16,867,0,867,292,1159,74.8059
第15任總統副總統,在新北市各村(里),新北市,　板橋區,港嘴里,166,1368,2486,4020,41,4061,1,4062,1204,5266,77.1174
第15任總統副總統,在新北市各村(里),新北市,　板橋區,埤墘里,142,967,1748,2857,38,2895,0,2895,819,3714,77.9483
第15任總統副總統,在新北市各村(里),新北市,　板橋區,莊敬里,133,940,1578,2651,32,2683,0,2683,690,3373,79.5434
第15任總統副總統,在新北市各村(里),新北市,　板橋區,永安里,99,712,1421,2232,26,2258,0,2258,663,2921,77.3023
第15任總統副總統,在新北市各村(里),新北市,　板橋區,振興里,122,995,1898,3015,30,3045,0,3045,831,3876,78.5604
第15任總統副總統,在新北市各村(里),新北市,　板橋區,振義里,112,866,1797,2775,33,2808,0,2808,855,3663,76.6585
第15任總統副總統,在新北市各村(里),新北市,　板橋區,光復里,89,720,1383,2192,23,2215,1,2216,677,2893,76.5641
第15任總統副總統,在新北市各村(里),新北市,　板橋區,埔墘里,176,1488,2562,4226,48,4274,0,4274,1208,5482,77.9642
第15任總統副總統,在新北市各村(里),新北市,　板橋區,富貴里,74,572,916,1562,21,1583,0,1583,400,1983,79.8285
第15任總統副總統,在新北市各村(里),新北市,　板橋區,長壽里,92,668,1216,1976,11,1987,0,1987,541,2528,78.5997
第15任總統副總統,在新北市各村(里),新北市,　板橋區,福壽里,122,870,1236,2228,22,2250,0,2250,653,2903,77.5060
第15任總統副總統,在新北市各村(里),新北市,　板橋區,居仁里,109,781,1543,2433,16,2449,0,2449,679,3128,78.2928
第15任總統副總統,在新北市各村(里),新北市,　板橋區,海山里,242,1762,2880,4884,69,4953,1,4954,1357,6311,78.4820
第15任總統副總統,在新北市各村(里),新北市,　板橋區,九如里,87,577,1198,1862,29,1891,0,1891,541,2432,77.7549
第15任總統副總統,在新北市各村(里),新北市,　板橋區,正泰里,86,714,1224,2024,35,2059,0,2059,543,2602,79.1314
第15任總統副總統,在新北市各村(里),新北市,　板橋區,玉光里,141,1117,2032,3290,37,3327,0,3327,1151,4478,74.2966
第15任總統副總統,在新北市各村(里),新北市,　板橋區,光仁里,100,626,1190,1916,25,1941,0,1941,499,2440,79.5492
第15任總統副總統,在新北市各村(里),新北市,　板橋區,雙玉里,108,909,1567,2584,30,2614,0,2614,792,3406,76.7469
第15任總統副總統,在新北市各村(里),新北市,　板橋區,廣新里,83,760,1363,2206,27,2233,0,2233,780,3013,74.1122
第15任總統副總統,在新北市各村(里),新北市,　板橋區,深丘里,227,2150,2891,5268,72,5340,0,5340,1653,6993,76.3621
第15任總統副總統,在新北市各村(里),新北市,　板橋區,香丘里,104,834,1440,2378,26,2404,0,2404,717,3121,77.0266
第15任總統副總統,在新北市各村(里),新北市,　板橋區,西安里,79,639,1062,1780,23,1803,0,1803,531,2334,77.2494
第15任總統副總統,在新北市各村(里),新北市,　板橋區,東丘里,119,982,1884,2985,29,3014,0,3014,843,3857,78.1436
第15任總統副總統,在新北市各村(里),新北市,　板橋區,民生里,57,509,921,1487,13,1500,0,1500,412,1912,78.4519
第15任總統副總統,在新北市各村(里),新北市,　板橋區,長安里,149,990,1767,2906,38,2944,0,2944,762,3706,79.4387
第15任總統副總統,在新北市各村(里),新北市,　板橋區,東安里,58,496,960,1514,16,1530,0,1530,457,1987,77.0005
第15任總統副總統,在新北市各村(里),新北市,　板橋區,福丘里,155,1342,1612,3109,41,3150,0,3150,930,4080,77.2059
第15任總統副總統,在新北市各村(里),新北市,　板橋區,福祿里,105,1053,1287,2445,26,2471,0,2471,807,3278,75.3813
第15任總統副總統,在新北市各村(里),新北市,　板橋區,民族里,152,1059,1668,2879,26,2905,0,2905,769,3674,79.0691
第15任總統副總統,在新北市各村(里),新北市,　板橋區,國泰里,85,932,1264,2281,31,2312,0,2312,723,3035,76.1779
第15任總統副總統,在新北市各村(里),新北市,　板橋區,後埔里,111,1008,1338,2457,47,2504,0,2504,702,3206,78.1036
第15任總統副總統,在新北市各村(里),新北市,　板橋區,福德里,145,1239,1929,3313,41,3354,0,3354,990,4344,77.2099
第15任總統副總統,在新北市各村(里),新北市,　板橋區,景星里,94,857,1260,2211,38,2249,0,2249,762,3011,74.6928
第15任總統副總統,在新北市各村(里),新北市,　板橋區,福星里,100,872,1395,2367,27,2394,0,2394,629,3023,79.1929
第15任總統副總統,在新北市各村(里),新北市,　板橋區,鄉雲里,137,949,1432,2518,39,2557,0,2557,750,3307,77.3208
第15任總統副總統,在新北市各村(里),新北市,　板橋區,廣德里,208,1717,2468,4393,67,4460,0,4460,1319,5779,77.1760
第15任總統副總統,在新北市各村(里),新北市,　板橋區,大豐里,144,1213,1702,3059,34,3093,0,3093,925,4018,76.9786
第15任總統副總統,在新北市各村(里),新北市,　板橋區,重慶里,266,2049,3122,5437,60,5497,0,5497,1797,7294,75.3633
第15任總統副總統,在新北市各村(里),新北市,　板橋區,仁愛里,122,1022,970,2114,36,2150,0,2150,570,2720,79.0441
第15任總統副總統,在新北市各村(里),新北市,　板橋區,和平里,142,987,1290,2419,19,2438,1,2439,684,3123,78.0660
第15任總統副總統,在新北市各村(里),新北市,　板橋區,廣福里,120,921,1520,2561,21,2582,0,2582,855,3437,75.1237
第15任總統副總統,在新北市各村(里),新北市,　板橋區,五權里,121,964,1576,2661,20,2681,0,2681,813,3494,76.7315
第15任總統副總統,在新北市各村(里),新北市,　板橋區,華興里,147,1055,1584,2786,39,2825,0,2825,849,3674,76.8917
第15任總統副總統,在新北市各村(里),新北市,　板橋區,華貴里,87,617,987,1691,24,1715,0,1715,521,2236,76.6995
第15任總統副總統,在新北市各村(里),新北市,　板橋區,華福里,66,546,783,1395,26,1421,0,1421,383,1804,78.7694
第15任總統副總統,在新北市各村(里),新北市,　板橋區,華德里,186,1725,2596,4507,56,4563,0,4563,1560,6123,74.5223
第15任總統副總統,在新北市各村(里),新北市,　板橋區,華東里,254,2215,2707,5176,56,5232,0,5232,1437,6669,78.4525
第15任總統副總統,在新北市各村(里),新北市,　板橋區,信義里,127,1019,1581,2727,30,2757,0,2757,938,3695,74.6143
第15任總統副總統,在新北市各村(里),新北市,　板橋區,浮洲里,113,804,1608,2525,17,2542,0,2542,812,3354,75.7901
第15任總統副總統,在新北市各村(里),新北市,　板橋區,華中里,139,1013,2258,3410,36,3446,0,3446,1130,4576,75.3059
第15任總統副總統,在新北市各村(里),新北市,　板橋區,僑中里,128,864,1805,2797,33,2830,0,2830,837,3667,77.1748
第15任總統副總統,在新北市各村(里),新北市,　板橋區,大觀里,101,708,1586,2395,20,2415,0,2415,755,3170,76.1830
第15任總統副總統,在新北市各村(里),新北市,　板橋區,歡園里,43,235,550,828,5,833,0,833,251,1084,76.8450
第15任總統副總統,在新北市各村(里),新北市,　板橋區,中山里,226,1697,2343,4266,46,4312,0,4312,1443,5755,74.9262
第15任總統副總統,在新北市各村(里),新北市,　板橋區,復興里,31,313,326,670,12,682,0,682,230,912,74.7807
第15任總統副總統,在新北市各村(里),新北市,　板橋區,大安里,122,931,1573,2626,25,2651,0,2651,788,3439,77.0864
第15任總統副總統,在新北市各村(里),新北市,　板橋區,福安里,240,1856,2390,4486,61,4547,0,4547,1365,5912,76.9114
第15任總統副總統,在新北市各村(里),新北市,　板橋區,聚安里,146,1115,2158,3419,34,3453,0,3453,1137,4590,75.2288
第15任總統副總統,在新北市各村(里),新北市,　板橋區,龍安里,92,622,1129,1843,20,1863,0,1863,567,2430,76.6667
第15任總統副總統,在新北市各村(里),新北市,　板橋區,崑崙里,272,2170,3700,6142,72,6214,0,6214,2039,8253,75.2938
第15任總統副總統,在新北市各村(里),新北市,　板橋區,成和里,228,1422,2488,4138,43,4181,0,4181,1522,5703,73.3123
第15任總統副總統,在新北市各村(里),新北市,　板橋區,溪洲里,164,1247,2278,3689,60,3749,0,3749,1293,5042,74.3554
第15任總統副總統,在新北市各村(里),新北市,　板橋區,溪福里,405,3074,5148,8627,99,8726,0,8726,3005,11731,74.3841
第15任總統副總統,在新北市各村(里),新北市,　板橋區,溪北里,108,825,1374,2307,16,2323,0,2323,704,3027,76.7426
第15任總統副總統,在新北市各村(里),新北市,　板橋區,堂春里,129,917,1686,2732,24,2756,0,2756,901,3657,75.3623
第15任總統副總統,在新北市各村(里),新北市,　三重區,富貴里,192,1526,2511,4229,35,4264,0,4264,1311,5575,76.4843
第15任總統副總統,在新北市各村(里),新北市,　三重區,碧華里,248,1859,3074,5181,58,5239,0,5239,1584,6823,76.7844
第15任總統副總統,在新北市各村(里),新北市,　三重區,仁華里,140,888,1772,2800,41,2841,0,2841,835,3676,77.2851
第15任總統副總統,在新北市各村(里),新北市,　三重區,永清里,159,945,2418,3522,37,3559,0,3559,1021,4580,77.7074
第15任總統副總統,在新北市各村(里),新北市,　三重區,永順里,160,874,2190,3224,31,3255,0,3255,1112,4367,74.5363
第15任總統副總統,在新北市各村(里),新北市,　三重區,富福里,62,386,829,1277,14,1291,0,1291,484,1775,72.7324
第15任總統副總統,在新北市各村(里),新北市,　三重區,慈化里,74,501,1067,1642,26,1668,0,1668,487,2155,77.4014
第15任總統副總統,在新北市各村(里),新北市,　三重區,慈惠里,71,377,1063,1511,14,1525,0,1525,454,1979,77.0591
第15任總統副總統,在新北市各村(里),新北市,　三重區,慈愛里,89,665,1537,2291,31,2322,0,2322,739,3061,75.8576
第15任總統副總統,在新北市各村(里),新北市,　三重區,永福里,139,963,2337,3439,41,3480,0,3480,1046,4526,76.8891
第15任總統副總統,在新北市各村(里),新北市,　三重區,慈生里,81,504,1013,1598,15,1613,0,1613,425,2038,79.1462
第15任總統副總統,在新北市各村(里),新北市,　三重區,慈福里,79,424,972,1475,16,1491,0,1491,495,1986,75.0755
第15任總統副總統,在新北市各村(里),新北市,　三重區,慈祐里,135,936,2104,3175,38,3213,0,3213,997,4210,76.3183
第15任總統副總統,在新北市各村(里),新北市,　三重區,富華里,115,720,1308,2143,33,2176,0,2176,677,2853,76.2706
第15任總統副總統,在新北市各村(里),新北市,　三重區,五華里,125,1057,2182,3364,41,3405,0,3405,1073,4478,76.0384
第15任總統副總統,在新北市各村(里),新北市,　三重區,五福里,119,822,1567,2508,30,2538,0,2538,820,3358,75.5807
第15任總統副總統,在新北市各村(里),新北市,　三重區,大有里,156,1084,2347,3587,34,3621,0,3621,1063,4684,77.3057
第15任總統副總統,在新北市各村(里),新北市,　三重區,博愛里,111,1053,1917,3081,43,3124,0,3124,889,4013,77.8470
第15任總統副總統,在新北市各村(里),新北市,　三重區,二重里,46,299,695,1040,14,1054,0,1054,345,1399,75.3395
第15任總統副總統,在新北市各村(里),新北市,　三重區,頂崁里,62,439,1039,1540,10,1550,0,1550,463,2013,76.9995
第15任總統副總統,在新北市各村(里),新北市,　三重區,谷王里,26,212,430,668,6,674,0,674,163,837,80.5257
第15任總統副總統,在新北市各村(里),新北市,　三重區,五谷里,55,402,782,1239,12,1251,0,1251,401,1652,75.7264
第15任總統副總統,在新北市各村(里),新北市,　三重區,中興里,118,801,1739,2658,34,2692,0,2692,782,3474,77.4899
第15任總統副總統,在新北市各村(里),新北市,　三重區,德厚里,8,79,190,277,4,281,0,281,59,340,82.6471
第15任總統副總統,在新北市各村(里),新北市,　三重區,成功里,209,1512,2440,4161,46,4207,0,4207,1134,5341,78.7680
第15任總統副總統,在新北市各村(里),新北市,　三重區,福祉里,165,1199,2233,3597,28,3625,0,3625,1051,4676,77.5235
第15任總統副總統,在新北市各村(里),新北市,　三重區,福德里,114,934,1650,2698,30,2728,0,2728,810,3538,77.1057
第15任總統副總統,在新北市各村(里),新北市,　三重區,福民里,84,701,1468,2253,23,2276,1,2277,738,3015,75.4892
第15任總統副總統,在新北市各村(里),新北市,　三重區,過田里,176,1611,2624,4411,45,4456,0,4456,4051,8507,52.3804
第15任總統副總統,在新北市各村(里),新北市,　三重區,錦田里,51,432,905,1388,17,1405,0,1405,414,1819,77.2402
第15任總統副總統,在新北市各村(里),新北市,　三重區,重明里,112,811,1494,2417,39,2456,0,2456,675,3131,78.4414
第15任總統副總統,在新北市各村(里),新北市,　三重區,光田里,163,1032,1816,3011,36,3047,0,3047,828,3875,78.6323
第15任總統副總統,在新北市各村(里),新北市,　三重區,光陽里,186,1458,2689,4333,47,4380,0,4380,1178,5558,78.8053
第15任總統副總統,在新北市各村(里),新北市,　三重區,田心里,130,825,1776,2731,35,2766,0,2766,835,3601,76.8120
第15任總統副總統,在新北市各村(里),新北市,　三重區,福田里,112,753,1606,2471,22,2493,0,2493,568,3061,81.4440
第15任總統副總統,在新北市各村(里),新北市,　三重區,田中里,166,1187,2796,4149,47,4196,0,4196,1131,5327,78.7685
第15任總統副總統,在新北市各村(里),新北市,　三重區,田安里,215,1319,2618,4152,43,4195,0,4195,1227,5422,77.3700
第15任總統副總統,在新北市各村(里),新北市,　三重區,三民里,110,691,1369,2170,18,2188,0,2188,665,2853,76.6912
第15任總統副總統,在新北市各村(里),新北市,　三重區,光明里,273,1642,2910,4825,44,4869,0,4869,1537,6406,76.0069
第15任總統副總統,在新北市各村(里),新北市,　三重區,光正里,84,697,893,1674,18,1692,0,1692,542,2234,75.7386
第15任總統副總統,在新北市各村(里),新北市,　三重區,同安里,51,321,529,901,14,915,0,915,366,1281,71.4286
第15任總統副總統,在新北市各村(里),新北市,　三重區,同慶里,57,467,685,1209,10,1219,0,1219,360,1579,77.2008
第15任總統副總統,在新北市各村(里),新北市,　三重區,菜寮里,80,521,899,1500,13,1513,0,1513,429,1942,77.9094
第15任總統副總統,在新北市各村(里),新北市,　三重區,永春里,61,462,768,1291,12,1303,0,1303,380,1683,77.4213
第15任總統副總統,在新北市各村(里),新北市,　三重區,中正里,43,354,580,977,15,992,0,992,273,1265,78.4190
第15任總統副總統,在新北市各村(里),新北市,　三重區,吉利里,33,363,559,955,14,969,0,969,306,1275,76.0000
第15任總統副總統,在新北市各村(里),新北市,　三重區,大同里,71,469,777,1317,25,1342,0,1342,447,1789,75.0140
第15任總統副總統,在新北市各村(里),新北市,　三重區,中民里,34,337,491,862,16,878,0,878,264,1142,76.8827
第15任總統副總統,在新北市各村(里),新北市,　三重區,平和里,61,332,591,984,20,1004,0,1004,348,1352,74.2604
第15任總統副總統,在新北市各村(里),新北市,　三重區,大安里,49,434,609,1092,9,1101,0,1101,378,1479,74.4422
第15任總統副總統,在新北市各村(里),新北市,　三重區,仁德里,60,444,828,1332,13,1345,0,1345,469,1814,74.1455
第15任總統副總統,在新北市各村(里),新北市,　三重區,忠孝里,54,405,725,1184,19,1203,0,1203,434,1637,73.4881
第15任總統副總統,在新北市各村(里),新北市,　三重區,仁義里,34,287,484,805,17,822,0,822,262,1084,75.8303
第15任總統副總統,在新北市各村(里),新北市,　三重區,光榮里,53,303,606,962,17,979,0,979,333,1312,74.6189
第15任總統副總統,在新北市各村(里),新北市,　三重區,光輝里,49,329,652,1030,8,1038,0,1038,299,1337,77.6365
第15任總統副總統,在新北市各村(里),新北市,　三重區,福星里,40,261,492,793,15,808,0,808,245,1053,76.7331
第15任總統副總統,在新北市各村(里),新北市,　三重區,福利里,83,580,925,1588,9,1597,0,1597,445,2042,78.2076
第15任總統副總統,在新北市各村(里),新北市,　三重區,清和里,142,906,1654,2702,15,2717,0,2717,772,3489,77.8733
第15任總統副總統,在新北市各村(里),新北市,　三重區,永興里,47,327,502,876,9,885,0,885,298,1183,74.8098
第15任總統副總統,在新北市各村(里),新北市,　三重區,中山里,75,615,1159,1849,26,1875,0,1875,548,2423,77.3834
第15任總統副總統,在新北市各村(里),新北市,　三重區,大園里,97,563,1155,1815,23,1838,0,1838,615,2453,74.9287
第15任總統副總統,在新北市各村(里),新北市,　三重區,國隆里,114,640,1075,1829,20,1849,0,1849,525,2374,77.8854
第15任總統副總統,在新北市各村(里),新北市,　三重區,重陽里,97,775,1431,2303,33,2336,0,2336,782,3118,74.9198
第15任總統副總統,在新北市各村(里),新北市,　三重區,民生里,133,816,1830,2779,32,2811,0,2811,873,3684,76.3029
第15任總統副總統,在新北市各村(里),新北市,　三重區,重新里,40,276,643,959,10,969,0,969,300,1269,76.3593
第15任總統副總統,在新北市各村(里),新北市,　三重區,正德里,29,271,476,776,8,784,0,784,240,1024,76.5625
第15任總統副總統,在新北市各村(里),新北市,　三重區,正義里,54,426,747,1227,15,1242,0,1242,343,1585,78.3596
第15任總統副總統,在新北市各村(里),新北市,　三重區,正安里,75,452,811,1338,10,1348,0,1348,400,1748,77.1167
第15任總統副總統,在新北市各村(里),新北市,　三重區,自強里,42,355,805,1202,23,1225,0,1225,377,1602,76.4669
第15任總統副總統,在新北市各村(里),新北市,　三重區,文化里,83,494,991,1568,9,1577,0,1577,467,2044,77.1526
第15任總統副總統,在新北市各村(里),新北市,　三重區,中央里,55,384,742,1181,16,1197,0,1197,403,1600,74.8125
第15任總統副總統,在新北市各村(里),新北市,　三重區,雙園里,26,245,382,653,11,664,0,664,191,855,77.6608
第15任總統副總統,在新北市各村(里),新北市,　三重區,錦通里,55,354,627,1036,11,1047,0,1047,311,1358,77.0987
第15任總統副總統,在新北市各村(里),新北市,　三重區,錦安里,55,436,762,1253,18,1271,0,1271,401,1672,76.0167
第15任總統副總統,在新北市各村(里),新北市,　三重區,長安里,54,484,910,1448,20,1468,0,1468,496,1964,74.7454
第15任總統副總統,在新北市各村(里),新北市,　三重區,光華里,51,451,878,1380,12,1392,0,1392,499,1891,73.6118
第15任總統副總統,在新北市各村(里),新北市,　三重區,長生里,29,156,397,582,10,592,0,592,212,804,73.6318
第15任總統副總統,在新北市各村(里),新北市,　三重區,開元里,57,347,635,1039,15,1054,0,1054,308,1362,77.3862
第15任總統副總統,在新北市各村(里),新北市,　三重區,大德里,32,202,379,613,5,618,0,618,146,764,80.8901
第15任總統副總統,在新北市各村(里),新北市,　三重區,長元里,78,540,1016,1634,24,1658,0,1658,551,2209,75.0566
第15任總統副總統,在新北市各村(里),新北市,　三重區,長江里,55,444,885,1384,22,1406,0,1406,440,1846,76.1647
第15任總統副總統,在新北市各村(里),新北市,　三重區,長泰里,64,478,951,1493,20,1513,0,1513,485,1998,75.7257
第15任總統副總統,在新北市各村(里),新北市,　三重區,長福里,57,333,664,1054,9,1063,0,1063,326,1389,76.5299
第15任總統副總統,在新北市各村(里),新北市,　三重區,介壽里,38,290,462,790,12,802,0,802,248,1050,76.3810
第15任總統副總統,在新北市各村(里),新北市,　三重區,萬壽里,60,494,823,1377,20,1397,0,1397,374,1771,78.8820
第15任總統副總統,在新北市各村(里),新北市,　三重區,錦江里,75,493,952,1520,18,1538,0,1538,556,2094,73.4479
第15任總統副總統,在新北市各村(里),新北市,　三重區,龍濱里,105,728,1377,2210,19,2229,0,2229,663,2892,77.0747
第15任總統副總統,在新北市各村(里),新北市,　三重區,龍門里,58,400,753,1211,16,1227,0,1227,432,1659,73.9602
第15任總統副總統,在新北市各村(里),新北市,　三重區,秀江里,46,287,529,862,17,879,0,879,289,1168,75.2568
第15任總統副總統,在新北市各村(里),新北市,　三重區,奕壽里,48,364,749,1161,17,1178,0,1178,371,1549,76.0491
第15任總統副總統,在新北市各村(里),新北市,　三重區,三安里,83,587,1103,1773,19,1792,0,1792,590,2382,75.2309
第15任總統副總統,在新北市各村(里),新北市,　三重區,福安里,96,605,1320,2021,14,2035,0,2035,606,2641,77.0541
第15任總統副總統,在新北市各村(里),新北市,　三重區,信安里,54,448,806,1308,18,1326,0,1326,460,1786,74.2441
第15任總統副總統,在新北市各村(里),新北市,　三重區,安慶里,52,412,954,1418,11,1429,1,1430,419,1849,77.2850
第15任總統副總統,在新北市各村(里),新北市,　三重區,幸福里,129,965,1967,3061,30,3091,0,3091,993,4084,75.6856
第15任總統副總統,在新北市各村(里),新北市,　三重區,六合里,119,817,1590,2526,22,2548,0,2548,753,3301,77.1887
第15任總統副總統,在新北市各村(里),新北市,　三重區,六福里,155,1038,2529,3722,50,3772,0,3772,1026,4798,78.6161
第15任總統副總統,在新北市各村(里),新北市,　三重區,順德里,64,490,911,1465,25,1490,0,1490,493,1983,75.1387
第15任總統副總統,在新北市各村(里),新北市,　三重區,承德里,41,408,750,1199,21,1220,0,1220,377,1597,76.3932
第15任總統副總統,在新北市各村(里),新北市,　三重區,瑞德里,65,501,1107,1673,13,1686,0,1686,431,2117,79.6410
第15任總統副總統,在新北市各村(里),新北市,　三重區,崇德里,90,813,1717,2620,38,2658,0,2658,838,3496,76.0297
第15任總統副總統,在新北市各村(里),新北市,　三重區,厚德里,124,758,1505,2387,26,2413,0,2413,661,3074,78.4971
第15任總統副總統,在新北市各村(里),新北市,　三重區,維德里,82,569,1292,1943,15,1958,0,1958,519,2477,79.0472
第15任總統副總統,在新北市各村(里),新北市,　三重區,尚德里,98,663,1284,2045,25,2070,0,2070,621,2691,76.9231
第15任總統副總統,在新北市各村(里),新北市,　三重區,培德里,103,765,1625,2493,21,2514,0,2514,703,3217,78.1473
第15任總統副總統,在新北市各村(里),新北市,　三重區,立德里,101,741,1518,2360,25,2385,0,2385,603,2988,79.8193
第15任總統副總統,在新北市各村(里),新北市,　三重區,永德里,141,964,2132,3237,42,3279,0,3279,999,4278,76.6480
第15任總統副總統,在新北市各村(里),新北市,　三重區,永煇里,83,439,1189,1711,19,1730,0,1730,524,2254,76.7524
第15任總統副總統,在新北市各村(里),新北市,　三重區,永發里,160,1105,2637,3902,46,3948,0,3948,1043,4991,79.1024
第15任總統副總統,在新北市各村(里),新北市,　三重區,永盛里,98,639,1382,2119,22,2141,0,2141,675,2816,76.0298
第15任總統副總統,在新北市各村(里),新北市,　三重區,永吉里,69,626,1198,1893,25,1918,0,1918,596,2514,76.2928
第15任總統副總統,在新北市各村(里),新北市,　三重區,永安里,121,807,1703,2631,27,2658,0,2658,770,3428,77.5379
第15任總統副總統,在新北市各村(里),新北市,　三重區,永豐里,171,1059,2503,3733,32,3765,0,3765,1175,4940,76.2146
第15任總統副總統,在新北市各村(里),新北市,　三重區,溪美里,248,1766,3614,5628,64,5692,0,5692,1599,7291,78.0689
第15任總統副總統,在新北市各村(里),新北市,　三重區,福隆里,152,905,1816,2873,29,2902,0,2902,977,3879,74.8131
第15任總統副總統,在新北市各村(里),新北市,　三重區,五常里,128,812,1774,2714,31,2745,0,2745,862,3607,76.1020
第15任總統副總統,在新北市各村(里),新北市,　三重區,仁忠里,94,685,1237,2016,25,2041,0,2041,743,2784,73.3118
第15任總統副總統,在新北市各村(里),新北市,　三重區,福樂里,113,728,1551,2392,25,2417,0,2417,789,3206,75.3899
第15任總統副總統,在新北市各村(里),新北市,　三重區,五順里,94,825,1668,2587,15,2602,0,2602,866,3468,75.0288
第15任總統副總統,在新北市各村(里),新北市,　中和區,中原里,183,1638,2289,4110,50,4160,0,4160,1356,5516,75.4170
第15任總統副總統,在新北市各村(里),新北市,　中和區,連和里,66,922,655,1643,22,1665,0,1665,488,2153,77.3340
第15任總統副總統,在新北市各村(里),新北市,　中和區,連城里,183,2141,2041,4365,46,4411,0,4411,1201,5612,78.5994
第15任總統副總統,在新北市各村(里),新北市,　中和區,力行里,207,1711,2081,3999,46,4045,0,4045,1104,5149,78.5589
第15任總統副總統,在新北市各村(里),新北市,　中和區,正行里,119,861,985,1965,15,1980,0,1980,561,2541,77.9221
第15任總統副總統,在新北市各村(里),新北市,　中和區,德行里,237,1906,2220,4363,54,4417,0,4417,1221,5638,78.3434
第15任總統副總統,在新北市各村(里),新北市,　中和區,枋寮里,124,1050,1310,2484,26,2510,0,2510,776,3286,76.3847
第15任總統副總統,在新北市各村(里),新北市,　中和區,漳和里,130,1037,1338,2505,25,2530,0,2530,712,3242,78.0382
第15任總統副總統,在新北市各村(里),新北市,　中和區,廟美里,117,1229,1608,2954,37,2991,0,2991,890,3881,77.0678
第15任總統副總統,在新北市各村(里),新北市,　中和區,福真里,129,1123,1495,2747,35,2782,0,2782,847,3629,76.6602
第15任總統副總統,在新北市各村(里),新北市,　中和區,福善里,117,1256,1555,2928,34,2962,0,2962,911,3873,76.4782
第15任總統副總統,在新北市各村(里),新北市,　中和區,福美里,127,1313,1621,3061,40,3101,0,3101,807,3908,79.3501
第15任總統副總統,在新北市各村(里),新北市,　中和區,福祥里,155,1402,1880,3437,54,3491,0,3491,951,4442,78.5907
第15任總統副總統,在新北市各村(里),新北市,　中和區,瓦磘里,147,1539,1930,3616,46,3662,0,3662,1222,4884,74.9795
第15任總統副總統,在新北市各村(里),新北市,　中和區,福和里,113,1034,1322,2469,26,2495,0,2495,742,3237,77.0775
第15任總統副總統,在新北市各村(里),新北市,　中和區,佳和里,149,1427,1703,3279,53,3332,0,3332,1002,4334,76.8805
第15任總統副總統,在新北市各村(里),新北市,　中和區,新南里,251,2582,2489,5322,69,5391,0,5391,1560,6951,77.5572
第15任總統副總統,在新北市各村(里),新北市,　中和區,南山里,147,1607,1665,3419,65,3484,0,3484,959,4443,78.4155
第15任總統副總統,在新北市各村(里),新北市,　中和區,平河里,307,2462,3129,5898,76,5974,0,5974,1761,7735,77.2334
第15任總統副總統,在新北市各村(里),新北市,　中和區,信和里,116,1097,1602,2815,32,2847,0,2847,888,3735,76.2249
第15任總統副總統,在新北市各村(里),新北市,　中和區,仁和里,123,1157,1476,2756,33,2789,0,2789,824,3613,77.1935
第15任總統副總統,在新北市各村(里),新北市,　中和區,中正里,127,1051,1408,2586,36,2622,0,2622,852,3474,75.4750
第15任總統副總統,在新北市各村(里),新北市,　中和區,建和里,91,1254,1058,2403,23,2426,0,2426,652,3078,78.8174
第15任總統副總統,在新北市各村(里),新北市,　中和區,中山里,68,748,988,1804,28,1832,0,1832,517,2349,77.9906
第15任總統副總統,在新北市各村(里),新北市,　中和區,碧河里,121,1269,1586,2976,38,3014,0,3014,814,3828,78.7356
第15任總統副總統,在新北市各村(里),新北市,　中和區,正南里,87,1235,904,2226,43,2269,0,2269,829,3098,73.2408
第15任總統副總統,在新北市各村(里),新北市,　中和區,頂南里,93,1112,837,2042,27,2069,0,2069,586,2655,77.9284
第15任總統副總統,在新北市各村(里),新北市,　中和區,華新里,221,2480,1929,4630,53,4683,0,4683,1553,6236,75.0962
第15任總統副總統,在新北市各村(里),新北市,　中和區,東南里,118,1874,920,2912,37,2949,0,2949,894,3843,76.7369
第15任總統副總統,在新北市各村(里),新北市,　中和區,華南里,147,1761,1380,3288,45,3333,0,3333,1069,4402,75.7156
第15任總統副總統,在新北市各村(里),新北市,　中和區,忠孝里,128,1700,1285,3113,40,3153,0,3153,1051,4204,75.0000
第15任總統副總統,在新北市各村(里),新北市,　中和區,崇南里,135,1594,1220,2949,43,2992,0,2992,810,3802,78.6954
第15任總統副總統,在新北市各村(里),新北市,　中和區,興南里,77,1056,924,2057,22,2079,1,2080,698,2778,74.8380
第15任總統副總統,在新北市各村(里),新北市,　中和區,景南里,79,1041,976,2096,21,2117,0,2117,678,2795,75.7424
第15任總統副總統,在新北市各村(里),新北市,　中和區,景本里,63,675,746,1484,21,1505,1,1506,412,1918,78.4672
第15任總統副總統,在新北市各村(里),新北市,　中和區,橫路里,14,84,145,243,4,247,0,247,67,314,78.6624
第15任總統副總統,在新北市各村(里),新北市,　中和區,內南里,140,1595,1532,3267,42,3309,0,3309,1096,4405,75.1192
第15任總統副總統,在新北市各村(里),新北市,　中和區,壽南里,61,734,776,1571,16,1587,0,1587,485,2072,76.5927
第15任總統副總統,在新北市各村(里),新北市,　中和區,福南里,114,1472,1180,2766,32,2798,0,2798,910,3708,75.4585
第15任總統副總統,在新北市各村(里),新北市,　中和區,外南里,147,1422,1469,3038,33,3071,0,3071,3712,6783,45.2750
第15任總統副總統,在新北市各村(里),新北市,　中和區,中興里,217,2063,2178,4458,50,4508,0,4508,1298,5806,77.6438
第15任總統副總統,在新北市各村(里),新北市,　中和區,吉興里,92,950,900,1942,25,1967,0,1967,619,2586,76.0634
第15任總統副總統,在新北市各村(里),新北市,　中和區,復興里,149,1633,1599,3381,47,3428,0,3428,978,4406,77.8030
第15任總統副總統,在新北市各村(里),新北市,　中和區,和興里,116,1416,1396,2928,42,2970,0,2970,866,3836,77.4244
第15任總統副總統,在新北市各村(里),新北市,　中和區,景平里,179,1837,1619,3635,55,3690,0,3690,1144,4834,76.3343
第15任總統副總統,在新北市各村(里),新北市,　中和區,景新里,134,1164,1129,2427,31,2458,0,2458,704,3162,77.7356
第15任總統副總統,在新北市各村(里),新北市,　中和區,景福里,169,1903,1730,3802,51,3853,0,3853,1207,5060,76.1462
第15任總統副總統,在新北市各村(里),新北市,　中和區,景安里,154,1624,1504,3282,54,3336,0,3336,871,4207,79.2964
第15任總統副總統,在新北市各村(里),新北市,　中和區,景文里,150,1162,1192,2504,27,2531,0,2531,711,3242,78.0691
第15任總統副總統,在新北市各村(里),新北市,　中和區,錦和里,150,1512,1930,3592,33,3625,0,3625,1030,4655,77.8733
第15任總統副總統,在新北市各村(里),新北市,　中和區,錦昌里,55,711,681,1447,17,1464,0,1464,449,1913,76.5290
第15任總統副總統,在新北市各村(里),新北市,　中和區,灰磘里,29,152,292,473,7,480,0,480,199,679,70.6922
第15任總統副總統,在新北市各村(里),新北市,　中和區,積穗里,290,2256,2961,5507,53,5560,0,5560,1508,7068,78.6644
第15任總統副總統,在新北市各村(里),新北市,　中和區,民享里,56,595,1125,1776,27,1803,0,1803,386,2189,82.3664
第15任總統副總統,在新北市各村(里),新北市,　中和區,員山里,215,1675,2433,4323,41,4364,0,4364,1176,5540,78.7726
第15任總統副總統,在新北市各村(里),新北市,　中和區,嘉穗里,92,769,1081,1942,14,1956,0,1956,515,2471,79.1582
第15任總統副總統,在新北市各村(里),新北市,　中和區,文元里,164,1292,2038,3494,42,3536,0,3536,1046,4582,77.1715
第15任總統副總統,在新北市各村(里),新北市,　中和區,嘉新里,112,992,1496,2600,30,2630,0,2630,830,3460,76.0116
第15任總統副總統,在新北市各村(里),新北市,　中和區,民安里,158,1226,1914,3298,54,3352,0,3352,953,4305,77.8630
第15任總統副總統,在新北市各村(里),新北市,　中和區,安穗里,151,1066,1746,2963,36,2999,0,2999,935,3934,76.2328
第15任總統副總統,在新北市各村(里),新北市,　中和區,瑞穗里,65,689,836,1590,22,1612,0,1612,451,2063,78.1386
第15任總統副總統,在新北市各村(里),新北市,　中和區,明穗里,145,1132,1835,3112,25,3137,0,3137,811,3948,79.4580
第15任總統副總統,在新北市各村(里),新北市,　中和區,清穗里,88,810,1204,2102,21,2123,0,2123,616,2739,77.5100
第15任總統副總統,在新北市各村(里),新北市,　中和區,自強里,156,1164,1963,3283,35,3318,0,3318,1012,4330,76.6282
第15任總統副總統,在新北市各村(里),新北市,　中和區,德穗里,133,1331,1589,3053,44,3097,0,3097,913,4010,77.2319
第15任總統副總統,在新北市各村(里),新北市,　中和區,民生里,129,1147,1564,2840,38,2878,0,2878,826,3704,77.6998
第15任總統副總統,在新北市各村(里),新北市,　中和區,國光里,123,1024,1463,2610,36,2646,0,2646,772,3418,77.4137
第15任總統副總統,在新北市各村(里),新北市,　中和區,壽德里,143,1691,1192,3026,36,3062,1,3063,784,3847,79.5945
第15任總統副總統,在新北市各村(里),新北市,　中和區,明德里,127,972,1487,2586,36,2622,0,2622,796,3418,76.7115
第15任總統副總統,在新北市各村(里),新北市,　中和區,錦中里,118,1115,1504,2737,22,2759,0,2759,893,3652,75.5476
第15任總統副總統,在新北市各村(里),新北市,　中和區,錦盛里,90,975,1455,2520,43,2563,0,2563,796,3359,76.3025
第15任總統副總統,在新北市各村(里),新北市,　中和區,民有里,75,755,1074,1904,24,1928,0,1928,537,2465,78.2150
第15任總統副總統,在新北市各村(里),新北市,　中和區,員富里,95,811,1330,2236,28,2264,0,2264,765,3029,74.7441
第15任總統副總統,在新北市各村(里),新北市,　中和區,嘉慶里,143,1072,1589,2804,35,2839,0,2839,948,3787,74.9670
第15任總統副總統,在新北市各村(里),新北市,　中和區,冠穗里,111,883,1361,2355,31,2386,0,2386,605,2991,79.7727
第15任總統副總統,在新北市各村(里),新北市,　中和區,國華里,104,810,1250,2164,21,2185,3,2188,701,2889,75.6317
第15任總統副總統,在新北市各村(里),新北市,　中和區,宜安里,63,673,548,1284,23,1307,0,1307,362,1669,78.3104
第15任總統副總統,在新北市各村(里),新北市,　中和區,安樂里,127,1286,1115,2528,30,2558,1,2559,678,3237,79.0238
第15任總統副總統,在新北市各村(里),新北市,　中和區,安和里,117,1020,1001,2138,19,2157,6,2163,608,2771,77.8419
第15任總統副總統,在新北市各村(里),新北市,　中和區,安順里,125,1545,1343,3013,43,3056,0,3056,834,3890,78.5604
第15任總統副總統,在新北市各村(里),新北市,　中和區,安平里,199,2175,1758,4132,41,4173,0,4173,1105,5278,79.0640
第15任總統副總統,在新北市各村(里),新北市,　中和區,中安里,144,1648,1253,3045,28,3073,0,3073,791,3864,79.5290
第15任總統副總統,在新北市各村(里),新北市,　中和區,泰安里,111,1123,1165,2399,27,2426,0,2426,708,3134,77.4091
第15任總統副總統,在新北市各村(里),新北市,　中和區,秀山里,134,1460,1450,3044,27,3071,0,3071,879,3950,77.7468
第15任總統副總統,在新北市各村(里),新北市,　中和區,秀成里,107,1143,1116,2366,32,2398,0,2398,729,3127,76.6869
第15任總統副總統,在新北市各村(里),新北市,　中和區,秀義里,101,783,927,1811,20,1831,0,1831,549,2380,76.9328
第15任總統副總統,在新北市各村(里),新北市,　中和區,秀福里,129,1535,1583,3247,30,3277,1,3278,961,4239,77.3060
第15任總統副總統,在新北市各村(里),新北市,　中和區,秀景里,194,2194,1819,4207,52,4259,0,4259,1304,5563,76.5594
第15任總統副總統,在新北市各村(里),新北市,　中和區,秀明里,169,1889,1241,3299,42,3341,0,3341,1093,4434,75.3496
第15任總統副總統,在新北市各村(里),新北市,　中和區,秀峰里,137,1643,1440,3220,38,3258,0,3258,893,4151,78.4871
第15任總統副總統,在新北市各村(里),新北市,　中和區,秀士里,57,907,685,1649,19,1668,0,1668,532,2200,75.8182
第15任總統副總統,在新北市各村(里),新北市,　中和區,秀水里,107,1350,1006,2463,28,2491,0,2491,802,3293,75.6453
第15任總統副總統,在新北市各村(里),新北市,　中和區,秀仁里,90,1098,1037,2225,23,2248,0,2248,669,2917,77.0655
第15任總統副總統,在新北市各村(里),新北市,　永和區,光復里,51,591,492,1134,19,1153,0,1153,345,1498,76.9693
第15任總統副總統,在新北市各村(里),新北市,　永和區,網溪里,40,386,333,759,11,770,0,770,241,1011,76.1622
第15任總統副總統,在新北市各村(里),新北市,　永和區,復興里,77,829,688,1594,24,1618,0,1618,467,2085,77.6019
第15任總統副總統,在新北市各村(里),新北市,　永和區,竹林里,103,1265,1094,2462,37,2499,0,2499,759,3258,76.7035
第15任總統副總統,在新北市各村(里),新北市,　永和區,桂林里,126,1302,1019,2447,33,2480,0,2480,778,3258,76.1203
第15任總統副總統,在新北市各村(里),新北市,　永和區,上林里,103,1232,917,2252,23,2275,0,2275,727,3002,75.7828
第15任總統副總統,在新北市各村(里),新北市,　永和區,福林里,125,1090,997,2212,22,2234,0,2234,686,2920,76.5068
第15任總統副總統,在新北市各村(里),新北市,　永和區,勵行里,36,325,467,828,11,839,0,839,262,1101,76.2035
第15任總統副總統,在新北市各村(里),新北市,　永和區,中興里,84,1025,926,2035,23,2058,0,2058,644,2702,76.1658
第15任總統副總統,在新北市各村(里),新北市,　永和區,永興里,74,1050,917,2041,26,2067,0,2067,708,2775,74.4865
第15任總統副總統,在新北市各村(里),新北市,　永和區,正興里,57,762,634,1453,20,1473,0,1473,516,1989,74.0573
第15任總統副總統,在新北市各村(里),新北市,　永和區,豫溪里,112,1395,1121,2628,35,2663,0,2663,1975,4638,57.4170
第15任總統副總統,在新北市各村(里),新北市,　永和區,光明里,89,1024,926,2039,25,2064,0,2064,582,2646,78.0045
第15任總統副總統,在新北市各村(里),新北市,　永和區,福和里,174,1756,1511,3441,31,3472,1,3473,990,4463,77.7952
第15任總統副總統,在新北市各村(里),新北市,　永和區,得和里,133,1519,1221,2873,29,2902,0,2902,807,3709,78.2421
第15任總統副總統,在新北市各村(里),新北市,　永和區,永貞里,95,1127,1064,2286,26,2312,0,2312,669,2981,77.5579
第15任總統副總統,在新北市各村(里),新北市,　永和區,永福里,91,956,865,1912,15,1927,0,1927,475,2402,80.2248
第15任總統副總統,在新北市各村(里),新北市,　永和區,河濱里,90,1037,953,2080,27,2107,0,2107,646,2753,76.5347
第15任總統副總統,在新北市各村(里),新北市,　永和區,秀和里,136,1562,1600,3298,45,3343,0,3343,915,4258,78.5110
第15任總統副總統,在新北市各村(里),新北市,　永和區,永元里,129,1476,1489,3094,38,3132,0,3132,905,4037,77.5824
第15任總統副總統,在新北市各村(里),新北市,　永和區,民權里,111,1473,1269,2853,36,2889,0,2889,862,3751,77.0195
第15任總統副總統,在新北市各村(里),新北市,　永和區,民族里,141,1550,1317,3008,27,3035,0,3035,937,3972,76.4099
第15任總統副總統,在新北市各村(里),新北市,　永和區,秀朗里,110,1163,1268,2541,28,2569,0,2569,804,3373,76.1637
第15任總統副總統,在新北市各村(里),新北市,　永和區,秀成里,83,922,932,1937,24,1961,0,1961,593,2554,76.7815
第15任總統副總統,在新北市各村(里),新北市,　永和區,秀林里,93,1123,1343,2559,37,2596,1,2597,684,3281,79.1222
第15任總統副總統,在新北市各村(里),新北市,　永和區,秀得里,76,884,778,1738,22,1760,0,1760,495,2255,78.0488
第15任總統副總統,在新北市各村(里),新北市,　永和區,秀元里,99,963,938,2000,33,2033,0,2033,553,2586,78.6156
第15任總統副總統,在新北市各村(里),新北市,　永和區,民生里,114,1242,1218,2574,29,2603,0,2603,768,3371,77.2174
第15任總統副總統,在新北市各村(里),新北市,　永和區,民本里,112,1171,1235,2518,27,2545,0,2545,844,3389,75.0959
第15任總統副總統,在新北市各村(里),新北市,　永和區,民富里,94,860,934,1888,17,1905,0,1905,593,2498,76.2610
第15任總統副總統,在新北市各村(里),新北市,　永和區,民樂里,145,1649,1357,3151,41,3192,0,3192,885,4077,78.2929
第15任總統副總統,在新北市各村(里),新北市,　永和區,民治里,81,970,789,1840,23,1863,0,1863,620,2483,75.0302
第15任總統副總統,在新北市各村(里),新北市,　永和區,智光里,112,1077,959,2148,17,2165,0,2165,714,2879,75.1997
第15任總統副總統,在新北市各村(里),新北市,　永和區,潭安里,151,1655,1349,3155,42,3197,0,3197,885,4082,78.3195
第15任總統副總統,在新北市各村(里),新北市,　永和區,潭墘里,131,1599,1270,3000,32,3032,0,3032,860,3892,77.9034
第15任總統副總統,在新北市各村(里),新北市,　永和區,店街里,107,1398,1223,2728,26,2754,0,2754,853,3607,76.3515
第15任總統副總統,在新北市各村(里),新北市,　永和區,大新里,95,901,807,1803,15,1818,0,1818,470,2288,79.4580
第15任總統副總統,在新北市各村(里),新北市,　永和區,永安里,130,1434,1190,2754,26,2780,0,2780,798,3578,77.6970
第15任總統副總統,在新北市各村(里),新北市,　永和區,永樂里,52,707,805,1564,14,1578,0,1578,470,2048,77.0508
第15任總統副總統,在新北市各村(里),新北市,　永和區,水源里,128,1334,1211,2673,33,2706,0,2706,782,3488,77.5803
第15任總統副總統,在新北市各村(里),新北市,　永和區,協和里,83,951,963,1997,22,2019,0,2019,597,2616,77.1789
第15任總統副總統,在新北市各村(里),新北市,　永和區,雙和里,110,1313,1228,2651,30,2681,0,2681,703,3384,79.2258
第15任總統副總統,在新北市各村(里),新北市,　永和區,安和里,122,1359,1129,2610,29,2639,0,2639,753,3392,77.8007
第15任總統副總統,在新北市各村(里),新北市,　永和區,前溪里,51,736,594,1381,24,1405,0,1405,468,1873,75.0133
第15任總統副總統,在新北市各村(里),新北市,　永和區,和平里,145,1539,1529,3213,33,3246,0,3246,964,4210,77.1021
第15任總統副總統,在新北市各村(里),新北市,　永和區,保平里,145,1377,1607,3129,35,3164,0,3164,912,4076,77.6251
第15任總統副總統,在新北市各村(里),新北市,　永和區,中溪里,156,1487,1673,3316,38,3354,0,3354,976,4330,77.4596
第15任總統副總統,在新北市各村(里),新北市,　永和區,保安里,199,2170,2298,4667,65,4732,0,4732,1378,6110,77.4468
第15任總統副總統,在新北市各村(里),新北市,　永和區,保順里,332,3154,2959,6445,77,6522,1,6523,1991,8514,76.6032
第15任總統副總統,在新北市各村(里),新北市,　永和區,下溪里,136,1240,1300,2676,40,2716,0,2716,792,3508,77.4230
第15任總統副總統,在新北市各村(里),新北市,　永和區,大同里,26,317,160,503,5,508,0,508,160,668,76.0479
第15任總統副總統,在新北市各村(里),新北市,　永和區,新生里,32,283,151,466,9,475,0,475,179,654,72.6300
第15任總統副總統,在新北市各村(里),新北市,　永和區,永成里,20,466,157,643,8,651,0,651,222,873,74.5704
第15任總統副總統,在新北市各村(里),新北市,　永和區,忠義里,34,378,141,553,6,559,0,559,164,723,77.3167
第15任總統副總統,在新北市各村(里),新北市,　永和區,仁愛里,85,860,878,1823,29,1852,0,1852,520,2372,78.0776
第15任總統副總統,在新北市各村(里),新北市,　永和區,文化里,92,974,829,1895,25,1920,0,1920,553,2473,77.6385
第15任總統副總統,在新北市各村(里),新北市,　永和區,信義里,83,877,814,1774,22,1796,0,1796,559,2355,76.2633
第15任總統副總統,在新北市各村(里),新北市,　永和區,後溪里,59,566,699,1324,13,1337,0,1337,375,1712,78.0958
第15任總統副總統,在新北市各村(里),新北市,　永和區,上溪里,44,615,609,1268,26,1294,0,1294,465,1759,73.5645
第15任總統副總統,在新北市各村(里),新北市,　永和區,頂溪里,82,828,796,1706,27,1733,0,1733,490,2223,77.9577
第15任總統副總統,在新北市各村(里),新北市,　永和區,河堤里,90,1119,1003,2212,21,2233,0,2233,727,2960,75.4392
第15任總統副總統,在新北市各村(里),新北市,　永和區,新廍里,70,797,652,1519,27,1546,0,1546,461,2007,77.0304
第15任總統副總統,在新北市各村(里),新北市,　新莊區,海山里,152,1179,2187,3518,23,3541,0,3541,1103,4644,76.2489
第15任總統副總統,在新北市各村(里),新北市,　新莊區,全安里,157,972,1865,2994,35,3029,0,3029,839,3868,78.3092
第15任總統副總統,在新北市各村(里),新北市,　新莊區,全泰里,146,1261,1878,3285,37,3322,0,3322,950,4272,77.7622
第15任總統副總統,在新北市各村(里),新北市,　新莊區,忠孝里,140,1106,1908,3154,42,3196,0,3196,930,4126,77.4600
第15任總統副總統,在新北市各村(里),新北市,　新莊區,文衡里,61,483,889,1433,7,1440,0,1440,393,1833,78.5597
第15任總統副總統,在新北市各村(里),新北市,　新莊區,文聖里,120,914,1321,2355,18,2373,0,2373,601,2974,79.7915
第15任總統副總統,在新北市各村(里),新北市,　新莊區,興漢里,100,912,1248,2260,27,2287,0,2287,641,2928,78.1079
第15任總統副總統,在新北市各村(里),新北市,　新莊區,榮和里,95,774,1210,2079,26,2105,0,2105,2680,4785,43.9916
第15任總統副總統,在新北市各村(里),新北市,　新莊區,文德里,51,422,712,1185,17,1202,0,1202,326,1528,78.6649
第15任總統副總統,在新北市各村(里),新北市,　新莊區,文明里,60,374,739,1173,10,1183,0,1183,362,1545,76.5696
第15任總統副總統,在新北市各村(里),新北市,　新莊區,化成里,117,748,1564,2429,32,2461,0,2461,748,3209,76.6906
第15任總統副總統,在新北市各村(里),新北市,　新莊區,頭前里,273,1730,3448,5451,51,5502,0,5502,1782,7284,75.5354
第15任總統副總統,在新北市各村(里),新北市,　新莊區,福基里,159,1033,1842,3034,34,3068,0,3068,942,4010,76.5087
第15任總統副總統,在新北市各村(里),新北市,　新莊區,福興里,161,1215,2404,3780,34,3814,0,3814,1133,4947,77.0972
第15任總統副總統,在新北市各村(里),新北市,　新莊區,昌平里,260,1684,2679,4623,60,4683,0,4683,1432,6115,76.5822
第15任總統副總統,在新北市各村(里),新北市,　新莊區,和平里,136,920,2065,3121,34,3155,0,3155,1018,4173,75.6051
第15任總統副總統,在新北市各村(里),新北市,　新莊區,幸福里,124,783,1849,2756,21,2777,0,2777,949,3726,74.5303
第15任總統副總統,在新北市各村(里),新北市,　新莊區,昌隆里,133,953,1758,2844,40,2884,0,2884,827,3711,77.7149
第15任總統副總統,在新北市各村(里),新北市,　新莊區,信義里,137,1189,2123,3449,32,3481,0,3481,1134,4615,75.4280
第15任總統副總統,在新北市各村(里),新北市,　新莊區,昌信里,105,777,1555,2437,19,2456,0,2456,676,3132,78.4163
第15任總統副總統,在新北市各村(里),新北市,　新莊區,昌明里,111,789,1562,2462,34,2496,0,2496,669,3165,78.8626
第15任總統副總統,在新北市各村(里),新北市,　新莊區,仁義里,93,669,1561,2323,28,2351,0,2351,846,3197,73.5377
第15任總統副總統,在新北市各村(里),新北市,　新莊區,仁愛里,74,527,1128,1729,13,1742,0,1742,611,2353,74.0331
第15任總統副總統,在新北市各村(里),新北市,　新莊區,自信里,75,503,1045,1623,19,1642,0,1642,525,2167,75.7730
第15任總統副總統,在新北市各村(里),新北市,　新莊區,自立里,142,1028,2241,3411,39,3450,0,3450,1179,4629,74.5301
第15任總統副總統,在新北市各村(里),新北市,　新莊區,自強里,71,534,1073,1678,20,1698,0,1698,647,2345,72.4094
第15任總統副總統,在新北市各村(里),新北市,　新莊區,思源里,136,1075,2238,3449,28,3477,0,3477,1106,4583,75.8673
第15任總統副總統,在新北市各村(里),新北市,　新莊區,思賢里,118,923,1788,2829,25,2854,0,2854,780,3634,78.5360
第15任總統副總統,在新北市各村(里),新北市,　新莊區,中華里,83,658,1158,1899,18,1917,1,1918,566,2484,77.1739
第15任總統副總統,在新北市各村(里),新北市,　新莊區,中美里,171,1243,2360,3774,44,3818,1,3819,1118,4937,77.3344
第15任總統副總統,在新北市各村(里),新北市,　新莊區,恆安里,150,1007,1770,2927,22,2949,0,2949,906,3855,76.4981
第15任總統副總統,在新北市各村(里),新北市,　新莊區,立人里,71,648,636,1355,16,1371,0,1371,396,1767,77.5891
第15任總統副總統,在新北市各村(里),新北市,　新莊區,立德里,69,630,1061,1760,12,1772,0,1772,520,2292,77.3124
第15任總統副總統,在新北市各村(里),新北市,　新莊區,中和里,120,959,1922,3001,24,3025,0,3025,938,3963,76.3311
第15任總統副總統,在新北市各村(里),新北市,　新莊區,中泰里,116,880,1919,2915,34,2949,0,2949,930,3879,76.0247
第15任總統副總統,在新北市各村(里),新北市,　新莊區,中宏里,113,739,1509,2361,23,2384,0,2384,762,3146,75.7788
第15任總統副總統,在新北市各村(里),新北市,　新莊區,中全里,86,585,1577,2248,22,2270,0,2270,824,3094,73.3678
第15任總統副總統,在新北市各村(里),新北市,　新莊區,立志里,119,812,1657,2588,33,2621,1,2622,777,3399,77.1109
第15任總統副總統,在新北市各村(里),新北市,　新莊區,立廷里,368,2522,4188,7078,64,7142,0,7142,2124,9266,77.0775
第15任總統副總統,在新北市各村(里),新北市,　新莊區,立基里,182,1424,2433,4039,45,4084,1,4085,1146,5231,78.0730
第15任總統副總統,在新北市各村(里),新北市,　新莊區,中誠里,56,413,927,1396,12,1408,0,1408,480,1888,74.5763
第15任總統副總統,在新北市各村(里),新北市,　新莊區,中港里,176,1350,2561,4087,36,4123,0,4123,1255,5378,76.6642
第15任總統副總統,在新北市各村(里),新北市,　新莊區,中信里,243,1723,3521,5487,48,5535,0,5535,1582,7117,77.7715
第15任總統副總統,在新北市各村(里),新北市,　新莊區,中平里,262,1936,3234,5432,48,5480,0,5480,1613,7093,77.2593
第15任總統副總統,在新北市各村(里),新北市,　新莊區,中原里,355,2404,4594,7353,68,7421,0,7421,2336,9757,76.0582
第15任總統副總統,在新北市各村(里),新北市,　新莊區,中隆里,137,1000,1875,3012,34,3046,0,3046,1035,4081,74.6386
第15任總統副總統,在新北市各村(里),新北市,　新莊區,立功里,90,795,1490,2375,20,2395,0,2395,787,3182,75.2671
第15任總統副總統,在新北市各村(里),新北市,　新莊區,立泰里,138,1074,1934,3146,41,3187,0,3187,999,4186,76.1347
第15任總統副總統,在新北市各村(里),新北市,　新莊區,立言里,173,1183,1974,3330,32,3362,0,3362,984,4346,77.3585
第15任總統副總統,在新北市各村(里),新北市,　新莊區,豐年里,93,755,1534,2382,29,2411,1,2412,793,3205,75.2262
第15任總統副總統,在新北市各村(里),新北市,　新莊區,國泰里,51,333,574,958,12,970,0,970,315,1285,75.4864
第15任總統副總統,在新北市各村(里),新北市,　新莊區,泰豐里,76,584,966,1626,13,1639,0,1639,508,2147,76.3391
第15任總統副總統,在新北市各村(里),新北市,　新莊區,瓊林里,163,1092,2445,3700,26,3726,0,3726,1283,5009,74.3861
第15任總統副總統,在新北市各村(里),新北市,　新莊區,福營里,68,529,1086,1683,16,1699,0,1699,599,2298,73.9339
第15任總統副總統,在新北市各村(里),新北市,　新莊區,營盤里,70,502,932,1504,20,1524,0,1524,439,1963,77.6363
第15任總統副總統,在新北市各村(里),新北市,　新莊區,丹鳳里,291,1952,3200,5443,54,5497,0,5497,1905,7402,74.2637
第15任總統副總統,在新北市各村(里),新北市,　新莊區,合鳳里,155,907,1771,2833,26,2859,0,2859,1059,3918,72.9709
第15任總統副總統,在新北市各村(里),新北市,　新莊區,祥鳳里,71,542,942,1555,18,1573,0,1573,496,2069,76.0271
第15任總統副總統,在新北市各村(里),新北市,　新莊區,雙鳳里,341,2441,3921,6703,65,6768,0,6768,2400,9168,73.8220
第15任總統副總統,在新北市各村(里),新北市,　新莊區,龍福里,90,523,810,1423,13,1436,0,1436,485,1921,74.7527
第15任總統副總統,在新北市各村(里),新北市,　新莊區,龍鳳里,246,1957,3723,5926,57,5983,0,5983,1874,7857,76.1487
第15任總統副總統,在新北市各村(里),新北市,　新莊區,裕民里,199,1338,2774,4311,41,4352,0,4352,1547,5899,73.7752
第15任總統副總統,在新北市各村(里),新北市,　新莊區,龍安里,68,488,937,1493,11,1504,0,1504,536,2040,73.7255
第15任總統副總統,在新北市各村(里),新北市,　新莊區,富國里,73,473,969,1515,13,1528,0,1528,536,2064,74.0310
第15任總統副總統,在新北市各村(里),新北市,　新莊區,富民里,141,796,1573,2510,22,2532,0,2532,807,3339,75.8311
第15任總統副總統,在新北市各村(里),新北市,　新莊區,後德里,129,696,1288,2113,20,2133,0,2133,527,2660,80.1880
第15任總統副總統,在新北市各村(里),新北市,　新莊區,萬安里,97,779,1473,2349,18,2367,0,2367,847,3214,73.6465
第15任總統副總統,在新北市各村(里),新北市,　新莊區,建福里,78,578,1000,1656,20,1676,0,1676,505,2181,76.8455
第15任總統副總統,在新北市各村(里),新北市,　新莊區,後港里,226,1469,3047,4742,40,4782,0,4782,1333,6115,78.2011
第15任總統副總統,在新北市各村(里),新北市,　新莊區,四維里,115,845,1891,2851,25,2876,0,2876,1186,4062,70.8026
第15任總統副總統,在新北市各村(里),新北市,　新莊區,南港里,187,1068,2133,3388,44,3432,0,3432,1132,4564,75.1972
第15任總統副總統,在新北市各村(里),新北市,　新莊區,建安里,208,1341,2731,4280,46,4326,0,4326,1396,5722,75.6029
第15任總統副總統,在新北市各村(里),新北市,　新莊區,民全里,113,757,1542,2412,23,2435,0,2435,751,3186,76.4281
第15任總統副總統,在新北市各村(里),新北市,　新莊區,八德里,79,592,1276,1947,24,1971,0,1971,722,2693,73.1898
第15任總統副總統,在新北市各村(里),新北市,　新莊區,成德里,153,985,1932,3070,39,3109,0,3109,1150,4259,72.9984
第15任總統副總統,在新北市各村(里),新北市,　新莊區,民安里,177,1222,2388,3787,38,3825,0,3825,1243,5068,75.4736
第15任總統副總統,在新北市各村(里),新北市,　新莊區,民有里,135,866,1594,2595,37,2632,4,2636,764,3400,77.4118
第15任總統副總統,在新北市各村(里),新北市,　新莊區,民本里,65,520,1225,1810,26,1836,0,1836,750,2586,70.9977
第15任總統副總統,在新北市各村(里),新北市,　新莊區,光明里,133,917,1905,2955,26,2981,0,2981,1030,4011,74.3206
第15任總統副總統,在新北市各村(里),新北市,　新莊區,光正里,148,944,1690,2782,30,2812,0,2812,864,3676,76.4962
第15任總統副總統,在新北市各村(里),新北市,　新莊區,光榮里,110,946,1626,2682,30,2712,0,2712,965,3677,73.7558
第15任總統副總統,在新北市各村(里),新北市,　新莊區,光和里,81,471,1175,1727,22,1749,0,1749,650,2399,72.9054
第15任總統副總統,在新北市各村(里),新北市,　新莊區,光華里,188,1381,2775,4344,37,4381,0,4381,1634,6015,72.8346
第15任總統副總統,在新北市各村(里),新北市,　新莊區,西盛里,369,2440,4582,7391,94,7485,0,7485,2412,9897,75.6290
第15任總統副總統,在新北市各村(里),新北市,　新店區,新店里,59,469,660,1188,13,1201,0,1201,388,1589,75.5821
第15任總統副總統,在新北市各村(里),新北市,　新店區,張南里,61,735,635,1431,12,1443,0,1443,452,1895,76.1478
第15任總統副總統,在新北市各村(里),新北市,　新店區,國校里,61,799,804,1664,24,1688,0,1688,543,2231,75.6611
第15任總統副總統,在新北市各村(里),新北市,　新店區,文中里,56,652,459,1167,14,1181,0,1181,363,1544,76.4896
第15任總統副總統,在新北市各村(里),新北市,　新店區,廣明里,15,207,361,583,4,587,0,587,189,776,75.6443
第15任總統副總統,在新北市各村(里),新北市,　新店區,文明里,89,762,885,1736,22,1758,0,1758,489,2247,78.2377
第15任總統副總統,在新北市各村(里),新北市,　新店區,中興里,164,1877,1419,3460,28,3488,0,3488,1072,4560,76.4912
第15任總統副總統,在新北市各村(里),新北市,　新店區,新生里,171,2112,1703,3986,38,4024,0,4024,1188,5212,77.2064
第15任總統副總統,在新北市各村(里),新北市,　新店區,新德里,85,860,881,1826,17,1843,1,1844,592,2436,75.6568
第15任總統副總統,在新北市各村(里),新北市,　新店區,張北里,236,3168,2450,5854,69,5923,0,5923,1907,7830,75.6450
第15任總統副總統,在新北市各村(里),新北市,　新店區,五峯里,181,2690,2260,5131,68,5199,0,5199,1578,6777,76.7154
第15任總統副總統,在新北市各村(里),新北市,　新店區,長春里,82,907,716,1705,23,1728,0,1728,549,2277,75.8893
第15任總統副總統,在新北市各村(里),新北市,　新店區,新安里,128,1682,1219,3029,25,3054,0,3054,2749,5803,52.6280
第15任總統副總統,在新北市各村(里),新北市,　新店區,忠誠里,58,908,727,1693,19,1712,0,1712,461,2173,78.7851
第15任總統副總統,在新北市各村(里),新北市,　新店區,中正里,156,2272,1634,4062,45,4107,0,4107,1349,5456,75.2749
第15任總統副總統,在新北市各村(里),新北市,　新店區,中華里,121,1702,1073,2896,39,2935,0,2935,914,3849,76.2536
第15任總統副總統,在新北市各村(里),新北市,　新店區,仁愛里,67,784,548,1399,14,1413,0,1413,400,1813,77.9371
第15任總統副總統,在新北市各村(里),新北市,　新店區,建國里,92,1229,816,2137,25,2162,0,2162,644,2806,77.0492
第15任總統副總統,在新北市各村(里),新北市,　新店區,百忍里,100,1446,1051,2597,33,2630,0,2630,794,3424,76.8107
第15任總統副總統,在新北市各村(里),新北市,　新店區,百和里,76,1112,973,2161,17,2178,0,2178,674,2852,76.3675
第15任總統副總統,在新北市各村(里),新北市,　新店區,福德里,108,1309,1182,2599,31,2630,0,2630,858,3488,75.4014
第15任總統副總統,在新北市各村(里),新北市,　新店區,百福里,115,1362,1052,2529,25,2554,0,2554,704,3258,78.3917
第15任總統副總統,在新北市各村(里),新北市,　新店區,福民里,118,1725,949,2792,32,2824,1,2825,878,3703,76.2625
第15任總統副總統,在新北市各村(里),新北市,　新店區,中山里,149,1877,1099,3125,37,3162,0,3162,886,4048,78.1126
第15任總統副總統,在新北市各村(里),新北市,　新店區,和平里,26,329,240,595,9,604,0,604,196,800,75.5000
第15任總統副總統,在新北市各村(里),新北市,　新店區,中央里,184,2301,1569,4054,49,4103,0,4103,1101,5204,78.8432
第15任總統副總統,在新北市各村(里),新北市,　新店區,國豐里,85,1271,839,2195,27,2222,0,2222,682,2904,76.5152
第15任總統副總統,在新北市各村(里),新北市,　新店區,明德里,114,1467,1105,2686,29,2715,0,2715,819,3534,76.8251
第15任總統副總統,在新北市各村(里),新北市,　新店區,大豐里,99,1281,1071,2451,28,2479,0,2479,855,3334,74.3551
第15任總統副總統,在新北市各村(里),新北市,　新店區,大同里,124,1389,1260,2773,24,2797,0,2797,712,3509,79.7093
第15任總統副總統,在新北市各村(里),新北市,　新店區,江陵里,140,1974,1590,3704,48,3752,0,3752,1116,4868,77.0748
第15任總統副總統,在新北市各村(里),新北市,　新店區,復興里,94,1036,949,2079,27,2106,3,2109,836,2945,71.5110
第15任總統副總統,在新北市各村(里),新北市,　新店區,寶興里,138,1938,1558,3634,52,3686,5,3691,1071,4762,77.4045
第15任總統副總統,在新北市各村(里),新北市,　新店區,寶福里,236,2548,1990,4774,66,4840,0,4840,1432,6272,77.1684
第15任總統副總統,在新北市各村(里),新北市,　新店區,寶安里,153,2078,1496,3727,46,3773,0,3773,1176,4949,76.2376
第15任總統副總統,在新北市各村(里),新北市,　新店區,信義里,204,2179,2184,4567,63,4630,0,4630,1374,6004,77.1153
第15任總統副總統,在新北市各村(里),新北市,　新店區,忠孝里,63,1084,681,1828,15,1843,0,1843,630,2473,74.5249
第15任總統副總統,在新北市各村(里),新北市,　新店區,大鵬里,58,1412,469,1939,10,1949,0,1949,485,2434,80.0740
第15任總統副總統,在新北市各村(里),新北市,　新店區,太平里,107,1074,865,2046,13,2059,0,2059,712,2771,74.3053
第15任總統副總統,在新北市各村(里),新北市,　新店區,美城里,87,937,804,1828,34,1862,0,1862,583,2445,76.1554
第15任總統副總統,在新北市各村(里),新北市,　新店區,頂城里,50,506,461,1017,20,1037,0,1037,518,1555,66.6881
第15任總統副總統,在新北市各村(里),新北市,　新店區,下城里,69,945,1086,2100,18,2118,0,2118,783,2901,73.0093
第15任總統副總統,在新北市各村(里),新北市,　新店區,柴埕里,235,2697,2803,5735,67,5802,0,5802,2014,7816,74.2323
第15任總統副總統,在新北市各村(里),新北市,　新店區,安和里,232,2386,2388,5006,57,5063,0,5063,1617,6680,75.7934
第15任總統副總統,在新北市各村(里),新北市,　新店區,永安里,164,1470,1661,3295,33,3328,0,3328,1162,4490,74.1203
第15任總統副總統,在新北市各村(里),新北市,　新店區,新和里,120,1361,1249,2730,31,2761,0,2761,935,3696,74.7024
第15任總統副總統,在新北市各村(里),新北市,　新店區,永平里,163,1735,1714,3612,38,3650,0,3650,1188,4838,75.4444
第15任總統副總統,在新北市各村(里),新北市,　新店區,公崙里,324,3971,3801,8096,73,8169,0,8169,2655,10824,75.4712
第15任總統副總統,在新北市各村(里),新北市,　新店區,安昌里,185,1774,1655,3614,28,3642,0,3642,1059,4701,77.4729
第15任總統副總統,在新北市各村(里),新北市,　新店區,德安里,186,1764,1971,3921,50,3971,0,3971,1431,5402,73.5098
第15任總統副總統,在新北市各村(里),新北市,　新店區,達觀里,113,1505,951,2569,24,2593,0,2593,950,3543,73.1866
第15任總統副總統,在新北市各村(里),新北市,　新店區,明城里,107,1357,894,2358,26,2384,0,2384,690,3074,77.5537
第15任總統副總統,在新北市各村(里),新北市,　新店區,小城里,98,1427,977,2502,33,2535,0,2535,766,3301,76.7949
第15任總統副總統,在新北市各村(里),新北市,　新店區,雙城里,156,1665,1863,3684,47,3731,0,3731,1346,5077,73.4883
第15任總統副總統,在新北市各村(里),新北市,　新店區,香坡里,280,3974,2733,6987,55,7042,0,7042,2521,9563,73.6380
第15任總統副總統,在新北市各村(里),新北市,　新店區,日興里,153,1637,1856,3646,55,3701,0,3701,1480,5181,71.4341
第15任總統副總統,在新北市各村(里),新北市,　新店區,玫瑰里,171,2049,1691,3911,30,3941,0,3941,1327,5268,74.8102
第15任總統副總統,在新北市各村(里),新北市,　新店區,吉祥里,148,1883,1156,3187,35,3222,0,3222,1030,4252,75.7761
第15任總統副總統,在新北市各村(里),新北市,　新店區,塗潭里,16,174,467,657,6,663,3,666,256,922,71.9089
第15任總統副總統,在新北市各村(里),新北市,　新店區,華城里,68,931,771,1770,35,1805,0,1805,624,2429,74.3104
第15任總統副總統,在新北市各村(里),新北市,　新店區,青潭里,151,1614,1688,3453,50,3503,0,3503,1203,4706,74.4369
第15任總統副總統,在新北市各村(里),新北市,　新店區,美潭里,137,1705,1578,3420,40,3460,0,3460,1183,4643,74.5208
第15任總統副總統,在新北市各村(里),新北市,　新店區,員潭里,146,1622,1500,3268,37,3305,0,3305,1204,4509,73.2978
第15任總統副總統,在新北市各村(里),新北市,　新店區,雙坑里,22,178,299,499,4,503,0,503,227,730,68.9041
第15任總統副總統,在新北市各村(里),新北市,　新店區,粗坑里,78,908,1065,2051,29,2080,0,2080,671,2751,75.6089
第15任總統副總統,在新北市各村(里),新北市,　新店區,屈尺里,47,654,880,1581,22,1603,0,1603,603,2206,72.6655
第15任總統副總統,在新北市各村(里),新北市,　新店區,龜山里,36,438,626,1100,15,1115,0,1115,474,1589,70.1699
第15任總統副總統,在新北市各村(里),新北市,　新店區,廣興里,28,277,596,901,8,909,0,909,358,1267,71.7443
第15任總統副總統,在新北市各村(里),新北市,　新店區,直潭里,32,293,537,862,15,877,0,877,297,1174,74.7019
第15任總統副總統,在新北市各村(里),新北市,　樹林區,三興里,153,997,1744,2894,39,2933,0,2933,1211,4144,70.7770
第15任總統副總統,在新北市各村(里),新北市,　樹林區,三福里,86,973,1477,2536,36,2572,0,2572,824,3396,75.7362
第15任總統副總統,在新北市各村(里),新北市,　樹林區,三多里,128,772,1624,2524,42,2566,0,2566,963,3529,72.7118
第15任總統副總統,在新北市各村(里),新北市,　樹林區,三龍里,66,437,872,1375,13,1388,0,1388,399,1787,77.6721
第15任總統副總統,在新北市各村(里),新北市,　樹林區,獇寮里,124,978,1998,3100,32,3132,0,3132,1139,4271,73.3318
第15任總統副總統,在新北市各村(里),新北市,　樹林區,光興里,116,847,1663,2626,31,2657,0,2657,835,3492,76.0882
第15任總統副總統,在新北市各村(里),新北市,　樹林區,金寮里,127,874,1739,2740,37,2777,0,2777,948,3725,74.5503
第15任總統副總統,在新北市各村(里),新北市,　樹林區,潭底里,105,858,1621,2584,35,2619,0,2619,1618,4237,61.8126
第15任總統副總統,在新北市各村(里),新北市,　樹林區,文林里,163,1149,1984,3296,39,3335,0,3335,987,4322,77.1634
第15任總統副總統,在新北市各村(里),新北市,　樹林區,保安里,201,1407,2514,4122,52,4174,0,4174,1244,5418,77.0395
第15任總統副總統,在新北市各村(里),新北市,　樹林區,圳安里,115,706,1562,2383,29,2412,0,2412,782,3194,75.5166
第15任總統副總統,在新北市各村(里),新北市,　樹林區,圳福里,137,965,1699,2801,36,2837,0,2837,949,3786,74.9340
第15任總統副總統,在新北市各村(里),新北市,　樹林區,圳民里,88,619,1136,1843,22,1865,1,1866,623,2489,74.9297
第15任總統副總統,在新北市各村(里),新北市,　樹林區,圳生里,38,265,788,1091,16,1107,0,1107,321,1428,77.5210
第15任總統副總統,在新北市各村(里),新北市,　樹林區,樹德里,120,893,1426,2439,34,2473,0,2473,688,3161,78.2347
第15任總統副總統,在新北市各村(里),新北市,　樹林區,樹福里,101,880,1477,2458,23,2481,0,2481,636,3117,79.5958
第15任總統副總統,在新北市各村(里),新北市,　樹林區,樹西里,167,1281,1999,3447,40,3487,0,3487,952,4439,78.5537
第15任總統副總統,在新北市各村(里),新北市,　樹林區,樹興里,109,855,1344,2308,30,2338,0,2338,768,3106,75.2737
第15任總統副總統,在新北市各村(里),新北市,　樹林區,樹人里,118,856,1208,2182,21,2203,0,2203,682,2885,76.3605
第15任總統副總統,在新北市各村(里),新北市,　樹林區,育英里,104,716,1290,2110,24,2134,0,2134,556,2690,79.3309
第15任總統副總統,在新北市各村(里),新北市,　樹林區,樹南里,158,946,1662,2766,36,2802,0,2802,845,3647,76.8303
第15任總統副總統,在新北市各村(里),新北市,　樹林區,坡內里,44,378,679,1101,12,1113,0,1113,363,1476,75.4065
第15任總統副總統,在新北市各村(里),新北市,　樹林區,樹東里,38,327,444,809,12,821,0,821,265,1086,75.5985
第15任總統副總統,在新北市各村(里),新北市,　樹林區,樹北里,37,237,390,664,6,670,0,670,188,858,78.0886
第15任總統副總統,在新北市各村(里),新北市,　樹林區,彭福里,190,1079,1942,3211,29,3240,0,3240,1218,4458,72.6783
第15任總統副總統,在新北市各村(里),新北市,　樹林區,和平里,121,737,1542,2400,33,2433,0,2433,870,3303,73.6603
第15任總統副總統,在新北市各村(里),新北市,　樹林區,彭興里,163,1099,2323,3585,33,3618,0,3618,1409,5027,71.9714
第15任總統副總統,在新北市各村(里),新北市,　樹林區,彭厝里,147,995,1980,3122,36,3158,0,3158,1104,4262,74.0967
第15任總統副總統,在新北市各村(里),新北市,　樹林區,大同里,125,842,1343,2310,21,2331,0,2331,697,3028,76.9815
第15任總統副總統,在新北市各村(里),新北市,　樹林區,中華里,111,718,1317,2146,17,2163,0,2163,769,2932,73.7722
第15任總統副總統,在新北市各村(里),新北市,　樹林區,太順里,86,568,1082,1736,18,1754,0,1754,585,2339,74.9893
第15任總統副總統,在新北市各村(里),新北市,　樹林區,東昇里,190,1101,1988,3279,39,3318,0,3318,972,4290,77.3427
第15任總統副總統,在新北市各村(里),新北市,　樹林區,東陽里,177,1319,2248,3744,44,3788,0,3788,1280,5068,74.7435
第15任總統副總統,在新北市各村(里),新北市,　樹林區,東山里,94,710,1261,2065,19,2084,0,2084,682,2766,75.3435
第15任總統副總統,在新北市各村(里),新北市,　樹林區,山佳里,196,1224,2164,3584,30,3614,0,3614,1231,4845,74.5924
第15任總統副總統,在新北市各村(里),新北市,　樹林區,中山里,137,1115,2028,3280,51,3331,0,3331,1195,4526,73.5970
第15任總統副總統,在新北市各村(里),新北市,　樹林區,樂山里,63,413,762,1238,18,1256,0,1256,454,1710,73.4503
第15任總統副總統,在新北市各村(里),新北市,　樹林區,柑園里,302,2459,3004,5765,70,5835,0,5835,1776,7611,76.6654
第15任總統副總統,在新北市各村(里),新北市,　樹林區,西園里,44,321,794,1159,17,1176,0,1176,398,1574,74.7141
第15任總統副總統,在新北市各村(里),新北市,　樹林區,南園里,431,3879,4546,8856,92,8948,0,8948,2806,11754,76.1273
第15任總統副總統,在新北市各村(里),新北市,　樹林區,東園里,40,272,769,1081,10,1091,0,1091,390,1481,73.6664
第15任總統副總統,在新北市各村(里),新北市,　樹林區,北園里,58,362,982,1402,15,1417,0,1417,493,1910,74.1885
第15任總統副總統,在新北市各村(里),新北市,　鶯歌區,建德里,21,138,232,391,7,398,0,398,104,502,79.2829
第15任總統副總統,在新北市各村(里),新北市,　鶯歌區,東鶯里,31,226,435,692,5,697,0,697,234,931,74.8657
第15任總統副總統,在新北市各村(里),新北市,　鶯歌區,北鶯里,135,1001,1359,2495,31,2526,0,2526,1133,3659,69.0353
第15任總統副總統,在新北市各村(里),新北市,　鶯歌區,西鶯里,67,503,846,1416,16,1432,0,1432,491,1923,74.4670
第15任總統副總統,在新北市各村(里),新北市,　鶯歌區,中鶯里,27,259,451,737,5,742,0,742,185,927,80.0431
第15任總統副總統,在新北市各村(里),新北市,　鶯歌區,南鶯里,165,1268,2205,3638,41,3679,1,3680,1169,4849,75.8713
第15任總統副總統,在新北市各村(里),新北市,　鶯歌區,建國里,217,1391,2698,4306,54,4360,0,4360,1540,5900,73.8983
第15任總統副總統,在新北市各村(里),新北市,　鶯歌區,二甲里,39,188,390,617,6,623,0,623,203,826,75.4237
第15任總統副總統,在新北市各村(里),新北市,　鶯歌區,二橋里,240,1673,3078,4991,67,5058,0,5058,1876,6934,72.9449
第15任總統副總統,在新北市各村(里),新北市,　鶯歌區,尖山里,243,1753,3104,5100,48,5148,1,5149,1799,6948,74.0933
第15任總統副總統,在新北市各村(里),新北市,　鶯歌區,南靖里,137,765,1428,2330,17,2347,0,2347,750,3097,75.7830
第15任總統副總統,在新北市各村(里),新北市,　鶯歌區,同慶里,48,335,682,1065,11,1076,0,1076,301,1377,78.1409
第15任總統副總統,在新北市各村(里),新北市,　鶯歌區,永昌里,250,1892,3118,5260,48,5308,1,5309,1766,7075,75.0247
第15任總統副總統,在新北市各村(里),新北市,　鶯歌區,永吉里,163,1066,1942,3171,29,3200,0,3200,987,4187,76.4270
第15任總統副總統,在新北市各村(里),新北市,　鶯歌區,鳳祥里,131,968,1661,2760,26,2786,0,2786,1081,3867,72.0455
第15任總統副總統,在新北市各村(里),新北市,　鶯歌區,鳳鳴里,166,1069,1917,3152,47,3199,0,3199,1084,4283,74.6906
第15任總統副總統,在新北市各村(里),新北市,　鶯歌區,鳳福里,126,912,1492,2530,31,2561,0,2561,859,3420,74.8830
第15任總統副總統,在新北市各村(里),新北市,　鶯歌區,大湖里,135,1347,1852,3334,42,3376,0,3376,1124,4500,75.0222
第15任總統副總統,在新北市各村(里),新北市,　鶯歌區,中湖里,163,1283,2074,3520,35,3555,2,3557,1421,4978,71.4142
第15任總統副總統,在新北市各村(里),新北市,　鶯歌區,東湖里,6,65,115,186,2,188,0,188,46,234,80.3419
第15任總統副總統,在新北市各村(里),新北市,　三峽區,三峽里,11,83,124,218,2,220,0,220,55,275,80.0000
第15任總統副總統,在新北市各村(里),新北市,　三峽區,秀川里,20,154,230,404,4,408,0,408,145,553,73.7794
第15任總統副總統,在新北市各村(里),新北市,　三峽區,八張里,124,918,1486,2528,21,2549,0,2549,892,3441,74.0773
第15任總統副總統,在新北市各村(里),新北市,　三峽區,中埔里,94,704,1125,1923,16,1939,0,1939,729,2668,72.6762
第15任總統副總統,在新北市各村(里),新北市,　三峽區,弘道里,37,200,495,732,8,740,0,740,266,1006,73.5586
第15任總統副總統,在新北市各村(里),新北市,　三峽區,永舘里,215,1645,2793,4653,48,4701,0,4701,1588,6289,74.7496
第15任總統副總統,在新北市各村(里),新北市,　三峽區,鳶山里,271,2186,3638,6095,79,6174,0,6174,2304,8478,72.8238
第15任總統副總統,在新北市各村(里),新北市,　三峽區,龍埔里,288,2104,3293,5685,60,5745,0,5745,2224,7969,72.0919
第15任總統副總統,在新北市各村(里),新北市,　三峽區,龍恩里,209,1810,2078,4097,62,4159,0,4159,1478,5637,73.7804
第15任總統副總統,在新北市各村(里),新北市,　三峽區,龍學里,472,4137,4358,8967,114,9081,0,9081,2958,12039,75.4299
第15任總統副總統,在新北市各村(里),新北市,　三峽區,礁溪里,158,1313,2171,3642,38,3680,0,3680,1332,5012,73.4238
第15任總統副總統,在新北市各村(里),新北市,　三峽區,安溪里,187,1714,2644,4545,45,4590,0,4590,1816,6406,71.6516
第15任總統副總統,在新北市各村(里),新北市,　三峽區,介壽里,188,1273,2438,3899,36,3935,0,3935,1917,5852,67.2420
第15任總統副總統,在新北市各村(里),新北市,　三峽區,中正里,126,1097,1972,3195,44,3239,0,3239,1214,4453,72.7375
第15任總統副總統,在新北市各村(里),新北市,　三峽區,大埔里,101,1037,1385,2523,32,2555,0,2555,1015,3570,71.5686
第15任總統副總統,在新北市各村(里),新北市,　三峽區,嘉添里,69,702,715,1486,22,1508,0,1508,583,2091,72.1186
第15任總統副總統,在新北市各村(里),新北市,　三峽區,添福里,32,235,488,755,5,760,0,760,231,991,76.6902
第15任總統副總統,在新北市各村(里),新北市,　三峽區,金圳里,16,107,209,332,5,337,0,337,152,489,68.9162
第15任總統副總統,在新北市各村(里),新北市,　三峽區,五寮里,20,222,299,541,5,546,0,546,244,790,69.1139
第15任總統副總統,在新北市各村(里),新北市,　三峽區,插角里,16,166,289,471,1,472,0,472,169,641,73.6349
第15任總統副總統,在新北市各村(里),新北市,　三峽區,有木里,18,151,276,445,7,452,0,452,239,691,65.4124
第15任總統副總統,在新北市各村(里),新北市,　三峽區,二鬮里,98,983,1119,2200,22,2222,0,2222,896,3118,71.2636
第15任總統副總統,在新北市各村(里),新北市,　三峽區,溪南里,38,317,626,981,15,996,0,996,332,1328,75.0000
第15任總統副總統,在新北市各村(里),新北市,　三峽區,溪北里,64,491,938,1493,17,1510,0,1510,534,2044,73.8748
第15任總統副總統,在新北市各村(里),新北市,　三峽區,溪東里,73,721,1053,1847,24,1871,0,1871,776,2647,70.6838
第15任總統副總統,在新北市各村(里),新北市,　三峽區,成福里,12,216,434,662,10,672,0,672,169,841,79.9049
第15任總統副總統,在新北市各村(里),新北市,　三峽區,竹崙里,42,398,800,1240,8,1248,0,1248,593,1841,67.7892
第15任總統副總統,在新北市各村(里),新北市,　三峽區,安坑里,28,254,601,883,16,899,0,899,366,1265,71.0672
第15任總統副總統,在新北市各村(里),新北市,　淡水區,中和里,22,137,246,405,6,411,0,411,126,537,76.5363
第15任總統副總統,在新北市各村(里),新北市,　淡水區,屯山里,25,223,475,723,11,734,0,734,268,1002,73.2535
第15任總統副總統,在新北市各村(里),新北市,　淡水區,賢孝里,43,398,557,998,9,1007,0,1007,413,1420,70.9155
第15任總統副總統,在新北市各村(里),新北市,　淡水區,興仁里,34,375,644,1053,4,1057,0,1057,440,1497,70.6079
第15任總統副總統,在新北市各村(里),新北市,　淡水區,蕃薯里,26,306,316,648,6,654,0,654,301,955,68.4817
第15任總統副總統,在新北市各村(里),新北市,　淡水區,忠山里,23,215,344,582,5,587,0,587,192,779,75.3530
第15任總統副總統,在新北市各村(里),新北市,　淡水區,義山里,67,673,943,1683,29,1712,0,1712,685,2397,71.4226
第15任總統副總統,在新北市各村(里),新北市,　淡水區,水源里,60,405,894,1359,15,1374,0,1374,586,1960,70.1020
第15任總統副總統,在新北市各村(里),新北市,　淡水區,忠寮里,29,215,503,747,9,756,0,756,279,1035,73.0435
第15任總統副總統,在新北市各村(里),新北市,　淡水區,樹興里,41,370,534,945,10,955,0,955,368,1323,72.1844
第15任總統副總統,在新北市各村(里),新北市,　淡水區,坪頂里,46,332,515,893,9,902,0,902,364,1266,71.2480
第15任總統副總統,在新北市各村(里),新北市,　淡水區,福德里,190,2171,2301,4662,61,4723,0,4723,1393,6116,77.2237
第15任總統副總統,在新北市各村(里),新北市,　淡水區,竹圍里,217,1760,2156,4133,39,4172,0,4172,1301,5473,76.2288
第15任總統副總統,在新北市各村(里),新北市,　淡水區,民權里,141,1165,1630,2936,24,2960,0,2960,954,3914,75.6260
第15任總統副總統,在新北市各村(里),新北市,　淡水區,民生里,217,1853,2459,4529,61,4590,0,4590,1719,6309,72.7532
第15任總統副總統,在新北市各村(里),新北市,　淡水區,八勢里,186,1778,1977,3941,42,3983,0,3983,1522,5505,72.3524
第15任總統副總統,在新北市各村(里),新北市,　淡水區,竿蓁里,325,3123,3390,6838,93,6931,1,6932,2780,9712,71.3653
第15任總統副總統,在新北市各村(里),新北市,　淡水區,崁頂里,459,4310,4922,9691,98,9789,0,9789,4554,14343,68.2493
第15任總統副總統,在新北市各村(里),新北市,　淡水區,埤島里,44,392,650,1086,16,1102,0,1102,383,1485,74.2088
第15任總統副總統,在新北市各村(里),新北市,　淡水區,水碓里,178,1362,2115,3655,25,3680,0,3680,1250,4930,74.6450
第15任總統副總統,在新北市各村(里),新北市,　淡水區,北新里,85,704,897,1686,25,1711,0,1711,665,2376,72.0118
第15任總統副總統,在新北市各村(里),新北市,　淡水區,正德里,140,1232,1521,2893,28,2921,0,2921,1065,3986,73.2815
第15任總統副總統,在新北市各村(里),新北市,　淡水區,新興里,210,1896,2403,4509,42,4551,0,4551,1782,6333,71.8617
第15任總統副總統,在新北市各村(里),新北市,　淡水區,新義里,100,921,1618,2639,28,2667,0,2667,943,3610,73.8781
第15任總統副總統,在新北市各村(里),新北市,　淡水區,新春里,275,2218,2890,5383,46,5429,0,5429,1987,7416,73.2066
第15任總統副總統,在新北市各村(里),新北市,　淡水區,新民里,148,1288,1640,3076,41,3117,0,3117,1032,4149,75.1265
第15任總統副總統,在新北市各村(里),新北市,　淡水區,北投里,344,2628,3224,6196,67,6263,0,6263,2175,8438,74.2237
第15任總統副總統,在新北市各村(里),新北市,　淡水區,鄧公里,200,1682,2067,3949,49,3998,0,3998,1359,5357,74.6313
第15任總統副總統,在新北市各村(里),新北市,　淡水區,幸福里,112,954,1452,2518,30,2548,0,2548,917,3465,73.5354
第15任總統副總統,在新北市各村(里),新北市,　淡水區,學府里,173,1120,1530,2823,29,2852,0,2852,1203,4055,70.3329
第15任總統副總統,在新北市各村(里),新北市,　淡水區,中興里,117,1025,1477,2619,40,2659,0,2659,962,3621,73.4328
第15任總統副總統,在新北市各村(里),新北市,　淡水區,長庚里,39,389,578,1006,10,1016,0,1016,301,1317,77.1450
第15任總統副總統,在新北市各村(里),新北市,　淡水區,清文里,31,306,463,800,13,813,0,813,264,1077,75.4875
第15任總統副總統,在新北市各村(里),新北市,　淡水區,草東里,20,196,317,533,5,538,0,538,152,690,77.9710
第15任總統副總統,在新北市各村(里),新北市,　淡水區,協元里,58,349,579,986,7,993,0,993,347,1340,74.1045
第15任總統副總統,在新北市各村(里),新北市,　淡水區,永吉里,34,223,326,583,16,599,0,599,198,797,75.1568
第15任總統副總統,在新北市各村(里),新北市,　淡水區,民安里,14,160,304,478,4,482,0,482,162,644,74.8447
第15任總統副總統,在新北市各村(里),新北市,　淡水區,新生里,11,113,192,316,3,319,0,319,96,415,76.8675
第15任總統副總統,在新北市各村(里),新北市,　淡水區,文化里,49,504,566,1119,21,1140,0,1140,426,1566,72.7969
第15任總統副總統,在新北市各村(里),新北市,　淡水區,油車里,145,1573,1832,3550,44,3594,0,3594,1252,4846,74.1643
第15任總統副總統,在新北市各村(里),新北市,　淡水區,沙崙里,114,1131,1461,2706,34,2740,0,2740,1166,3906,70.1485
第15任總統副總統,在新北市各村(里),新北市,　淡水區,大庄里,262,2632,2764,5658,58,5716,0,5716,2129,7845,72.8617
第15任總統副總統,在新北市各村(里),新北市,　汐止區,仁德里,67,494,653,1214,11,1225,0,1225,360,1585,77.2871
第15任總統副總統,在新北市各村(里),新北市,　汐止區,義民里,34,394,452,880,5,885,0,885,326,1211,73.0801
第15任總統副總統,在新北市各村(里),新北市,　汐止區,禮門里,23,257,407,687,8,695,0,695,236,931,74.6509
第15任總統副總統,在新北市各村(里),新北市,　汐止區,智慧里,117,1441,1525,3083,23,3106,1,3107,1037,4144,74.9517
第15任總統副總統,在新北市各村(里),新北市,　汐止區,大同里,78,764,975,1817,18,1835,0,1835,603,2438,75.2666
第15任總統副總統,在新北市各村(里),新北市,　汐止區,信望里,11,93,126,230,4,234,0,234,85,319,73.3542
第15任總統副總統,在新北市各村(里),新北市,　汐止區,新昌里,154,1312,2002,3468,27,3495,0,3495,1185,4680,74.6795
第15任總統副總統,在新北市各村(里),新北市,　汐止區,福安里,187,1531,2139,3857,42,3899,0,3899,1218,5117,76.1970
第15任總統副總統,在新北市各村(里),新北市,　汐止區,秀峰里,110,997,1573,2680,26,2706,0,2706,2064,4770,56.7296
第15任總統副總統,在新北市各村(里),新北市,　汐止區,秀山里,133,1289,1466,2888,24,2912,0,2912,894,3806,76.5108
第15任總統副總統,在新北市各村(里),新北市,　汐止區,復興里,214,2074,2450,4738,52,4790,2,4792,1256,6048,79.1997
第15任總統副總統,在新北市各村(里),新北市,　汐止區,自強里,191,1362,2046,3599,47,3646,0,3646,1206,4852,75.1443
第15任總統副總統,在新北市各村(里),新北市,　汐止區,文化里,150,1190,1623,2963,32,2995,0,2995,922,3917,76.4616
第15任總統副總統,在新北市各村(里),新北市,　汐止區,白雲里,135,1110,1533,2778,30,2808,0,2808,957,3765,74.5817
第15任總統副總統,在新北市各村(里),新北市,　汐止區,茄苳里,104,1033,1536,2673,27,2700,0,2700,1095,3795,71.1462
第15任總統副總統,在新北市各村(里),新北市,　汐止區,崇德里,171,1221,1814,3206,39,3245,0,3245,1036,4281,75.8000
第15任總統副總統,在新北市各村(里),新北市,　汐止區,城中里,136,1342,1513,2991,22,3013,0,3013,875,3888,77.4949
第15任總統副總統,在新北市各村(里),新北市,　汐止區,橋東里,102,760,1074,1936,19,1955,0,1955,648,2603,75.1056
第15任總統副總統,在新北市各村(里),新北市,　汐止區,建成里,197,1547,1624,3368,33,3401,0,3401,1067,4468,76.1191
第15任總統副總統,在新北市各村(里),新北市,　汐止區,長安里,44,396,604,1044,11,1055,0,1055,376,1431,73.7247
第15任總統副總統,在新北市各村(里),新北市,　汐止區,保安里,38,357,664,1059,12,1071,0,1071,394,1465,73.1058
第15任總統副總統,在新北市各村(里),新北市,　汐止區,東山里,15,163,236,414,1,415,0,415,133,548,75.7299
第15任總統副總統,在新北市各村(里),新北市,　汐止區,保長里,127,1147,1691,2965,32,2997,0,2997,1005,4002,74.8876
第15任總統副總統,在新北市各村(里),新北市,　汐止區,保新里,94,848,864,1806,32,1838,1,1839,751,2590,70.9653
第15任總統副總統,在新北市各村(里),新北市,　汐止區,鄉長里,81,600,909,1590,17,1607,0,1607,444,2051,78.3520
第15任總統副總統,在新北市各村(里),新北市,　汐止區,江北里,176,1434,2165,3775,40,3815,0,3815,1501,5316,71.7645
第15任總統副總統,在新北市各村(里),新北市,　汐止區,拱北里,139,1260,1623,3022,32,3054,0,3054,1468,4522,67.5365
第15任總統副總統,在新北市各村(里),新北市,　汐止區,烘內里,46,447,568,1061,9,1070,0,1070,377,1447,73.9461
第15任總統副總統,在新北市各村(里),新北市,　汐止區,八連里,38,247,386,671,5,676,0,676,237,913,74.0416
第15任總統副總統,在新北市各村(里),新北市,　汐止區,長青里,41,326,300,667,11,678,0,678,223,901,75.2497
第15任總統副總統,在新北市各村(里),新北市,　汐止區,北峰里,128,1051,1807,2986,29,3015,0,3015,1131,4146,72.7207
第15任總統副總統,在新北市各村(里),新北市,　汐止區,金龍里,167,1338,1851,3356,32,3388,0,3388,1185,4573,74.0870
第15任總統副總統,在新北市各村(里),新北市,　汐止區,樟樹里,62,501,784,1347,16,1363,0,1363,558,1921,70.9526
第15任總統副總統,在新北市各村(里),新北市,　汐止區,忠孝里,247,2339,2756,5342,57,5399,0,5399,1898,7297,73.9893
第15任總統副總統,在新北市各村(里),新北市,　汐止區,厚德里,208,2126,2337,4671,41,4712,0,4712,1792,6504,72.4477
第15任總統副總統,在新北市各村(里),新北市,　汐止區,山光里,79,831,807,1717,14,1731,0,1731,702,2433,71.1467
第15任總統副總統,在新北市各村(里),新北市,　汐止區,中興里,217,1935,2817,4969,57,5026,0,5026,1860,6886,72.9887
第15任總統副總統,在新北市各村(里),新北市,　汐止區,福德里,86,812,1188,2086,18,2104,0,2104,785,2889,72.8280
第15任總統副總統,在新北市各村(里),新北市,　汐止區,興福里,91,898,1104,2093,30,2123,0,2123,674,2797,75.9028
第15任總統副總統,在新北市各村(里),新北市,　汐止區,康福里,169,1371,1752,3292,27,3319,0,3319,1261,4580,72.4672
第15任總統副總統,在新北市各村(里),新北市,　汐止區,湖光里,186,1806,2009,4001,44,4045,0,4045,1280,5325,75.9624
第15任總統副總統,在新北市各村(里),新北市,　汐止區,湖蓮里,100,990,736,1826,23,1849,0,1849,568,2417,76.4998
第15任總統副總統,在新北市各村(里),新北市,　汐止區,湖興里,188,2195,2021,4404,38,4442,0,4442,1369,5811,76.4412
第15任總統副總統,在新北市各村(里),新北市,　汐止區,北山里,201,1533,2115,3849,33,3882,0,3882,1148,5030,77.1769
第15任總統副總統,在新北市各村(里),新北市,　汐止區,忠山里,109,1249,1023,2381,33,2414,0,2414,699,3113,77.5458
第15任總統副總統,在新北市各村(里),新北市,　汐止區,環河里,35,284,530,849,7,856,0,856,270,1126,76.0213
第15任總統副總統,在新北市各村(里),新北市,　汐止區,橫科里,130,1330,1636,3096,38,3134,0,3134,1028,4162,75.3003
第15任總統副總統,在新北市各村(里),新北市,　汐止區,福山里,101,1120,1245,2466,26,2492,0,2492,856,3348,74.4325
第15任總統副總統,在新北市各村(里),新北市,　汐止區,宜興里,83,1053,898,2034,29,2063,1,2064,626,2690,76.6914
第15任總統副總統,在新北市各村(里),新北市,　汐止區,東勢里,110,1446,1393,2949,28,2977,0,2977,850,3827,77.7894
第15任總統副總統,在新北市各村(里),新北市,　瑞芳區,龍潭里,25,239,249,513,8,521,0,521,182,703,74.1110
第15任總統副總統,在新北市各村(里),新北市,　瑞芳區,龍興里,52,611,702,1365,13,1378,0,1378,442,1820,75.7143
第15任總統副總統,在新北市各村(里),新北市,　瑞芳區,龍鎮里,33,374,474,881,6,887,0,887,297,1184,74.9155
第15任總統副總統,在新北市各村(里),新北市,　瑞芳區,龍安里,17,192,210,419,10,429,0,429,162,591,72.5888
第15任總統副總統,在新北市各村(里),新北市,　瑞芳區,龍川里,50,475,597,1122,16,1138,0,1138,438,1576,72.2081
第15任總統副總統,在新北市各村(里),新北市,　瑞芳區,龍山里,43,427,453,923,10,933,0,933,358,1291,72.2696
第15任總統副總統,在新北市各村(里),新北市,　瑞芳區,爪峯里,107,1005,1327,2439,31,2470,0,2470,984,3454,71.5113
第15任總統副總統,在新北市各村(里),新北市,　瑞芳區,新峰里,86,859,1082,2027,8,2035,0,2035,886,2921,69.6679
第15任總統副總統,在新北市各村(里),新北市,　瑞芳區,東和里,51,455,561,1067,10,1077,0,1077,469,1546,69.6636
第15任總統副總統,在新北市各村(里),新北市,　瑞芳區,柑坪里,29,254,445,728,13,741,0,741,309,1050,70.5714
第15任總統副總統,在新北市各村(里),新北市,　瑞芳區,弓橋里,3,63,120,186,2,188,0,188,93,281,66.9039
第15任總統副總統,在新北市各村(里),新北市,　瑞芳區,猴硐里,19,114,167,300,1,301,0,301,157,458,65.7205
第15任總統副總統,在新北市各村(里),新北市,　瑞芳區,光復里,8,65,106,179,2,181,0,181,80,261,69.3487
第15任總統副總統,在新北市各村(里),新北市,　瑞芳區,碩仁里,5,42,54,101,0,101,0,101,46,147,68.7075
第15任總統副總統,在新北市各村(里),新北市,　瑞芳區,吉慶里,58,499,606,1163,18,1181,0,1181,482,1663,71.0162
第15任總統副總統,在新北市各村(里),新北市,　瑞芳區,吉安里,92,857,1068,2017,18,2035,0,2035,857,2892,70.3665
第15任總統副總統,在新北市各村(里),新北市,　瑞芳區,上天里,36,376,457,869,14,883,0,883,393,1276,69.2006
第15任總統副總統,在新北市各村(里),新北市,　瑞芳區,傑魚里,44,481,761,1286,10,1296,0,1296,547,1843,70.3201
第15任總統副總統,在新北市各村(里),新北市,　瑞芳區,基山里,6,118,147,271,3,274,0,274,146,420,65.2381
第15任總統副總統,在新北市各村(里),新北市,　瑞芳區,永慶里,7,112,141,260,4,264,0,264,171,435,60.6897
第15任總統副總統,在新北市各村(里),新北市,　瑞芳區,崇文里,8,82,102,192,1,193,0,193,114,307,62.8664
第15任總統副總統,在新北市各村(里),新北市,　瑞芳區,福住里,6,67,50,123,0,123,0,123,45,168,73.2143
第15任總統副總統,在新北市各村(里),新北市,　瑞芳區,頌德里,13,93,109,215,3,218,0,218,117,335,65.0746
第15任總統副總統,在新北市各村(里),新北市,　瑞芳區,瓜山里,5,70,54,129,0,129,0,129,43,172,75.0000
第15任總統副總統,在新北市各村(里),新北市,　瑞芳區,銅山里,8,50,75,133,3,136,0,136,50,186,73.1183
第15任總統副總統,在新北市各村(里),新北市,　瑞芳區,新山里,8,107,120,235,2,237,0,237,127,364,65.1099
第15任總統副總統,在新北市各村(里),新北市,　瑞芳區,石山里,6,120,80,206,4,210,0,210,117,327,64.2202
第15任總統副總統,在新北市各村(里),新北市,　瑞芳區,濓洞里,16,141,116,273,6,279,0,279,167,446,62.5561
第15任總統副總統,在新北市各村(里),新北市,　瑞芳區,濓新里,15,73,101,189,1,190,0,190,105,295,64.4068
第15任總統副總統,在新北市各村(里),新北市,　瑞芳區,南雅里,9,88,101,198,3,201,0,201,60,261,77.0115
第15任總統副總統,在新北市各村(里),新北市,　瑞芳區,鼻頭里,17,215,273,505,8,513,0,513,338,851,60.2820
第15任總統副總統,在新北市各村(里),新北市,　瑞芳區,海濱里,44,395,352,791,12,803,0,803,412,1215,66.0905
第15任總統副總統,在新北市各村(里),新北市,　瑞芳區,瑞濱里,55,549,625,1229,16,1245,0,1245,628,1873,66.4709
第15任總統副總統,在新北市各村(里),新北市,　瑞芳區,深澳里,42,404,353,799,7,806,0,806,471,1277,63.1167
第15任總統副總統,在新北市各村(里),新北市,　土城區,祖田里,59,327,702,1088,15,1103,0,1103,363,1466,75.2387
第15任總統副總統,在新北市各村(里),新北市,　土城區,頂新里,93,893,862,1848,16,1864,0,1864,571,2435,76.5503
第15任總統副總統,在新北市各村(里),新北市,　土城區,頂福里,167,1333,1835,3335,46,3381,0,3381,1151,4532,74.6028
第15任總統副總統,在新北市各村(里),新北市,　土城區,頂埔里,147,1230,1789,3166,26,3192,0,3192,1126,4318,73.9231
第15任總統副總統,在新北市各村(里),新北市,　土城區,沛陂里,175,1010,1796,2981,35,3016,0,3016,960,3976,75.8551
第15任總統副總統,在新北市各村(里),新北市,　土城區,永寧里,243,1853,2897,4993,58,5051,0,5051,1969,7020,71.9516
第15任總統副總統,在新北市各村(里),新北市,　土城區,大安里,130,1190,1858,3178,43,3221,1,3222,1011,4233,76.0926
第15任總統副總統,在新北市各村(里),新北市,　土城區,員仁里,163,1282,2049,3494,41,3535,0,3535,1269,4804,73.5845
第15任總統副總統,在新北市各村(里),新北市,　土城區,埤塘里,127,960,1474,2561,25,2586,0,2586,2366,4952,52.2213
第15任總統副總統,在新北市各村(里),新北市,　土城區,土城里,55,520,781,1356,18,1374,0,1374,444,1818,75.5776
第15任總統副總統,在新北市各村(里),新北市,　土城區,長風里,67,863,515,1445,17,1462,0,1462,315,1777,82.2735
第15任總統副總統,在新北市各村(里),新北市,　土城區,員信里,133,1101,1622,2856,32,2888,0,2888,946,3834,75.3260
第15任總統副總統,在新北市各村(里),新北市,　土城區,員林里,222,1585,2390,4197,51,4248,0,4248,1349,5597,75.8978
第15任總統副總統,在新北市各村(里),新北市,　土城區,員福里,175,1254,2065,3494,29,3523,0,3523,1271,4794,73.4877
第15任總統副總統,在新北市各村(里),新北市,　土城區,日和里,182,1224,2346,3752,50,3802,0,3802,1225,5027,75.6316
第15任總統副總統,在新北市各村(里),新北市,　土城區,日新里,126,1025,1891,3042,36,3078,0,3078,976,4054,75.9250
第15任總統副總統,在新北市各村(里),新北市,　土城區,裕生里,163,1254,2148,3565,57,3622,0,3622,1132,4754,76.1885
第15任總統副總統,在新北市各村(里),新北市,　土城區,貨饒里,125,939,1834,2898,42,2940,0,2940,926,3866,76.0476
第15任總統副總統,在新北市各村(里),新北市,　土城區,瑞興里,96,624,1288,2008,30,2038,0,2038,688,2726,74.7616
第15任總統副總統,在新北市各村(里),新北市,　土城區,復興里,147,1020,1812,2979,34,3013,0,3013,965,3978,75.7416
第15任總統副總統,在新北市各村(里),新北市,　土城區,廣福里,179,1451,2136,3766,49,3815,0,3815,1067,4882,78.1442
第15任總統副總統,在新北市各村(里),新北市,　土城區,學成里,87,727,1412,2226,26,2252,0,2252,574,2826,79.6886
第15任總統副總統,在新北市各村(里),新北市,　土城區,埤林里,226,2067,3216,5509,65,5574,0,5574,1666,7240,76.9890
第15任總統副總統,在新北市各村(里),新北市,　土城區,廣興里,116,832,1306,2254,38,2292,0,2292,661,2953,77.6160
第15任總統副總統,在新北市各村(里),新北市,　土城區,樂利里,138,1249,1953,3340,43,3383,0,3383,1103,4486,75.4124
第15任總統副總統,在新北市各村(里),新北市,　土城區,學府里,113,793,1388,2294,25,2319,0,2319,756,3075,75.4146
第15任總統副總統,在新北市各村(里),新北市,　土城區,明德里,182,1449,2180,3811,54,3865,0,3865,1134,4999,77.3155
第15任總統副總統,在新北市各村(里),新北市,　土城區,學士里,150,1198,1796,3144,40,3184,0,3184,875,4059,78.4430
第15任總統副總統,在新北市各村(里),新北市,　土城區,柑林里,118,783,1296,2197,25,2222,0,2222,675,2897,76.7000
第15任總統副總統,在新北市各村(里),新北市,　土城區,中正里,109,804,1210,2123,21,2144,0,2144,631,2775,77.2613
第15任總統副總統,在新北市各村(里),新北市,　土城區,青雲里,99,674,1172,1945,21,1966,0,1966,586,2552,77.0376
第15任總統副總統,在新北市各村(里),新北市,　土城區,清和里,155,1250,2449,3854,38,3892,0,3892,1551,5443,71.5047
第15任總統副總統,在新北市各村(里),新北市,　土城區,清化里,42,371,652,1065,9,1074,0,1074,352,1426,75.3156
第15任總統副總統,在新北市各村(里),新北市,　土城區,清溪里,203,1796,2444,4443,56,4499,0,4499,1464,5963,75.4486
第15任總統副總統,在新北市各村(里),新北市,　土城區,青山里,91,694,1129,1914,27,1941,0,1941,653,2594,74.8265
第15任總統副總統,在新北市各村(里),新北市,　土城區,清水里,241,1767,3176,5184,47,5231,0,5231,1765,6996,74.7713
第15任總統副總統,在新北市各村(里),新北市,　土城區,永豐里,138,1075,1571,2784,29,2813,0,2813,904,3717,75.6793
第15任總統副總統,在新北市各村(里),新北市,　土城區,永富里,184,1199,2015,3398,47,3445,0,3445,1217,4662,73.8953
第15任總統副總統,在新北市各村(里),新北市,　土城區,廷寮里,148,1071,1934,3153,33,3186,0,3186,1022,4208,75.7129
第15任總統副總統,在新北市各村(里),新北市,　土城區,金城里,203,1569,2037,3809,37,3846,0,3846,1399,5245,73.3270
第15任總統副總統,在新北市各村(里),新北市,　土城區,峯廷里,226,1601,2772,4599,58,4657,0,4657,1725,6382,72.9709
第15任總統副總統,在新北市各村(里),新北市,　土城區,延吉里,115,857,1720,2692,29,2721,0,2721,1046,3767,72.2325
第15任總統副總統,在新北市各村(里),新北市,　土城區,延壽里,123,1019,1691,2833,23,2856,0,2856,1031,3887,73.4757
第15任總統副總統,在新北市各村(里),新北市,　土城區,延祿里,116,919,1563,2598,26,2624,0,2624,1016,3640,72.0879
第15任總統副總統,在新北市各村(里),新北市,　土城區,平和里,229,1514,2792,4535,54,4589,0,4589,1430,6019,76.2419
第15任總統副總統,在新北市各村(里),新北市,　土城區,安和里,166,1026,2006,3198,40,3238,0,3238,1026,4264,75.9381
第15任總統副總統,在新北市各村(里),新北市,　土城區,延和里,207,1509,2473,4189,51,4240,0,4240,1392,5632,75.2841
第15任總統副總統,在新北市各村(里),新北市,　蘆洲區,光華里,161,1099,2143,3403,31,3434,0,3434,1127,4561,75.2905
第15任總統副總統,在新北市各村(里),新北市,　蘆洲區,光明里,146,870,2008,3024,39,3063,0,3063,1118,4181,73.2600
第15任總統副總統,在新北市各村(里),新北市,　蘆洲區,中路里,125,789,1712,2626,25,2651,0,2651,884,3535,74.9929
第15任總統副總統,在新北市各村(里),新北市,　蘆洲區,永安里,137,1015,2184,3336,35,3371,0,3371,1115,4486,75.1449
第15任總統副總統,在新北市各村(里),新北市,　蘆洲區,九芎里,173,1016,2203,3392,36,3428,0,3428,1260,4688,73.1229
第15任總統副總統,在新北市各村(里),新北市,　蘆洲區,延平里,123,706,1785,2614,32,2646,0,2646,896,3542,74.7036
第15任總統副總統,在新北市各村(里),新北市,　蘆洲區,中華里,92,644,1390,2126,22,2148,0,2148,681,2829,75.9279
第15任總統副總統,在新北市各村(里),新北市,　蘆洲區,中原里,173,1117,2360,3650,44,3694,0,3694,1285,4979,74.1916
第15任總統副總統,在新北市各村(里),新北市,　蘆洲區,長安里,135,842,2203,3180,21,3201,0,3201,1215,4416,72.4864
第15任總統副總統,在新北市各村(里),新北市,　蘆洲區,忠義里,118,637,1342,2097,24,2121,0,2121,688,2809,75.5073
第15任總統副總統,在新北市各村(里),新北市,　蘆洲區,正義里,431,2730,5119,8280,72,8352,1,8353,2237,10590,78.8669
第15任總統副總統,在新北市各村(里),新北市,　蘆洲區,南港里,149,1090,2453,3692,43,3735,0,3735,1242,4977,75.0452
第15任總統副總統,在新北市各村(里),新北市,　蘆洲區,永樂里,167,1206,2570,3943,44,3987,0,3987,1276,5263,75.7553
第15任總統副總統,在新北市各村(里),新北市,　蘆洲區,成功里,179,1372,3194,4745,60,4805,0,4805,1654,6459,74.3923
第15任總統副總統,在新北市各村(里),新北市,　蘆洲區,永康里,164,1206,2819,4189,49,4238,0,4238,1459,5697,74.3900
第15任總統副總統,在新北市各村(里),新北市,　蘆洲區,永德里,125,861,1901,2887,41,2928,0,2928,995,3923,74.6368
第15任總統副總統,在新北市各村(里),新北市,　蘆洲區,樓厝里,193,1371,2556,4120,58,4178,0,4178,1289,5467,76.4222
第15任總統副總統,在新北市各村(里),新北市,　蘆洲區,信義里,123,760,1682,2565,30,2595,0,2595,882,3477,74.6333
第15任總統副總統,在新北市各村(里),新北市,　蘆洲區,玉清里,184,1225,2316,3725,42,3767,0,3767,1228,4995,75.4154
第15任總統副總統,在新北市各村(里),新北市,　蘆洲區,復興里,102,578,1581,2261,26,2287,0,2287,757,3044,75.1314
第15任總統副總統,在新北市各村(里),新北市,　蘆洲區,福安里,96,632,1404,2132,29,2161,0,2161,657,2818,76.6856
第15任總統副總統,在新北市各村(里),新北市,　蘆洲區,鷺江里,173,1057,2228,3458,44,3502,0,3502,1146,4648,75.3442
第15任總統副總統,在新北市各村(里),新北市,　蘆洲區,恆德里,178,1345,2414,3937,47,3984,0,3984,1421,5405,73.7095
第15任總統副總統,在新北市各村(里),新北市,　蘆洲區,溪墘里,92,624,1391,2107,18,2125,0,2125,620,2745,77.4135
第15任總統副總統,在新北市各村(里),新北市,　蘆洲區,仁復里,47,472,875,1394,17,1411,0,1411,459,1870,75.4545
第15任總統副總統,在新北市各村(里),新北市,　蘆洲區,仁德里,141,1075,2355,3571,38,3609,0,3609,1112,4721,76.4457
第15任總統副總統,在新北市各村(里),新北市,　蘆洲區,仁義里,119,865,1822,2806,31,2837,0,2837,1980,4817,58.8956
第15任總統副總統,在新北市各村(里),新北市,　蘆洲區,得勝里,85,675,1342,2102,34,2136,1,2137,782,2919,73.1757
第15任總統副總統,在新北市各村(里),新北市,　蘆洲區,得仁里,100,601,1299,2000,19,2019,0,2019,625,2644,76.3616
第15任總統副總統,在新北市各村(里),新北市,　蘆洲區,保和里,69,521,1071,1661,25,1686,0,1686,527,2213,76.1862
第15任總統副總統,在新北市各村(里),新北市,　蘆洲區,樹德里,103,704,1400,2207,20,2227,0,2227,671,2898,76.8461
第15任總統副總統,在新北市各村(里),新北市,　蘆洲區,民和里,86,584,1125,1795,18,1813,0,1813,555,2368,76.5625
第15任總統副總統,在新北市各村(里),新北市,　蘆洲區,水河里,261,1792,3943,5996,64,6060,0,6060,2044,8104,74.7779
第15任總統副總統,在新北市各村(里),新北市,　蘆洲區,水湳里,311,1929,4283,6523,76,6599,0,6599,2187,8786,75.1081
第15任總統副總統,在新北市各村(里),新北市,　蘆洲區,仁愛里,175,995,2270,3440,49,3489,0,3489,1057,4546,76.7488
第15任總統副總統,在新北市各村(里),新北市,　蘆洲區,忠孝里,72,409,1134,1615,17,1632,0,1632,492,2124,76.8362
第15任總統副總統,在新北市各村(里),新北市,　蘆洲區,保佑里,112,768,1592,2472,38,2510,0,2510,752,3262,76.9467
第15任總統副總統,在新北市各村(里),新北市,　蘆洲區,保新里,84,693,1389,2166,25,2191,0,2191,768,2959,74.0453
第15任總統副總統,在新北市各村(里),新北市,　五股區,興珍里,118,751,2161,3030,40,3070,0,3070,1021,4091,75.0428
第15任總統副總統,在新北市各村(里),新北市,　五股區,更寮里,31,158,627,816,8,824,0,824,249,1073,76.7940
第15任總統副總統,在新北市各村(里),新北市,　五股區,觀音里,24,251,617,892,11,903,0,903,340,1243,72.6468
第15任總統副總統,在新北市各村(里),新北市,　五股區,集福里,105,813,1583,2501,21,2522,0,2522,860,3382,74.5713
第15任總統副總統,在新北市各村(里),新北市,　五股區,集賢里,117,706,1648,2471,22,2493,0,2493,896,3389,73.5615
第15任總統副總統,在新北市各村(里),新北市,　五股區,成德里,93,588,1344,2025,28,2053,0,2053,766,2819,72.8272
第15任總統副總統,在新北市各村(里),新北市,　五股區,成州里,166,1131,2445,3742,45,3787,0,3787,1417,5204,72.7709
第15任總統副總統,在新北市各村(里),新北市,　五股區,成功里,192,1204,2583,3979,47,4026,0,4026,1534,5560,72.4101
第15任總統副總統,在新北市各村(里),新北市,　五股區,成泰里,322,1985,3743,6050,57,6107,0,6107,2240,8347,73.1640
第15任總統副總統,在新北市各村(里),新北市,　五股區,五龍里,23,205,685,913,12,925,0,925,299,1224,75.5719
第15任總統副總統,在新北市各村(里),新北市,　五股區,五福里,105,716,1412,2233,26,2259,0,2259,764,3023,74.7271
第15任總統副總統,在新北市各村(里),新北市,　五股區,六福里,114,890,1409,2413,26,2439,0,2439,887,3326,73.3313
第15任總統副總統,在新北市各村(里),新北市,　五股區,民義里,110,823,1364,2297,16,2313,0,2313,739,3052,75.7864
第15任總統副總統,在新北市各村(里),新北市,　五股區,五股里,102,839,1552,2493,32,2525,0,2525,1312,3837,65.8066
第15任總統副總統,在新北市各村(里),新北市,　五股區,德音里,177,1202,1969,3348,32,3380,0,3380,1135,4515,74.8616
第15任總統副總統,在新北市各村(里),新北市,　五股區,水碓里,205,1565,3119,4889,61,4950,0,4950,1747,6697,73.9137
第15任總統副總統,在新北市各村(里),新北市,　五股區,福德里,101,689,1198,1988,21,2009,0,2009,827,2836,70.8392
第15任總統副總統,在新北市各村(里),新北市,　五股區,德泰里,131,1027,1706,2864,24,2888,0,2888,922,3810,75.8005
第15任總統副總統,在新北市各村(里),新北市,　五股區,貿商里,88,1229,688,2005,22,2027,0,2027,598,2625,77.2190
第15任總統副總統,在新北市各村(里),新北市,　五股區,陸一里,67,1197,429,1693,25,1718,0,1718,548,2266,75.8164
第15任總統副總統,在新北市各村(里),新北市,　泰山區,大科里,28,182,390,600,9,609,0,609,189,798,76.3158
第15任總統副總統,在新北市各村(里),新北市,　泰山區,黎明里,114,737,1350,2201,28,2229,0,2229,760,2989,74.5734
第15任總統副總統,在新北市各村(里),新北市,　泰山區,山腳里,158,1514,2489,4161,59,4220,0,4220,1586,5806,72.6834
第15任總統副總統,在新北市各村(里),新北市,　泰山區,福泰里,84,655,1067,1806,19,1825,0,1825,620,2445,74.6421
第15任總統副總統,在新北市各村(里),新北市,　泰山區,福興里,90,852,1329,2271,35,2306,0,2306,742,3048,75.6562
第15任總統副總統,在新北市各村(里),新北市,　泰山區,楓樹里,138,974,1697,2809,42,2851,0,2851,968,3819,74.6531
第15任總統副總統,在新北市各村(里),新北市,　泰山區,同榮里,97,1081,1484,2662,39,2701,0,2701,819,3520,76.7330
第15任總統副總統,在新北市各村(里),新北市,　泰山區,同興里,84,789,1516,2389,28,2417,0,2417,721,3138,77.0236
第15任總統副總統,在新北市各村(里),新北市,　泰山區,全興里,249,1854,3024,5127,60,5187,0,5187,1991,7178,72.2625
第15任總統副總統,在新北市各村(里),新北市,　泰山區,義學里,121,1027,1880,3028,36,3064,0,3064,961,4025,76.1242
第15任總統副總統,在新北市各村(里),新北市,　泰山區,義仁里,253,1805,3278,5336,59,5395,0,5395,1725,7120,75.7725
第15任總統副總統,在新北市各村(里),新北市,　泰山區,明志里,101,886,1443,2430,28,2458,0,2458,762,3220,76.3354
第15任總統副總統,在新北市各村(里),新北市,　泰山區,泰友里,63,524,860,1447,25,1472,0,1472,434,1906,77.2298
第15任總統副總統,在新北市各村(里),新北市,　泰山區,新明里,85,764,1282,2131,18,2149,0,2149,685,2834,75.8292
第15任總統副總統,在新北市各村(里),新北市,　泰山區,貴子里,126,922,1568,2616,15,2631,0,2631,832,3463,75.9746
第15任總統副總統,在新北市各村(里),新北市,　泰山區,貴賢里,126,988,1403,2517,28,2545,0,2545,709,3254,78.2114
第15任總統副總統,在新北市各村(里),新北市,　泰山區,貴和里,135,1161,1858,3154,33,3187,0,3187,1061,4248,75.0235
第15任總統副總統,在新北市各村(里),新北市,　林口區,東林里,123,869,1554,2546,25,2571,0,2571,941,3512,73.2062
第15任總統副總統,在新北市各村(里),新北市,　林口區,林口里,165,1259,2016,3440,35,3475,0,3475,1238,4713,73.7322
第15任總統副總統,在新北市各村(里),新北市,　林口區,西林里,338,2526,3531,6395,53,6448,0,6448,2347,8795,73.3144
第15任總統副總統,在新北市各村(里),新北市,　林口區,菁湖里,121,952,1743,2816,29,2845,0,2845,884,3729,76.2939
第15任總統副總統,在新北市各村(里),新北市,　林口區,中湖里,125,920,1707,2752,32,2784,0,2784,963,3747,74.2994
第15任總統副總統,在新北市各村(里),新北市,　林口區,湖北里,29,303,708,1040,7,1047,0,1047,300,1347,77.7283
第15任總統副總統,在新北市各村(里),新北市,　林口區,湖南里,733,5815,7012,13560,132,13692,0,13692,4700,18392,74.4454
第15任總統副總統,在新北市各村(里),新北市,　林口區,南勢里,733,5505,6561,12799,141,12940,0,12940,4220,17160,75.4079
第15任總統副總統,在新北市各村(里),新北市,　林口區,仁愛里,262,1865,2165,4292,31,4323,2,4325,1425,5750,75.1826
第15任總統副總統,在新北市各村(里),新北市,　林口區,麗林里,326,2245,2696,5267,72,5339,1,5340,1815,7155,74.6191
第15任總統副總統,在新北市各村(里),新北市,　林口區,東勢里,228,1787,2239,4254,44,4298,0,4298,1343,5641,76.1922
第15任總統副總統,在新北市各村(里),新北市,　林口區,麗園里,133,1069,1476,2678,38,2716,0,2716,809,3525,77.0496
第15任總統副總統,在新北市各村(里),新北市,　林口區,頂福里,29,154,516,699,10,709,0,709,280,989,71.6886
第15任總統副總統,在新北市各村(里),新北市,　林口區,下福里,49,306,539,894,6,900,0,900,270,1170,76.9231
第15任總統副總統,在新北市各村(里),新北市,　林口區,嘉寶里,30,163,489,682,6,688,0,688,189,877,78.4493
第15任總統副總統,在新北市各村(里),新北市,　林口區,瑞平里,25,150,379,554,6,560,0,560,214,774,72.3514
第15任總統副總統,在新北市各村(里),新北市,　林口區,太平里,52,252,722,1026,10,1036,0,1036,331,1367,75.7864
第15任總統副總統,在新北市各村(里),新北市,　深坑區,萬順里,52,662,943,1657,13,1670,0,1670,571,2241,74.5203
第15任總統副總統,在新北市各村(里),新北市,　深坑區,萬福里,74,758,978,1810,20,1830,0,1830,592,2422,75.5574
第15任總統副總統,在新北市各村(里),新北市,　深坑區,土庫里,98,800,1075,1973,21,1994,0,1994,670,2664,74.8498
第15任總統副總統,在新北市各村(里),新北市,　深坑區,深坑里,84,918,1217,2219,24,2243,0,2243,731,2974,75.4203
第15任總統副總統,在新北市各村(里),新北市,　深坑區,埔新里,169,1712,2128,4009,36,4045,0,4045,1374,5419,74.6448
第15任總統副總統,在新北市各村(里),新北市,　深坑區,昇高里,63,632,718,1413,17,1430,0,1430,451,1881,76.0234
第15任總統副總統,在新北市各村(里),新北市,　深坑區,賴仲里,61,737,747,1545,21,1566,0,1566,481,2047,76.5022
第15任總統副總統,在新北市各村(里),新北市,　深坑區,阿柔里,16,155,246,417,2,419,0,419,120,539,77.7365
第15任總統副總統,在新北市各村(里),新北市,　石碇區,石碇里,17,113,165,295,2,297,0,297,84,381,77.9528
第15任總統副總統,在新北市各村(里),新北市,　石碇區,潭邊里,18,214,322,554,10,564,0,564,205,769,73.3420
第15任總統副總統,在新北市各村(里),新北市,　石碇區,烏塗里,6,127,325,458,9,467,0,467,177,644,72.5155
第15任總統副總統,在新北市各村(里),新北市,　石碇區,彭山里,3,92,108,203,1,204,0,204,91,295,69.1525
第15任總統副總統,在新北市各村(里),新北市,　石碇區,豐田里,9,102,159,270,3,273,0,273,98,371,73.5849
第15任總統副總統,在新北市各村(里),新北市,　石碇區,隆盛里,8,151,271,430,6,436,0,436,211,647,67.3879
第15任總統副總統,在新北市各村(里),新北市,　石碇區,豐林里,10,83,126,219,1,220,0,220,77,297,74.0741
第15任總統副總統,在新北市各村(里),新北市,　石碇區,中民里,25,167,290,482,5,487,0,487,215,702,69.3732
第15任總統副總統,在新北市各村(里),新北市,　石碇區,永定里,22,116,248,386,2,388,0,388,187,575,67.4783
第15任總統副總統,在新北市各村(里),新北市,　石碇區,光明里,7,59,133,199,3,202,0,202,68,270,74.8148
第15任總統副總統,在新北市各村(里),新北市,　石碇區,永安里,20,169,389,578,4,582,0,582,201,783,74.3295
第15任總統副總統,在新北市各村(里),新北市,　石碇區,格頭里,26,199,499,724,6,730,0,730,204,934,78.1585
第15任總統副總統,在新北市各村(里),新北市,　坪林區,坪林里,36,295,598,929,16,945,0,945,304,1249,75.6605
第15任總統副總統,在新北市各村(里),新北市,　坪林區,水德里,9,164,268,441,8,449,0,449,161,610,73.6066
第15任總統副總統,在新北市各村(里),新北市,　坪林區,大林里,23,219,524,766,8,774,0,774,352,1126,68.7389
第15任總統副總統,在新北市各村(里),新北市,　坪林區,石𥕢里,9,79,192,280,1,281,0,281,131,412,68.2039
第15任總統副總統,在新北市各村(里),新北市,　坪林區,粗窟里,23,239,390,652,7,659,0,659,191,850,77.5294
第15任總統副總統,在新北市各村(里),新北市,　坪林區,上德里,20,216,308,544,4,548,0,548,246,794,69.0176
第15任總統副總統,在新北市各村(里),新北市,　坪林區,漁光里,12,150,408,570,3,573,0,573,270,843,67.9715
第15任總統副總統,在新北市各村(里),新北市,　三芝區,八賢里,7,65,132,204,2,206,0,206,99,305,67.5410
第15任總統副總統,在新北市各村(里),新北市,　三芝區,埔頭里,155,1269,1774,3198,40,3238,0,3238,1438,4676,69.2472
第15任總統副總統,在新北市各村(里),新北市,　三芝區,古庄里,24,333,395,752,3,755,0,755,317,1072,70.4291
第15任總統副總統,在新北市各村(里),新北市,　三芝區,新庄里,14,236,287,537,6,543,0,543,213,756,71.8254
第15任總統副總統,在新北市各村(里),新北市,　三芝區,埔坪里,143,1716,2110,3969,52,4021,0,4021,1902,5923,67.8879
第15任總統副總統,在新北市各村(里),新北市,　三芝區,茂長里,21,197,257,475,6,481,0,481,131,612,78.5948
第15任總統副總統,在新北市各村(里),新北市,　三芝區,橫山里,17,170,153,340,9,349,0,349,147,496,70.3629
第15任總統副總統,在新北市各村(里),新北市,　三芝區,錫板里,12,185,289,486,3,489,0,489,181,670,72.9851
第15任總統副總統,在新北市各村(里),新北市,　三芝區,後厝里,50,683,653,1386,6,1392,0,1392,651,2043,68.1351
第15任總統副總統,在新北市各村(里),新北市,　三芝區,福德里,15,231,290,536,9,545,0,545,203,748,72.8610
第15任總統副總統,在新北市各村(里),新北市,　三芝區,圓山里,12,124,217,353,7,360,0,360,155,515,69.9029
第15任總統副總統,在新北市各村(里),新北市,　三芝區,店子里,11,121,262,394,14,408,0,408,164,572,71.3287
第15任總統副總統,在新北市各村(里),新北市,　三芝區,興華里,31,275,540,846,7,853,0,853,312,1165,73.2189
第15任總統副總統,在新北市各村(里),新北市,　石門區,德茂里,25,275,440,740,8,748,0,748,328,1076,69.5167
第15任總統副總統,在新北市各村(里),新北市,　石門區,富基里,35,376,509,920,13,933,0,933,370,1303,71.6040
第15任總統副總統,在新北市各村(里),新北市,　石門區,老梅里,42,532,814,1388,23,1411,0,1411,657,2068,68.2302
第15任總統副總統,在新北市各村(里),新北市,　石門區,山溪里,25,254,318,597,8,605,0,605,252,857,70.5951
第15任總統副總統,在新北市各村(里),新北市,　石門區,石門里,42,476,537,1055,10,1065,0,1065,426,1491,71.4286
第15任總統副總統,在新北市各村(里),新北市,　石門區,尖鹿里,38,393,569,1000,12,1012,0,1012,413,1425,71.0175
第15任總統副總統,在新北市各村(里),新北市,　石門區,乾華里,7,86,111,204,3,207,0,207,113,320,64.6875
第15任總統副總統,在新北市各村(里),新北市,　石門區,茂林里,11,190,231,432,4,436,0,436,188,624,69.8718
第15任總統副總統,在新北市各村(里),新北市,　石門區,草里里,24,289,308,621,9,630,0,630,267,897,70.2341
第15任總統副總統,在新北市各村(里),新北市,　八里區,龍源里,194,1972,2635,4801,53,4854,0,4854,1681,6535,74.2770
第15任總統副總統,在新北市各村(里),新北市,　八里區,米倉里,121,839,1275,2235,28,2263,0,2263,930,3193,70.8738
第15任總統副總統,在新北市各村(里),新北市,　八里區,大崁里,108,763,1303,2174,15,2189,0,2189,723,2912,75.1717
第15任總統副總統,在新北市各村(里),新北市,　八里區,埤頭里,97,872,1516,2485,24,2509,0,2509,955,3464,72.4307
第15任總統副總統,在新北市各村(里),新北市,　八里區,頂罟里,58,477,839,1374,20,1394,0,1394,582,1976,70.5466
第15任總統副總統,在新北市各村(里),新北市,　八里區,舊城里,204,1565,2584,4353,51,4404,0,4404,1848,6252,70.4415
第15任總統副總統,在新北市各村(里),新北市,　八里區,訊塘里,133,1061,1550,2744,31,2775,0,2775,1044,3819,72.6630
第15任總統副總統,在新北市各村(里),新北市,　八里區,荖阡里,56,394,677,1127,13,1140,0,1140,451,1591,71.6530
第15任總統副總統,在新北市各村(里),新北市,　八里區,長坑里,47,368,635,1050,11,1061,0,1061,432,1493,71.0650
第15任總統副總統,在新北市各村(里),新北市,　八里區,下罟里,65,425,562,1052,15,1067,0,1067,367,1434,74.4073
第15任總統副總統,在新北市各村(里),新北市,　平溪區,薯榔里,3,89,165,257,3,260,0,260,115,375,69.3333
第15任總統副總統,在新北市各村(里),新北市,　平溪區,菁桐里,5,71,77,153,3,156,0,156,69,225,69.3333
第15任總統副總統,在新北市各村(里),新北市,　平溪區,白石里,6,63,115,184,1,185,0,185,52,237,78.0591
第15任總統副總統,在新北市各村(里),新北市,　平溪區,石底里,11,97,197,305,6,311,0,311,125,436,71.3303
第15任總統副總統,在新北市各村(里),新北市,　平溪區,平溪里,7,89,72,168,2,170,0,170,62,232,73.2759
第15任總統副總統,在新北市各村(里),新北市,　平溪區,嶺腳里,11,158,217,386,4,390,0,390,206,596,65.4362
第15任總統副總統,在新北市各村(里),新北市,　平溪區,東勢里,10,138,148,296,2,298,0,298,117,415,71.8072
第15任總統副總統,在新北市各村(里),新北市,　平溪區,十分里,27,224,282,533,6,539,0,539,271,810,66.5432
第15任總統副總統,在新北市各村(里),新北市,　平溪區,望古里,3,35,59,97,0,97,0,97,54,151,64.2384
第15任總統副總統,在新北市各村(里),新北市,　平溪區,南山里,8,99,128,235,1,236,0,236,114,350,67.4286
第15任總統副總統,在新北市各村(里),新北市,　平溪區,新寮里,3,54,60,117,0,117,0,117,36,153,76.4706
第15任總統副總統,在新北市各村(里),新北市,　平溪區,平湖里,3,57,78,138,0,138,0,138,42,180,76.6667
第15任總統副總統,在新北市各村(里),新北市,　雙溪區,雙溪里,7,155,144,306,4,310,0,310,134,444,69.8198
第15任總統副總統,在新北市各村(里),新北市,　雙溪區,新基里,12,260,250,522,6,528,1,529,198,727,72.6272
第15任總統副總統,在新北市各村(里),新北市,　雙溪區,三港里,4,95,130,229,3,232,0,232,131,363,63.9118
第15任總統副總統,在新北市各村(里),新北市,　雙溪區,牡丹里,32,394,545,971,15,986,0,986,499,1485,66.3973
第15任總統副總統,在新北市各村(里),新北市,　雙溪區,三貂里,7,89,108,204,2,206,0,206,117,323,63.7771
第15任總統副總統,在新北市各村(里),新北市,　雙溪區,平林里,24,262,314,600,4,604,0,604,266,870,69.4253
第15任總統副總統,在新北市各村(里),新北市,　雙溪區,上林里,12,155,263,430,5,435,1,436,182,618,70.3883
第15任總統副總統,在新北市各村(里),新北市,　雙溪區,外柑里,12,113,152,277,1,278,0,278,129,407,68.3047
第15任總統副總統,在新北市各村(里),新北市,　雙溪區,長源里,10,60,149,219,4,223,0,223,139,362,61.6022
第15任總統副總統,在新北市各村(里),新北市,　雙溪區,共和里,10,113,120,243,4,247,0,247,117,364,67.8571
第15任總統副總統,在新北市各村(里),新北市,　雙溪區,魚行里,23,183,245,451,4,455,0,455,246,701,64.9073
第15任總統副總統,在新北市各村(里),新北市,　雙溪區,泰平里,38,286,395,719,3,722,0,722,356,1078,66.9759
第15任總統副總統,在新北市各村(里),新北市,　貢寮區,貢寮里,24,195,316,535,9,544,0,544,286,830,65.5422
第15任總統副總統,在新北市各村(里),新北市,　貢寮區,龍崗里,8,77,175,260,1,261,0,261,151,412,63.3495
第15任總統副總統,在新北市各村(里),新北市,　貢寮區,吉林里,18,126,196,340,5,345,0,345,134,479,72.0251
第15任總統副總統,在新北市各村(里),新北市,　貢寮區,雙玉里,14,137,280,431,3,434,0,434,223,657,66.0578
第15任總統副總統,在新北市各村(里),新北市,　貢寮區,福連里,12,175,374,561,6,567,0,567,318,885,64.0678
第15任總統副總統,在新北市各村(里),新北市,　貢寮區,福隆里,38,379,612,1029,3,1032,0,1032,544,1576,65.4822
第15任總統副總統,在新北市各村(里),新北市,　貢寮區,龍門里,8,122,301,431,6,437,0,437,219,656,66.6159
第15任總統副總統,在新北市各村(里),新北市,　貢寮區,真理里,27,257,960,1244,14,1258,0,1258,729,1987,63.3115
第15任總統副總統,在新北市各村(里),新北市,　貢寮區,仁里里,44,330,755,1129,9,1138,0,1138,498,1636,69.5599
第15任總統副總統,在新北市各村(里),新北市,　貢寮區,美豐里,13,147,310,470,6,476,0,476,245,721,66.0194
第15任總統副總統,在新北市各村(里),新北市,　貢寮區,和美里,28,168,442,638,8,646,0,646,334,980,65.9184
第15任總統副總統,在新北市各村(里),新北市,　金山區,和平里,15,160,175,350,6,356,0,356,104,460,77.3913
第15任總統副總統,在新北市各村(里),新北市,　金山區,大同里,18,200,245,463,6,469,0,469,229,698,67.1920
第15任總統副總統,在新北市各村(里),新北市,　金山區,豐漁里,8,116,208,332,1,333,0,333,159,492,67.6829
第15任總統副總統,在新北市各村(里),新北市,　金山區,磺港里,33,362,777,1172,10,1182,0,1182,530,1712,69.0421
第15任總統副總統,在新北市各村(里),新北市,　金山區,金美里,114,1243,2015,3372,23,3395,0,3395,1461,4856,69.9135
第15任總統副總統,在新北市各村(里),新北市,　金山區,五湖里,53,467,691,1211,19,1230,0,1230,415,1645,74.7720
第15任總統副總統,在新北市各村(里),新北市,　金山區,美田里,106,954,1518,2578,19,2597,0,2597,1052,3649,71.1702
第15任總統副總統,在新北市各村(里),新北市,　金山區,重和里,32,284,473,789,12,801,0,801,377,1178,67.9966
第15任總統副總統,在新北市各村(里),新北市,　金山區,兩湖里,15,95,173,283,2,285,0,285,92,377,75.5968
第15任總統副總統,在新北市各村(里),新北市,　金山區,六股里,7,162,303,472,5,477,0,477,162,639,74.6479
第15任總統副總統,在新北市各村(里),新北市,　金山區,三界里,20,139,278,437,6,443,0,443,181,624,70.9936
第15任總統副總統,在新北市各村(里),新北市,　金山區,萬壽里,12,93,192,297,5,302,0,302,134,436,69.2661
第15任總統副總統,在新北市各村(里),新北市,　金山區,清泉里,16,215,314,545,13,558,0,558,243,801,69.6629
第15任總統副總統,在新北市各村(里),新北市,　金山區,西湖里,2,58,86,146,1,147,0,147,37,184,79.8913
第15任總統副總統,在新北市各村(里),新北市,　金山區,永興里,14,145,216,375,1,376,0,376,192,568,66.1972
第15任總統副總統,在新北市各村(里),新北市,　萬里區,萬里里,106,1156,1681,2943,30,2973,0,2973,1194,4167,71.3463
第15任總統副總統,在新北市各村(里),新北市,　萬里區,北基里,76,814,844,1734,16,1750,0,1750,980,2730,64.1026
第15任總統副總統,在新北市各村(里),新北市,　萬里區,龜吼里,52,686,919,1657,19,1676,0,1676,807,2483,67.4990
第15任總統副總統,在新北市各村(里),新北市,　萬里區,野柳里,58,840,1251,2149,21,2170,0,2170,957,3127,69.3956
第15任總統副總統,在新北市各村(里),新北市,　萬里區,大鵬里,68,791,1020,1879,21,1900,0,1900,717,2617,72.6022
第15任總統副總統,在新北市各村(里),新北市,　萬里區,磺潭里,17,173,206,396,2,398,0,398,176,574,69.3380
第15任總統副總統,在新北市各村(里),新北市,　萬里區,雙興里,29,238,421,688,8,696,0,696,254,950,73.2632
第15任總統副總統,在新北市各村(里),新北市,　萬里區,溪底里,13,143,288,444,4,448,0,448,203,651,68.8172
第15任總統副總統,在新北市各村(里),新北市,　萬里區,崁脚里,17,91,167,275,2,277,0,277,123,400,69.2500
第15任總統副總統,在新北市各村(里),新北市,　萬里區,中幅里,26,274,416,716,6,722,0,722,335,1057,68.3065
第15任總統副總統,在新北市各村(里),新北市,　烏來區,忠治里,62,604,487,1153,5,1158,0,1158,364,1522,76.0841
第15任總統副總統,在新北市各村(里),新北市,　烏來區,烏來里,85,817,742,1644,14,1658,0,1658,654,2312,71.7128
第15任總統副總統,在新北市各村(里),新北市,　烏來區,孝義里,3,63,112,178,4,182,0,182,51,233,78.1116
第15任總統副總統,在新北市各村(里),新北市,　烏來區,信賢里,11,158,172,341,6,347,0,347,136,483,71.8427
第15任總統副總統,在新北市各村(里),新北市,　烏來區,福山里,12,252,110,374,8,382,0,382,221,603,63.3499
第15任總統副總統,在臺東縣各村(里),臺東縣,　臺東市,文化里,17,241,235,493,3,496,0,496,353,849,58.4217
第15任總統副總統,在臺東縣各村(里),臺東縣,　臺東市,民族里,44,447,511,1002,9,1011,0,1011,347,1358,74.4477
第15任總統副總統,在臺東縣各村(里),臺東縣,　臺東市,自強里,108,1502,1217,2827,28,2855,0,2855,1017,3872,73.7345
第15任總統副總統,在臺東縣各村(里),臺東縣,　臺東市,民生里,64,1118,1026,2208,18,2226,0,2226,788,3014,73.8553
第15任總統副總統,在臺東縣各村(里),臺東縣,　臺東市,寶桑里,28,282,265,575,5,580,0,580,243,823,70.4739
第15任總統副總統,在臺東縣各村(里),臺東縣,　臺東市,民權里,24,286,282,592,10,602,0,602,246,848,70.9906
第15任總統副總統,在臺東縣各村(里),臺東縣,　臺東市,四維里,14,261,153,428,5,433,0,433,216,649,66.7180
第15任總統副總統,在臺東縣各村(里),臺東縣,　臺東市,中華里,42,515,534,1091,9,1100,0,1100,526,1626,67.6507
第15任總統副總統,在臺東縣各村(里),臺東縣,　臺東市,仁愛里,16,224,233,473,5,478,0,478,216,694,68.8761
第15任總統副總統,在臺東縣各村(里),臺東縣,　臺東市,強國里,18,199,219,436,1,437,0,437,172,609,71.7570
第15任總統副總統,在臺東縣各村(里),臺東縣,　臺東市,大同里,22,260,223,505,10,515,0,515,223,738,69.7832
第15任總統副總統,在臺東縣各村(里),臺東縣,　臺東市,成功里,22,239,268,529,3,532,0,532,210,742,71.6981
第15任總統副總統,在臺東縣各村(里),臺東縣,　臺東市,建國里,37,407,372,816,13,829,0,829,416,1245,66.5863
第15任總統副總統,在臺東縣各村(里),臺東縣,　臺東市,中正里,13,259,303,575,6,581,0,581,199,780,74.4872
第15任總統副總統,在臺東縣各村(里),臺東縣,　臺東市,中山里,14,266,276,556,4,560,0,560,179,739,75.7781
第15任總統副總統,在臺東縣各村(里),臺東縣,　臺東市,興國里,20,232,276,528,1,529,0,529,205,734,72.0708
第15任總統副總統,在臺東縣各村(里),臺東縣,　臺東市,鐵花里,11,112,167,290,4,294,0,294,105,399,73.6842
第15任總統副總統,在臺東縣各村(里),臺東縣,　臺東市,東海里,64,1028,814,1906,18,1924,0,1924,747,2671,72.0329
第15任總統副總統,在臺東縣各村(里),臺東縣,　臺東市,復國里,15,210,157,382,2,384,0,384,192,576,66.6667
第15任總統副總統,在臺東縣各村(里),臺東縣,　臺東市,復興里,10,148,124,282,0,282,0,282,149,431,65.4292
第15任總統副總統,在臺東縣各村(里),臺東縣,　臺東市,新興里,26,338,286,650,4,654,0,654,298,952,68.6975
第15任總統副總統,在臺東縣各村(里),臺東縣,　臺東市,新生里,169,2449,1812,4430,45,4475,0,4475,1825,6300,71.0317
第15任總統副總統,在臺東縣各村(里),臺東縣,　臺東市,中心里,75,1089,907,2071,18,2089,0,2089,804,2893,72.2088
第15任總統副總統,在臺東縣各村(里),臺東縣,　臺東市,馬蘭里,80,1060,667,1807,14,1821,0,1821,655,2476,73.5460
第15任總統副總統,在臺東縣各村(里),臺東縣,　臺東市,光明里,73,982,671,1726,16,1742,0,1742,703,2445,71.2474
第15任總統副總統,在臺東縣各村(里),臺東縣,　臺東市,豐年里,93,1097,721,1911,16,1927,0,1927,1018,2945,65.4329
第15任總統副總統,在臺東縣各村(里),臺東縣,　臺東市,豐樂里,40,514,426,980,11,991,0,991,430,1421,69.7396
第15任總統副總統,在臺東縣各村(里),臺東縣,　臺東市,永樂里,64,733,599,1396,17,1413,0,1413,605,2018,70.0198
第15任總統副總統,在臺東縣各村(里),臺東縣,　臺東市,康樂里,31,426,418,875,12,887,0,887,403,1290,68.7597
第15任總統副總統,在臺東縣各村(里),臺東縣,　臺東市,豐榮里,221,3052,2125,5398,49,5447,0,5447,2321,7768,70.1210
第15任總統副總統,在臺東縣各村(里),臺東縣,　臺東市,豐谷里,107,1889,1291,3287,22,3309,0,3309,1627,4936,67.0381
第15任總統副總統,在臺東縣各村(里),臺東縣,　臺東市,豐里里,52,725,787,1564,16,1580,0,1580,716,2296,68.8153
第15任總統副總統,在臺東縣各村(里),臺東縣,　臺東市,豐原里,32,330,428,790,4,794,0,794,381,1175,67.5745
第15任總統副總統,在臺東縣各村(里),臺東縣,　臺東市,富岡里,30,566,290,886,19,905,0,905,562,1467,61.6905
第15任總統副總統,在臺東縣各村(里),臺東縣,　臺東市,富豐里,19,291,191,501,4,505,0,505,327,832,60.6971
第15任總統副總統,在臺東縣各村(里),臺東縣,　臺東市,南榮里,66,1069,619,1754,13,1767,0,1767,799,2566,68.8620
第15任總統副總統,在臺東縣各村(里),臺東縣,　臺東市,岩灣里,38,810,526,1374,23,1397,0,1397,732,2129,65.6177
第15任總統副總統,在臺東縣各村(里),臺東縣,　臺東市,卑南里,81,907,996,1984,17,2001,0,2001,651,2652,75.4525
第15任總統副總統,在臺東縣各村(里),臺東縣,　臺東市,南王里,54,1047,711,1812,18,1830,0,1830,796,2626,69.6877
第15任總統副總統,在臺東縣各村(里),臺東縣,　臺東市,豐田里,38,595,651,1284,18,1302,0,1302,659,1961,66.3947
第15任總統副總統,在臺東縣各村(里),臺東縣,　臺東市,新園里,33,650,414,1097,17,1114,0,1114,452,1566,71.1367
第15任總統副總統,在臺東縣各村(里),臺東縣,　臺東市,建和里,24,554,349,927,7,934,0,934,427,1361,68.6260
第15任總統副總統,在臺東縣各村(里),臺東縣,　臺東市,建興里,25,302,312,639,7,646,0,646,263,909,71.0671
第15任總統副總統,在臺東縣各村(里),臺東縣,　臺東市,建業里,38,466,326,830,11,841,0,841,405,1246,67.4960
第15任總統副總統,在臺東縣各村(里),臺東縣,　臺東市,知本里,37,500,366,903,14,917,0,917,420,1337,68.5864
第15任總統副總統,在臺東縣各村(里),臺東縣,　臺東市,建農里,52,796,354,1202,10,1212,0,1212,699,1911,63.4223
第15任總統副總統,在臺東縣各村(里),臺東縣,　成功鎮,信義里,20,742,197,959,5,964,0,964,797,1761,54.7416
第15任總統副總統,在臺東縣各村(里),臺東縣,　成功鎮,和平里,7,283,87,377,2,379,0,379,344,723,52.4205
第15任總統副總統,在臺東縣各村(里),臺東縣,　成功鎮,忠仁里,43,775,462,1280,5,1285,0,1285,799,2084,61.6603
第15任總統副總統,在臺東縣各村(里),臺東縣,　成功鎮,忠智里,45,740,399,1184,12,1196,0,1196,626,1822,65.6422
第15任總統副總統,在臺東縣各村(里),臺東縣,　成功鎮,三民里,51,1068,379,1498,10,1508,0,1508,1082,2590,58.2239
第15任總統副總統,在臺東縣各村(里),臺東縣,　成功鎮,三仙里,22,457,200,679,11,690,0,690,671,1361,50.6980
第15任總統副總統,在臺東縣各村(里),臺東縣,　成功鎮,忠孝里,16,319,158,493,4,497,0,497,459,956,51.9874
第15任總統副總統,在臺東縣各村(里),臺東縣,　成功鎮,博愛里,8,293,54,355,2,357,0,357,266,623,57.3034
第15任總統副總統,在臺東縣各村(里),臺東縣,　關山鎮,里壠里,44,599,376,1019,8,1027,0,1027,592,1619,63.4342
第15任總統副總統,在臺東縣各村(里),臺東縣,　關山鎮,中福里,19,295,271,585,6,591,0,591,192,783,75.4789
第15任總統副總統,在臺東縣各村(里),臺東縣,　關山鎮,新福里,24,291,206,521,14,535,0,535,321,856,62.5000
第15任總統副總統,在臺東縣各村(里),臺東縣,　關山鎮,豐泉里,27,468,282,777,5,782,1,783,301,1084,72.1402
第15任總統副總統,在臺東縣各村(里),臺東縣,　關山鎮,月眉里,8,189,191,388,7,395,0,395,299,694,56.9164
第15任總統副總統,在臺東縣各村(里),臺東縣,　關山鎮,德高里,36,640,348,1024,7,1031,0,1031,627,1658,62.1834
第15任總統副總統,在臺東縣各村(里),臺東縣,　關山鎮,電光里,15,180,90,285,6,291,0,291,226,517,56.2863
第15任總統副總統,在臺東縣各村(里),臺東縣,　卑南鄉,賓朗村,54,663,730,1447,11,1458,0,1458,682,2140,68.1308
第15任總統副總統,在臺東縣各村(里),臺東縣,　卑南鄉,美農村,21,266,336,623,2,625,0,625,433,1058,59.0737
第15任總統副總統,在臺東縣各村(里),臺東縣,　卑南鄉,初鹿村,32,462,335,829,8,837,0,837,381,1218,68.7192
第15任總統副總統,在臺東縣各村(里),臺東縣,　卑南鄉,明峰村,34,359,312,705,7,712,0,712,430,1142,62.3468
第15任總統副總統,在臺東縣各村(里),臺東縣,　卑南鄉,嘉豐村,18,160,108,286,3,289,0,289,188,477,60.5870
第15任總統副總統,在臺東縣各村(里),臺東縣,　卑南鄉,太平村,60,1170,767,1997,22,2019,0,2019,964,2983,67.6835
第15任總統副總統,在臺東縣各村(里),臺東縣,　卑南鄉,泰安村,25,455,248,728,9,737,0,737,348,1085,67.9263
第15任總統副總統,在臺東縣各村(里),臺東縣,　卑南鄉,利嘉村,24,490,222,736,8,744,0,744,339,1083,68.6981
第15任總統副總統,在臺東縣各村(里),臺東縣,　卑南鄉,東興村,13,601,178,792,4,796,0,796,344,1140,69.8246
第15任總統副總統,在臺東縣各村(里),臺東縣,　卑南鄉,溫泉村,26,291,398,715,4,719,0,719,366,1085,66.2673
第15任總統副總統,在臺東縣各村(里),臺東縣,　卑南鄉,富山村,10,174,95,279,5,284,0,284,179,463,61.3391
第15任總統副總統,在臺東縣各村(里),臺東縣,　卑南鄉,富源村,5,74,125,204,4,208,0,208,124,332,62.6506
第15任總統副總統,在臺東縣各村(里),臺東縣,　卑南鄉,利吉村,9,173,108,290,1,291,0,291,145,436,66.7431
第15任總統副總統,在臺東縣各村(里),臺東縣,　鹿野鄉,鹿野村,18,407,244,669,7,676,0,676,377,1053,64.1975
第15任總統副總統,在臺東縣各村(里),臺東縣,　鹿野鄉,龍田村,14,273,366,653,9,662,0,662,354,1016,65.1575
第15任總統副總統,在臺東縣各村(里),臺東縣,　鹿野鄉,永安村,21,529,318,868,14,882,0,882,514,1396,63.1805
第15任總統副總統,在臺東縣各村(里),臺東縣,　鹿野鄉,瑞隆村,14,338,158,510,3,513,0,513,345,858,59.7902
第15任總統副總統,在臺東縣各村(里),臺東縣,　鹿野鄉,瑞源村,25,310,187,522,7,529,0,529,313,842,62.8266
第15任總統副總統,在臺東縣各村(里),臺東縣,　鹿野鄉,瑞和村,17,195,132,344,5,349,0,349,290,639,54.6166
第15任總統副總統,在臺東縣各村(里),臺東縣,　鹿野鄉,瑞豐村,19,188,350,557,7,564,0,564,311,875,64.4571
第15任總統副總統,在臺東縣各村(里),臺東縣,　池上鄉,福原村,42,632,564,1238,9,1247,0,1247,606,1853,67.2963
第15任總統副總統,在臺東縣各村(里),臺東縣,　池上鄉,福文村,26,332,263,621,5,626,0,626,465,1091,57.3786
第15任總統副總統,在臺東縣各村(里),臺東縣,　池上鄉,慶豐村,12,201,147,360,5,365,0,365,266,631,57.8447
第15任總統副總統,在臺東縣各村(里),臺東縣,　池上鄉,大坡村,7,94,51,152,4,156,0,156,165,321,48.5981
第15任總統副總統,在臺東縣各村(里),臺東縣,　池上鄉,大埔村,17,272,155,444,6,450,0,450,319,769,58.5176
第15任總統副總統,在臺東縣各村(里),臺東縣,　池上鄉,新興村,18,259,222,499,4,503,0,503,318,821,61.2667
第15任總統副總統,在臺東縣各村(里),臺東縣,　池上鄉,錦園村,8,84,116,208,2,210,0,210,133,343,61.2245
第15任總統副總統,在臺東縣各村(里),臺東縣,　池上鄉,萬安村,3,80,110,193,1,194,0,194,109,303,64.0264
第15任總統副總統,在臺東縣各村(里),臺東縣,　池上鄉,富興村,11,132,81,224,0,224,0,224,161,385,58.1818
第15任總統副總統,在臺東縣各村(里),臺東縣,　池上鄉,振興村,5,127,59,191,1,192,0,192,235,427,44.9649
第15任總統副總統,在臺東縣各村(里),臺東縣,　東河鄉,都蘭村,48,808,483,1339,9,1348,0,1348,723,2071,65.0893
第15任總統副總統,在臺東縣各村(里),臺東縣,　東河鄉,興昌村,12,305,206,523,9,532,0,532,352,884,60.1810
第15任總統副總統,在臺東縣各村(里),臺東縣,　東河鄉,隆昌村,7,210,105,322,3,325,0,325,215,540,60.1852
第15任總統副總統,在臺東縣各村(里),臺東縣,　東河鄉,東河村,26,378,130,534,6,540,0,540,423,963,56.0748
第15任總統副總統,在臺東縣各村(里),臺東縣,　東河鄉,泰源村,22,396,143,561,7,568,0,568,567,1135,50.0441
第15任總統副總統,在臺東縣各村(里),臺東縣,　東河鄉,北源村,36,493,200,729,4,733,0,733,856,1589,46.1296
第15任總統副總統,在臺東縣各村(里),臺東縣,　東河鄉,尚德村,6,74,54,134,1,135,0,135,121,256,52.7344
第15任總統副總統,在臺東縣各村(里),臺東縣,　長濱鄉,寧埔村,16,466,161,643,6,649,0,649,523,1172,55.3754
第15任總統副總統,在臺東縣各村(里),臺東縣,　長濱鄉,竹湖村,16,309,148,473,4,477,0,477,404,881,54.1430
第15任總統副總統,在臺東縣各村(里),臺東縣,　長濱鄉,長濱村,33,684,359,1076,18,1094,0,1094,832,1926,56.8017
第15任總統副總統,在臺東縣各村(里),臺東縣,　長濱鄉,忠勇村,11,148,99,258,3,261,0,261,260,521,50.0960
第15任總統副總統,在臺東縣各村(里),臺東縣,　長濱鄉,三間村,21,474,134,629,5,634,0,634,520,1154,54.9393
第15任總統副總統,在臺東縣各村(里),臺東縣,　長濱鄉,樟原村,9,226,109,344,3,347,0,347,251,598,58.0268
第15任總統副總統,在臺東縣各村(里),臺東縣,　太麻里鄉,美和村,25,386,394,805,11,816,0,816,451,1267,64.4041
第15任總統副總統,在臺東縣各村(里),臺東縣,　太麻里鄉,三和村,15,161,207,383,3,386,0,386,205,591,65.3130
第15任總統副總統,在臺東縣各村(里),臺東縣,　太麻里鄉,華源村,20,145,218,383,8,391,0,391,199,590,66.2712
第15任總統副總統,在臺東縣各村(里),臺東縣,　太麻里鄉,北里村,13,188,159,360,4,364,0,364,193,557,65.3501
第15任總統副總統,在臺東縣各村(里),臺東縣,　太麻里鄉,大王村,26,666,438,1130,13,1143,0,1143,569,1712,66.7640
第15任總統副總統,在臺東縣各村(里),臺東縣,　太麻里鄉,泰和村,28,544,379,951,5,956,0,956,410,1366,69.9854
第15任總統副總統,在臺東縣各村(里),臺東縣,　太麻里鄉,香蘭村,14,273,190,477,5,482,0,482,299,781,61.7157
第15任總統副總統,在臺東縣各村(里),臺東縣,　太麻里鄉,金崙村,36,845,205,1086,6,1092,0,1092,555,1647,66.3024
第15任總統副總統,在臺東縣各村(里),臺東縣,　太麻里鄉,多良村,19,424,88,531,6,537,0,537,345,882,60.8844
第15任總統副總統,在臺東縣各村(里),臺東縣,　大武鄉,南興村,8,236,92,336,3,339,0,339,187,526,64.4487
第15任總統副總統,在臺東縣各村(里),臺東縣,　大武鄉,尚武村,20,346,339,705,8,713,0,713,665,1378,51.7417
第15任總統副總統,在臺東縣各村(里),臺東縣,　大武鄉,大武村,17,462,246,725,4,729,0,729,525,1254,58.1340
第15任總統副總統,在臺東縣各村(里),臺東縣,　大武鄉,大鳥村,18,528,113,659,4,663,0,663,405,1068,62.0787
第15任總統副總統,在臺東縣各村(里),臺東縣,　大武鄉,大竹村,12,356,65,433,7,440,0,440,290,730,60.2740
第15任總統副總統,在臺東縣各村(里),臺東縣,　綠島鄉,南寮村,19,520,240,779,3,782,0,782,661,1443,54.1927
第15任總統副總統,在臺東縣各村(里),臺東縣,　綠島鄉,中寮村,17,337,146,500,8,508,0,508,500,1008,50.3968
第15任總統副總統,在臺東縣各村(里),臺東縣,　綠島鄉,公舘村,13,332,141,486,8,494,0,494,457,951,51.9453
第15任總統副總統,在臺東縣各村(里),臺東縣,　海端鄉,加拿村,10,230,52,292,2,294,0,294,172,466,63.0901
第15任總統副總統,在臺東縣各村(里),臺東縣,　海端鄉,崁頂村,10,284,69,363,1,364,0,364,179,543,67.0350
第15任總統副總統,在臺東縣各村(里),臺東縣,　海端鄉,海端村,24,391,113,528,5,533,0,533,391,924,57.6840
第15任總統副總統,在臺東縣各村(里),臺東縣,　海端鄉,廣原村,9,307,81,397,2,399,0,399,304,703,56.7568
第15任總統副總統,在臺東縣各村(里),臺東縣,　海端鄉,霧鹿村,4,124,33,161,4,165,0,165,84,249,66.2651
第15任總統副總統,在臺東縣各村(里),臺東縣,　海端鄉,利稻村,6,103,49,158,1,159,0,159,83,242,65.7025
第15任總統副總統,在臺東縣各村(里),臺東縣,　延平鄉,桃源村,13,428,195,636,8,644,0,644,326,970,66.3918
第15任總統副總統,在臺東縣各村(里),臺東縣,　延平鄉,紅葉村,9,203,57,269,4,273,0,273,132,405,67.4074
第15任總統副總統,在臺東縣各村(里),臺東縣,　延平鄉,永康村,6,167,23,196,2,198,0,198,95,293,67.5768
第15任總統副總統,在臺東縣各村(里),臺東縣,　延平鄉,武陵村,11,279,69,359,6,365,0,365,186,551,66.2432
第15任總統副總統,在臺東縣各村(里),臺東縣,　延平鄉,鸞山村,10,271,62,343,6,349,0,349,214,563,61.9893
第15任總統副總統,在臺東縣各村(里),臺東縣,　金峰鄉,嘉蘭村,22,679,156,857,3,860,0,860,325,1185,72.5738
第15任總統副總統,在臺東縣各村(里),臺東縣,　金峰鄉,正興村,17,365,65,447,1,448,0,448,132,580,77.2414
第15任總統副總統,在臺東縣各村(里),臺東縣,　金峰鄉,新興村,4,324,71,399,3,402,0,402,92,494,81.3765
第15任總統副總統,在臺東縣各村(里),臺東縣,　金峰鄉,賓茂村,8,213,25,246,2,248,0,248,66,314,78.9809
第15任總統副總統,在臺東縣各村(里),臺東縣,　金峰鄉,歷坵村,7,204,24,235,3,238,0,238,76,314,75.7962
第15任總統副總統,在臺東縣各村(里),臺東縣,　達仁鄉,安朔村,17,285,61,363,0,363,0,363,195,558,65.0538
第15任總統副總統,在臺東縣各村(里),臺東縣,　達仁鄉,南田村,5,136,45,186,1,187,0,187,94,281,66.5480
第15任總統副總統,在臺東縣各村(里),臺東縣,　達仁鄉,森永村,6,185,55,246,1,247,0,247,130,377,65.5172
第15任總統副總統,在臺東縣各村(里),臺東縣,　達仁鄉,新化村,5,177,41,223,1,224,0,224,97,321,69.7819
第15任總統副總統,在臺東縣各村(里),臺東縣,　達仁鄉,台坂村,11,313,58,382,4,386,0,386,196,582,66.3230
第15任總統副總統,在臺東縣各村(里),臺東縣,　達仁鄉,土坂村,17,414,92,523,4,527,0,527,315,842,62.5891
第15任總統副總統,在臺東縣各村(里),臺東縣,　蘭嶼鄉,椰油村,24,273,94,391,3,394,0,394,521,915,43.0601
第15任總統副總統,在臺東縣各村(里),臺東縣,　蘭嶼鄉,紅頭村,33,335,163,531,4,535,0,535,680,1215,44.0329
第15任總統副總統,在臺東縣各村(里),臺東縣,　蘭嶼鄉,東清村,48,276,146,470,4,474,0,474,731,1205,39.3361
第15任總統副總統,在臺東縣各村(里),臺東縣,　蘭嶼鄉,朗島村,50,124,119,293,3,296,0,296,436,732,40.4372
第15任總統副總統,在臺南市各村(里),臺南市,　新營區,忠政里,117,1446,1832,3395,30,3425,0,3425,1096,4521,75.7576
第15任總統副總統,在臺南市各村(里),臺南市,　新營區,民權里,57,638,959,1654,20,1674,0,1674,550,2224,75.2698
第15任總統副總統,在臺南市各村(里),臺南市,　新營區,三仙里,75,688,1258,2021,29,2050,0,2050,744,2794,73.3715
第15任總統副總統,在臺南市各村(里),臺南市,　新營區,永平里,69,680,1233,1982,24,2006,0,2006,675,2681,74.8228
第15任總統副總統,在臺南市各村(里),臺南市,　新營區,大宏里,81,727,1273,2081,24,2105,0,2105,748,2853,73.7820
第15任總統副總統,在臺南市各村(里),臺南市,　新營區,王公里,123,1026,1795,2944,39,2983,0,2983,995,3978,74.9874
第15任總統副總統,在臺南市各村(里),臺南市,　新營區,新東里,191,1639,2743,4573,72,4645,0,4645,1300,5945,78.1329
第15任總統副總統,在臺南市各村(里),臺南市,　新營區,中營里,36,303,547,886,9,895,0,895,257,1152,77.6910
第15任總統副總統,在臺南市各村(里),臺南市,　新營區,土庫里,30,298,732,1060,10,1070,0,1070,329,1399,76.4832
第15任總統副總統,在臺南市各村(里),臺南市,　新營區,興業里,55,498,699,1252,21,1273,0,1273,438,1711,74.4009
第15任總統副總統,在臺南市各村(里),臺南市,　新營區,南興里,61,597,1009,1667,16,1683,0,1683,679,2362,71.2532
第15任總統副總統,在臺南市各村(里),臺南市,　新營區,民生里,62,748,1454,2264,15,2279,0,2279,868,3147,72.4182
第15任總統副總統,在臺南市各村(里),臺南市,　新營區,新北里,127,1234,2078,3439,41,3480,0,3480,1153,4633,75.1133
第15任總統副總統,在臺南市各村(里),臺南市,　新營區,新南里,167,1195,2239,3601,38,3639,0,3639,1113,4752,76.5783
第15任總統副總統,在臺南市各村(里),臺南市,　新營區,民榮里,107,1012,1985,3104,38,3142,0,3142,1150,4292,73.2060
第15任總統副總統,在臺南市各村(里),臺南市,　新營區,埤寮里,48,318,784,1150,10,1160,0,1160,428,1588,73.0479
第15任總統副總統,在臺南市各村(里),臺南市,　新營區,護鎮里,34,269,668,971,11,982,0,982,352,1334,73.6132
第15任總統副總統,在臺南市各村(里),臺南市,　新營區,太南里,31,267,916,1214,7,1221,0,1221,433,1654,73.8210
第15任總統副總統,在臺南市各村(里),臺南市,　新營區,太北里,35,276,935,1246,18,1264,0,1264,423,1687,74.9259
第15任總統副總統,在臺南市各村(里),臺南市,　新營區,南紙里,109,896,1644,2649,29,2678,0,2678,907,3585,74.7001
第15任總統副總統,在臺南市各村(里),臺南市,　新營區,嘉芳里,48,348,884,1280,18,1298,0,1298,503,1801,72.0711
第15任總統副總統,在臺南市各村(里),臺南市,　新營區,姑爺里,24,148,497,669,10,679,0,679,229,908,74.7797
第15任總統副總統,在臺南市各村(里),臺南市,　新營區,五興里,33,266,805,1104,19,1123,0,1123,427,1550,72.4516
第15任總統副總統,在臺南市各村(里),臺南市,　鹽水區,水秀里,29,312,766,1107,11,1118,0,1118,376,1494,74.8327
第15任總統副總統,在臺南市各村(里),臺南市,　鹽水區,津城里,34,289,706,1029,18,1047,0,1047,373,1420,73.7324
第15任總統副總統,在臺南市各村(里),臺南市,　鹽水區,月港里,31,414,740,1185,9,1194,0,1194,382,1576,75.7614
第15任總統副總統,在臺南市各村(里),臺南市,　鹽水區,橋南里,89,747,1791,2627,40,2667,0,2667,993,3660,72.8689
第15任總統副總統,在臺南市各村(里),臺南市,　鹽水區,岸內里,83,756,1807,2646,23,2669,0,2669,940,3609,73.9540
第15任總統副總統,在臺南市各村(里),臺南市,　鹽水區,汫水里,9,98,498,605,5,610,0,610,283,893,68.3091
第15任總統副總統,在臺南市各村(里),臺南市,　鹽水區,義中里,27,250,805,1082,18,1100,0,1100,445,1545,71.1974
第15任總統副總統,在臺南市各村(里),臺南市,　鹽水區,三明里,16,185,857,1058,15,1073,0,1073,423,1496,71.7246
第15任總統副總統,在臺南市各村(里),臺南市,　鹽水區,文昌里,22,154,477,653,2,655,0,655,333,988,66.2955
第15任總統副總統,在臺南市各村(里),臺南市,　鹽水區,歡雅里,36,258,832,1126,13,1139,0,1139,464,1603,71.0543
第15任總統副總統,在臺南市各村(里),臺南市,　鹽水區,三和里,13,163,465,641,5,646,0,646,228,874,73.9130
第15任總統副總統,在臺南市各村(里),臺南市,　鹽水區,竹林里,14,155,616,785,9,794,0,794,296,1090,72.8440
第15任總統副總統,在臺南市各村(里),臺南市,　鹽水區,坔頭港里,24,240,739,1003,17,1020,0,1020,353,1373,74.2899
第15任總統副總統,在臺南市各村(里),臺南市,　白河區,白河里,36,361,810,1207,17,1224,0,1224,432,1656,73.9130
第15任總統副總統,在臺南市各村(里),臺南市,　白河區,永安里,57,604,1495,2156,25,2181,0,2181,704,2885,75.5979
第15任總統副總統,在臺南市各村(里),臺南市,　白河區,外角里,25,239,682,946,13,959,0,959,377,1336,71.7814
第15任總統副總統,在臺南市各村(里),臺南市,　白河區,庄內里,39,287,841,1167,12,1179,0,1179,401,1580,74.6203
第15任總統副總統,在臺南市各村(里),臺南市,　白河區,秀祐里,25,158,437,620,5,625,0,625,230,855,73.0994
第15任總統副總統,在臺南市各村(里),臺南市,　白河區,河東里,26,247,632,905,18,923,0,923,395,1318,70.0303
第15任總統副總統,在臺南市各村(里),臺南市,　白河區,虎山里,4,101,192,297,7,304,0,304,133,437,69.5652
第15任總統副總統,在臺南市各村(里),臺南市,　白河區,大林里,9,70,298,377,4,381,0,381,199,580,65.6897
第15任總統副總統,在臺南市各村(里),臺南市,　白河區,崁頭里,7,71,169,247,5,252,0,252,110,362,69.6133
第15任總統副總統,在臺南市各村(里),臺南市,　白河區,六溪里,7,74,224,305,1,306,0,306,187,493,62.0690
第15任總統副總統,在臺南市各村(里),臺南市,　白河區,關嶺里,11,216,428,655,7,662,0,662,336,998,66.3327
第15任總統副總統,在臺南市各村(里),臺南市,　白河區,仙草里,18,258,505,781,12,793,0,793,458,1251,63.3893
第15任總統副總統,在臺南市各村(里),臺南市,　白河區,詔豐里,25,313,1014,1352,20,1372,1,1373,559,1932,71.0145
第15任總統副總統,在臺南市各村(里),臺南市,　白河區,大竹里,35,268,643,946,11,957,0,957,430,1387,68.9978
第15任總統副總統,在臺南市各村(里),臺南市,　白河區,廣蓮里,29,260,750,1039,7,1046,0,1046,395,1441,72.5885
第15任總統副總統,在臺南市各村(里),臺南市,　白河區,竹門里,22,179,390,591,6,597,0,597,248,845,70.6509
第15任總統副總統,在臺南市各村(里),臺南市,　白河區,崎內里,15,176,277,468,3,471,0,471,238,709,66.4316
第15任總統副總統,在臺南市各村(里),臺南市,　白河區,昇安里,28,238,691,957,10,967,0,967,324,1291,74.9032
第15任總統副總統,在臺南市各村(里),臺南市,　白河區,汴頭里,6,95,364,465,3,468,0,468,235,703,66.5718
第15任總統副總統,在臺南市各村(里),臺南市,　白河區,內角里,10,122,355,487,3,490,0,490,176,666,73.5736
第15任總統副總統,在臺南市各村(里),臺南市,　白河區,馬稠後里,20,274,634,928,5,933,0,933,414,1347,69.2650
第15任總統副總統,在臺南市各村(里),臺南市,　柳營區,士林里,61,341,944,1346,18,1364,1,1365,442,1807,75.4842
第15任總統副總統,在臺南市各村(里),臺南市,　柳營區,光福里,45,343,775,1163,11,1174,0,1174,344,1518,77.3386
第15任總統副總統,在臺南市各村(里),臺南市,　柳營區,中埕里,29,215,531,775,8,783,0,783,303,1086,72.0994
第15任總統副總統,在臺南市各村(里),臺南市,　柳營區,東昇里,73,570,1396,2039,32,2071,1,2072,621,2693,76.9031
第15任總統副總統,在臺南市各村(里),臺南市,　柳營區,八翁里,38,299,697,1034,5,1039,0,1039,328,1367,76.0059
第15任總統副總統,在臺南市各村(里),臺南市,　柳營區,人和里,25,170,349,544,9,553,0,553,178,731,75.6498
第15任總統副總統,在臺南市各村(里),臺南市,　柳營區,太康里,35,293,733,1061,14,1075,1,1076,367,1443,74.4976
第15任總統副總統,在臺南市各村(里),臺南市,　柳營區,重溪里,51,293,931,1275,15,1290,0,1290,437,1727,74.6960
第15任總統副總統,在臺南市各村(里),臺南市,　柳營區,篤農里,23,240,673,936,12,948,0,948,324,1272,74.5283
第15任總統副總統,在臺南市各村(里),臺南市,　柳營區,大農里,13,116,338,467,10,477,0,477,182,659,72.3824
第15任總統副總統,在臺南市各村(里),臺南市,　柳營區,神農里,28,187,751,966,14,980,0,980,370,1350,72.5926
第15任總統副總統,在臺南市各村(里),臺南市,　柳營區,果毅里,33,197,620,850,8,858,0,858,320,1178,72.8353
第15任總統副總統,在臺南市各村(里),臺南市,　柳營區,旭山里,33,314,719,1066,19,1085,0,1085,433,1518,71.4756
第15任總統副總統,在臺南市各村(里),臺南市,　後壁區,後壁里,35,380,773,1188,12,1200,0,1200,379,1579,75.9975
第15任總統副總統,在臺南市各村(里),臺南市,　後壁區,侯伯里,19,235,649,903,10,913,0,913,351,1264,72.2310
第15任總統副總統,在臺南市各村(里),臺南市,　後壁區,嘉苳里,31,248,607,886,7,893,0,893,341,1234,72.3663
第15任總統副總統,在臺南市各村(里),臺南市,　後壁區,土溝里,15,224,706,945,9,954,0,954,329,1283,74.3570
第15任總統副總統,在臺南市各村(里),臺南市,　後壁區,上茄苳里,38,324,1203,1565,16,1581,0,1581,562,2143,73.7751
第15任總統副總統,在臺南市各村(里),臺南市,　後壁區,菁豐里,25,243,581,849,14,863,0,863,311,1174,73.5094
第15任總統副總統,在臺南市各村(里),臺南市,　後壁區,菁寮里,49,288,680,1017,19,1036,0,1036,386,1422,72.8551
第15任總統副總統,在臺南市各村(里),臺南市,　後壁區,新嘉里,14,150,521,685,12,697,0,697,271,968,72.0041
第15任總統副總統,在臺南市各村(里),臺南市,　後壁區,長短樹里,39,359,1006,1404,15,1419,0,1419,505,1924,73.7526
第15任總統副總統,在臺南市各村(里),臺南市,　後壁區,竹新里,36,176,771,983,14,997,0,997,343,1340,74.4030
第15任總統副總統,在臺南市各村(里),臺南市,　後壁區,新東里,39,277,828,1144,12,1156,0,1156,447,1603,72.1148
第15任總統副總統,在臺南市各村(里),臺南市,　後壁區,頂安里,41,319,549,909,7,916,0,916,302,1218,75.2053
第15任總統副總統,在臺南市各村(里),臺南市,　後壁區,長安里,30,277,576,883,16,899,0,899,317,1216,73.9309
第15任總統副總統,在臺南市各村(里),臺南市,　後壁區,福安里,36,322,885,1243,10,1253,0,1253,487,1740,72.0115
第15任總統副總統,在臺南市各村(里),臺南市,　東山區,東山里,38,303,577,918,6,924,0,924,437,1361,67.8913
第15任總統副總統,在臺南市各村(里),臺南市,　東山區,東中里,56,532,1144,1732,19,1751,0,1751,671,2422,72.2956
第15任總統副總統,在臺南市各村(里),臺南市,　東山區,東正里,24,246,653,923,10,933,0,933,460,1393,66.9777
第15任總統副總統,在臺南市各村(里),臺南市,　東山區,大客里,9,207,453,669,8,677,0,677,388,1065,63.5681
第15任總統副總統,在臺南市各村(里),臺南市,　東山區,三榮里,21,157,426,604,4,608,0,608,304,912,66.6667
第15任總統副總統,在臺南市各村(里),臺南市,　東山區,科里里,24,242,557,823,14,837,0,837,379,1216,68.8322
第15任總統副總統,在臺南市各村(里),臺南市,　東山區,東河里,13,124,446,583,6,589,0,589,254,843,69.8695
第15任總統副總統,在臺南市各村(里),臺南市,　東山區,聖賢里,47,338,927,1312,22,1334,0,1334,501,1835,72.6975
第15任總統副總統,在臺南市各村(里),臺南市,　東山區,南溪里,6,87,162,255,1,256,0,256,152,408,62.7451
第15任總統副總統,在臺南市各村(里),臺南市,　東山區,水雲里,5,50,162,217,4,221,0,221,157,378,58.4656
第15任總統副總統,在臺南市各村(里),臺南市,　東山區,林安里,0,63,171,234,3,237,0,237,123,360,65.8333
第15任總統副總統,在臺南市各村(里),臺南市,　東山區,東原里,36,458,818,1312,15,1327,0,1327,718,2045,64.8900
第15任總統副總統,在臺南市各村(里),臺南市,　東山區,嶺南里,13,98,278,389,3,392,0,392,250,642,61.0592
第15任總統副總統,在臺南市各村(里),臺南市,　東山區,南勢里,32,226,390,648,6,654,0,654,410,1064,61.4662
第15任總統副總統,在臺南市各村(里),臺南市,　東山區,青山里,18,239,436,693,7,700,0,700,334,1034,67.6983
第15任總統副總統,在臺南市各村(里),臺南市,　東山區,高原里,14,268,340,622,2,624,0,624,258,882,70.7483
第15任總統副總統,在臺南市各村(里),臺南市,　麻豆區,新興里,41,283,1079,1403,12,1415,0,1415,393,1808,78.2633
第15任總統副總統,在臺南市各村(里),臺南市,　麻豆區,巷口里,56,409,1124,1589,18,1607,0,1607,459,2066,77.7832
第15任總統副總統,在臺南市各村(里),臺南市,　麻豆區,東角里,52,538,1334,1924,19,1943,0,1943,559,2502,77.6579
第15任總統副總統,在臺南市各村(里),臺南市,　麻豆區,晋江里,59,389,1381,1829,18,1847,0,1847,563,2410,76.6390
第15任總統副總統,在臺南市各村(里),臺南市,　麻豆區,中興里,34,383,1019,1436,9,1445,0,1445,480,1925,75.0649
第15任總統副總統,在臺南市各村(里),臺南市,　麻豆區,興農里,32,218,875,1125,19,1144,0,1144,305,1449,78.9510
第15任總統副總統,在臺南市各村(里),臺南市,　麻豆區,油車里,77,540,2103,2720,18,2738,0,2738,670,3408,80.3404
第15任總統副總統,在臺南市各村(里),臺南市,　麻豆區,北勢里,25,103,692,820,9,829,0,829,257,1086,76.3352
第15任總統副總統,在臺南市各村(里),臺南市,　麻豆區,大埕里,60,492,1559,2111,26,2137,0,2137,614,2751,77.6808
第15任總統副總統,在臺南市各村(里),臺南市,　麻豆區,清水里,27,241,870,1138,8,1146,0,1146,306,1452,78.9256
第15任總統副總統,在臺南市各村(里),臺南市,　麻豆區,南勢里,45,517,1167,1729,14,1743,0,1743,512,2255,77.2949
第15任總統副總統,在臺南市各村(里),臺南市,　麻豆區,寮廍里,36,196,990,1222,10,1232,0,1232,354,1586,77.6797
第15任總統副總統,在臺南市各村(里),臺南市,　麻豆區,埤頭里,43,245,1419,1707,14,1721,0,1721,534,2255,76.3193
第15任總統副總統,在臺南市各村(里),臺南市,　麻豆區,海埔里,38,295,1213,1546,28,1574,1,1575,483,2058,76.4820
第15任總統副總統,在臺南市各村(里),臺南市,　麻豆區,港尾里,21,214,664,899,12,911,0,911,291,1202,75.7903
第15任總統副總統,在臺南市各村(里),臺南市,　麻豆區,麻口里,21,131,697,849,13,862,0,862,219,1081,79.7410
第15任總統副總統,在臺南市各村(里),臺南市,　麻豆區,安業里,12,150,839,1001,10,1011,0,1011,277,1288,78.4938
第15任總統副總統,在臺南市各村(里),臺南市,　麻豆區,謝厝寮里,42,186,1044,1272,15,1287,0,1287,337,1624,79.2488
第15任總統副總統,在臺南市各村(里),臺南市,　麻豆區,安正里,12,110,552,674,5,679,0,679,243,922,73.6443
第15任總統副總統,在臺南市各村(里),臺南市,　麻豆區,井東里,34,243,1049,1326,13,1339,0,1339,357,1696,78.9505
第15任總統副總統,在臺南市各村(里),臺南市,　下營區,下營里,35,380,688,1103,14,1117,0,1117,382,1499,74.5163
第15任總統副總統,在臺南市各村(里),臺南市,　下營區,仁里里,35,383,946,1364,11,1375,0,1375,553,1928,71.3174
第15任總統副總統,在臺南市各村(里),臺南市,　下營區,宅內里,36,410,685,1131,18,1149,0,1149,426,1575,72.9524
第15任總統副總統,在臺南市各村(里),臺南市,　下營區,後街里,37,369,718,1124,8,1132,0,1132,404,1536,73.6979
第15任總統副總統,在臺南市各村(里),臺南市,　下營區,新興里,37,400,891,1328,13,1341,0,1341,549,1890,70.9524
第15任總統副總統,在臺南市各村(里),臺南市,　下營區,營前里,34,462,999,1495,19,1514,0,1514,529,2043,74.1067
第15任總統副總統,在臺南市各村(里),臺南市,　下營區,大吉里,26,319,768,1113,21,1134,0,1134,405,1539,73.6842
第15任總統副總統,在臺南市各村(里),臺南市,　下營區,茅營里,53,350,1214,1617,10,1627,0,1627,530,2157,75.4288
第15任總統副總統,在臺南市各村(里),臺南市,　下營區,開化里,40,300,1024,1364,13,1377,0,1377,457,1834,75.0818
第15任總統副總統,在臺南市各村(里),臺南市,　下營區,西連里,24,111,509,644,8,652,0,652,212,864,75.4630
第15任總統副總統,在臺南市各村(里),臺南市,　下營區,賀建里,26,211,639,876,15,891,0,891,369,1260,70.7143
第15任總統副總統,在臺南市各村(里),臺南市,　下營區,紅甲里,51,292,1252,1595,18,1613,0,1613,571,2184,73.8553
第15任總統副總統,在臺南市各村(里),臺南市,　六甲區,六甲里,101,502,1515,2118,20,2138,0,2138,666,2804,76.2482
第15任總統副總統,在臺南市各村(里),臺南市,　六甲區,甲東里,51,437,1379,1867,22,1889,0,1889,729,2618,72.1543
第15任總統副總統,在臺南市各村(里),臺南市,　六甲區,甲南里,24,244,686,954,7,961,0,961,333,1294,74.2658
第15任總統副總統,在臺南市各村(里),臺南市,　六甲區,七甲里,42,292,961,1295,20,1315,0,1315,536,1851,71.0427
第15任總統副總統,在臺南市各村(里),臺南市,　六甲區,二甲里,62,555,1758,2375,26,2401,0,2401,824,3225,74.4496
第15任總統副總統,在臺南市各村(里),臺南市,　六甲區,水林里,50,339,1091,1480,18,1498,0,1498,537,2035,73.6118
第15任總統副總統,在臺南市各村(里),臺南市,　六甲區,中社里,45,310,799,1154,12,1166,0,1166,403,1569,74.3149
第15任總統副總統,在臺南市各村(里),臺南市,　六甲區,龜港里,34,232,594,860,5,865,0,865,279,1144,75.6119
第15任總統副總統,在臺南市各村(里),臺南市,　六甲區,菁埔里,11,107,311,429,3,432,0,432,146,578,74.7405
第15任總統副總統,在臺南市各村(里),臺南市,　六甲區,王爺里,18,113,338,469,4,473,0,473,246,719,65.7858
第15任總統副總統,在臺南市各村(里),臺南市,　六甲區,大丘里,4,112,254,370,4,374,0,374,230,604,61.9205
第15任總統副總統,在臺南市各村(里),臺南市,　官田區,官田里,53,371,1040,1464,14,1478,0,1478,520,1998,73.9740
第15任總統副總統,在臺南市各村(里),臺南市,　官田區,二鎮里,66,415,1861,2342,19,2361,0,2361,701,3062,77.1065
第15任總統副總統,在臺南市各村(里),臺南市,　官田區,烏山頭里,22,168,699,889,7,896,0,896,312,1208,74.1722
第15任總統副總統,在臺南市各村(里),臺南市,　官田區,大崎里,5,73,197,275,0,275,0,275,121,396,69.4444
第15任總統副總統,在臺南市各村(里),臺南市,　官田區,隆田里,47,457,916,1420,13,1433,0,1433,500,1933,74.1335
第15任總統副總統,在臺南市各村(里),臺南市,　官田區,隆本里,79,824,1601,2504,23,2527,0,2527,813,3340,75.6587
第15任總統副總統,在臺南市各村(里),臺南市,　官田區,南廍里,28,187,669,884,13,897,0,897,312,1209,74.1935
第15任總統副總統,在臺南市各村(里),臺南市,　官田區,東西庄里,18,107,1267,1392,16,1408,0,1408,427,1835,76.7302
第15任總統副總統,在臺南市各村(里),臺南市,　官田區,渡拔里,54,476,1386,1916,19,1935,0,1935,528,2463,78.5627
第15任總統副總統,在臺南市各村(里),臺南市,　官田區,社子里,12,108,504,624,8,632,0,632,220,852,74.1784
第15任總統副總統,在臺南市各村(里),臺南市,　大內區,石湖里,25,187,478,690,13,703,0,703,273,976,72.0287
第15任總統副總統,在臺南市各村(里),臺南市,　大內區,石林里,16,81,357,454,4,458,0,458,163,621,73.7520
第15任總統副總統,在臺南市各村(里),臺南市,　大內區,石城里,27,238,760,1025,9,1034,0,1034,364,1398,73.9628
第15任總統副總統,在臺南市各村(里),臺南市,　大內區,內江里,15,203,440,658,4,662,0,662,236,898,73.7194
第15任總統副總統,在臺南市各村(里),臺南市,　大內區,大內里,20,178,385,583,5,588,0,588,168,756,77.7778
第15任總統副總統,在臺南市各村(里),臺南市,　大內區,內郭里,13,102,333,448,2,450,0,450,157,607,74.1351
第15任總統副總統,在臺南市各村(里),臺南市,　大內區,頭社里,31,178,475,684,5,689,0,689,284,973,70.8119
第15任總統副總統,在臺南市各村(里),臺南市,　大內區,環湖里,14,188,304,506,7,513,0,513,200,713,71.9495
第15任總統副總統,在臺南市各村(里),臺南市,　大內區,二溪里,19,181,414,614,13,627,0,627,201,828,75.7246
第15任總統副總統,在臺南市各村(里),臺南市,　大內區,曲溪里,12,107,303,422,6,428,0,428,132,560,76.4286
第15任總統副總統,在臺南市各村(里),臺南市,　佳里區,東寧里,46,480,1145,1671,16,1687,0,1687,525,2212,76.2658
第15任總統副總統,在臺南市各村(里),臺南市,　佳里區,忠仁里,59,499,1489,2047,24,2071,0,2071,694,2765,74.9005
第15任總統副總統,在臺南市各村(里),臺南市,　佳里區,鎮山里,152,1012,2956,4120,34,4154,0,4154,1300,5454,76.1643
第15任總統副總統,在臺南市各村(里),臺南市,　佳里區,安西里,140,1209,2966,4315,45,4360,0,4360,1367,5727,76.1306
第15任總統副總統,在臺南市各村(里),臺南市,　佳里區,文新里,133,1094,2466,3693,36,3729,0,3729,1191,4920,75.7927
第15任總統副總統,在臺南市各村(里),臺南市,　佳里區,建南里,102,854,2054,3010,30,3040,0,3040,1061,4101,74.1283
第15任總統副總統,在臺南市各村(里),臺南市,　佳里區,南勢里,94,839,2280,3213,24,3237,0,3237,1043,4280,75.6308
第15任總統副總統,在臺南市各村(里),臺南市,　佳里區,六安里,113,856,1964,2933,43,2976,0,2976,947,3923,75.8603
第15任總統副總統,在臺南市各村(里),臺南市,　佳里區,佳化里,52,375,1108,1535,5,1540,0,1540,539,2079,74.0741
第15任總統副總統,在臺南市各村(里),臺南市,　佳里區,佳興里,36,375,1162,1573,17,1590,0,1590,478,2068,76.8859
第15任總統副總統,在臺南市各村(里),臺南市,　佳里區,營溪里,28,187,558,773,6,779,0,779,271,1050,74.1905
第15任總統副總統,在臺南市各村(里),臺南市,　佳里區,海澄里,41,380,1130,1551,14,1565,0,1565,553,2118,73.8905
第15任總統副總統,在臺南市各村(里),臺南市,　佳里區,下營里,27,327,987,1341,15,1356,0,1356,433,1789,75.7965
第15任總統副總統,在臺南市各村(里),臺南市,　佳里區,塭內里,60,402,1549,2011,20,2031,0,2031,696,2727,74.4774
第15任總統副總統,在臺南市各村(里),臺南市,　佳里區,民安里,36,239,908,1183,10,1193,0,1193,355,1548,77.0672
第15任總統副總統,在臺南市各村(里),臺南市,　佳里區,子龍里,52,358,1349,1759,20,1779,0,1779,556,2335,76.1884
第15任總統副總統,在臺南市各村(里),臺南市,　學甲區,秀昌里,42,401,1343,1786,19,1805,0,1805,585,2390,75.5230
第15任總統副總統,在臺南市各村(里),臺南市,　學甲區,明宜里,30,271,1074,1375,9,1384,0,1384,482,1866,74.1693
第15任總統副總統,在臺南市各村(里),臺南市,　學甲區,慈福里,49,406,967,1422,19,1441,0,1441,505,1946,74.0493
第15任總統副總統,在臺南市各村(里),臺南市,　學甲區,仁得里,94,680,2009,2783,28,2811,0,2811,913,3724,75.4834
第15任總統副總統,在臺南市各村(里),臺南市,　學甲區,新達里,40,380,1027,1447,14,1461,0,1461,609,2070,70.5797
第15任總統副總統,在臺南市各村(里),臺南市,　學甲區,新榮里,51,355,1193,1599,6,1605,0,1605,555,2160,74.3056
第15任總統副總統,在臺南市各村(里),臺南市,　學甲區,大灣里,22,163,495,680,9,689,0,689,254,943,73.0647
第15任總統副總統,在臺南市各村(里),臺南市,　學甲區,豐和里,21,152,681,854,5,859,0,859,322,1181,72.7350
第15任總統副總統,在臺南市各村(里),臺南市,　學甲區,中洲里,22,225,708,955,13,968,0,968,394,1362,71.0720
第15任總統副總統,在臺南市各村(里),臺南市,　學甲區,光華里,18,130,640,788,11,799,0,799,381,1180,67.7119
第15任總統副總統,在臺南市各村(里),臺南市,　學甲區,宅港里,14,96,426,536,2,538,0,538,249,787,68.3609
第15任總統副總統,在臺南市各村(里),臺南市,　學甲區,平和里,20,108,605,733,6,739,0,739,280,1019,72.5221
第15任總統副總統,在臺南市各村(里),臺南市,　學甲區,三慶里,23,214,689,926,11,937,0,937,404,1341,69.8732
第15任總統副總統,在臺南市各村(里),臺南市,　西港區,西港里,75,508,1754,2337,23,2360,0,2360,691,3051,77.3517
第15任總統副總統,在臺南市各村(里),臺南市,　西港區,慶安里,99,781,2253,3133,23,3156,0,3156,1010,4166,75.7561
第15任總統副總統,在臺南市各村(里),臺南市,　西港區,南海里,52,327,1371,1750,30,1780,0,1780,550,2330,76.3948
第15任總統副總統,在臺南市各村(里),臺南市,　西港區,港東里,36,272,873,1181,13,1194,0,1194,383,1577,75.7134
第15任總統副總統,在臺南市各村(里),臺南市,　西港區,檨林里,40,252,880,1172,14,1186,0,1186,401,1587,74.7322
第15任總統副總統,在臺南市各村(里),臺南市,　西港區,後營里,22,162,818,1002,14,1016,0,1016,381,1397,72.7273
第15任總統副總統,在臺南市各村(里),臺南市,　西港區,營西里,32,237,745,1014,14,1028,0,1028,404,1432,71.7877
第15任總統副總統,在臺南市各村(里),臺南市,　西港區,金砂里,13,132,451,596,3,599,0,599,145,744,80.5108
第15任總統副總統,在臺南市各村(里),臺南市,　西港區,劉厝里,24,190,736,950,13,963,0,963,302,1265,76.1265
第15任總統副總統,在臺南市各村(里),臺南市,　西港區,竹林里,15,217,781,1013,15,1028,0,1028,307,1335,77.0037
第15任總統副總統,在臺南市各村(里),臺南市,　西港區,永樂里,19,176,792,987,8,995,0,995,317,1312,75.8384
第15任總統副總統,在臺南市各村(里),臺南市,　西港區,新復里,25,191,382,598,11,609,0,609,170,779,78.1772
第15任總統副總統,在臺南市各村(里),臺南市,　七股區,後港里,20,156,590,766,3,769,0,769,228,997,77.1314
第15任總統副總統,在臺南市各村(里),臺南市,　七股區,大潭里,18,98,323,439,5,444,0,444,208,652,68.0982
第15任總統副總統,在臺南市各村(里),臺南市,　七股區,篤加里,17,136,399,552,3,555,0,555,253,808,68.6881
第15任總統副總統,在臺南市各村(里),臺南市,　七股區,頂山里,8,129,388,525,4,529,0,529,244,773,68.4347
第15任總統副總統,在臺南市各村(里),臺南市,　七股區,西寮里,7,78,234,319,6,325,0,325,138,463,70.1944
第15任總統副總統,在臺南市各村(里),臺南市,　七股區,塩埕里,8,67,211,286,1,287,0,287,123,410,70.0000
第15任總統副總統,在臺南市各村(里),臺南市,　七股區,中寮里,8,132,288,428,2,430,0,430,244,674,63.7982
第15任總統副總統,在臺南市各村(里),臺南市,　七股區,龍山里,25,208,908,1141,9,1150,0,1150,426,1576,72.9695
第15任總統副總統,在臺南市各村(里),臺南市,　七股區,溪南里,15,89,161,265,3,268,0,268,76,344,77.9070
第15任總統副總統,在臺南市各村(里),臺南市,　七股區,七股里,20,109,533,662,6,668,0,668,204,872,76.6055
第15任總統副總統,在臺南市各村(里),臺南市,　七股區,玉成里,13,141,392,546,6,552,0,552,204,756,73.0159
第15任總統副總統,在臺南市各村(里),臺南市,　七股區,大埕里,60,394,1324,1778,16,1794,0,1794,720,2514,71.3604
第15任總統副總統,在臺南市各村(里),臺南市,　七股區,樹林里,39,286,1012,1337,19,1356,0,1356,490,1846,73.4561
第15任總統副總統,在臺南市各村(里),臺南市,　七股區,竹橋里,25,199,714,938,11,949,0,949,261,1210,78.4298
第15任總統副總統,在臺南市各村(里),臺南市,　七股區,義合里,39,328,993,1360,10,1370,0,1370,440,1810,75.6906
第15任總統副總統,在臺南市各村(里),臺南市,　七股區,永吉里,25,172,490,687,5,692,0,692,269,961,72.0083
第15任總統副總統,在臺南市各村(里),臺南市,　七股區,三股里,27,203,670,900,17,917,0,917,396,1313,69.8401
第15任總統副總統,在臺南市各村(里),臺南市,　七股區,十份里,23,248,599,870,10,880,0,880,449,1329,66.2152
第15任總統副總統,在臺南市各村(里),臺南市,　將軍區,長榮里,19,184,605,808,7,815,0,815,265,1080,75.4630
第15任總統副總統,在臺南市各村(里),臺南市,　將軍區,西甲里,35,433,1237,1705,13,1718,0,1718,626,2344,73.2935
第15任總統副總統,在臺南市各村(里),臺南市,　將軍區,忠嘉里,37,396,1273,1706,22,1728,0,1728,665,2393,72.2106
第15任總統副總統,在臺南市各村(里),臺南市,　將軍區,苓仔寮里,41,303,1058,1402,10,1412,0,1412,543,1955,72.2251
第15任總統副總統,在臺南市各村(里),臺南市,　將軍區,巷埔里,18,124,672,814,7,821,0,821,345,1166,70.4117
第15任總統副總統,在臺南市各村(里),臺南市,　將軍區,將軍里,35,239,807,1081,11,1092,0,1092,465,1557,70.1349
第15任總統副總統,在臺南市各村(里),臺南市,　將軍區,玉山里,9,91,444,544,6,550,0,550,280,830,66.2651
第15任總統副總統,在臺南市各村(里),臺南市,　將軍區,廣山里,4,102,279,385,8,393,0,393,234,627,62.6794
第15任總統副總統,在臺南市各村(里),臺南市,　將軍區,長沙里,19,165,688,872,10,882,0,882,421,1303,67.6899
第15任總統副總統,在臺南市各村(里),臺南市,　將軍區,平沙里,14,125,628,767,9,776,0,776,355,1131,68.6118
第15任總統副總統,在臺南市各村(里),臺南市,　將軍區,鯤鯓里,29,256,987,1272,15,1287,0,1287,561,1848,69.6429
第15任總統副總統,在臺南市各村(里),臺南市,　將軍區,鯤溟里,14,107,478,599,3,602,0,602,344,946,63.6364
第15任總統副總統,在臺南市各村(里),臺南市,　北門區,永隆里,11,204,355,570,8,578,0,578,271,849,68.0801
第15任總統副總統,在臺南市各村(里),臺南市,　北門區,北門里,11,171,368,550,7,557,0,557,258,815,68.3436
第15任總統副總統,在臺南市各村(里),臺南市,　北門區,玉港里,12,102,368,482,5,487,0,487,231,718,67.8273
第15任總統副總統,在臺南市各村(里),臺南市,　北門區,保吉里,20,279,578,877,7,884,0,884,414,1298,68.1048
第15任總統副總統,在臺南市各村(里),臺南市,　北門區,蚵寮里,26,224,678,928,7,935,0,935,491,1426,65.5680
第15任總統副總統,在臺南市各村(里),臺南市,　北門區,雙春里,14,86,202,302,2,304,0,304,146,450,67.5556
第15任總統副總統,在臺南市各村(里),臺南市,　北門區,錦湖里,16,144,417,577,4,581,0,581,332,913,63.6364
第15任總統副總統,在臺南市各村(里),臺南市,　北門區,慈安里,12,125,345,482,11,493,0,493,233,726,67.9063
第15任總統副總統,在臺南市各村(里),臺南市,　北門區,三光里,9,164,631,804,0,804,0,804,346,1150,69.9130
第15任總統副總統,在臺南市各村(里),臺南市,　北門區,文山里,16,189,641,846,7,853,0,853,383,1236,69.0129
第15任總統副總統,在臺南市各村(里),臺南市,　新化區,武安里,72,784,1496,2352,17,2369,0,2369,632,3001,78.9404
第15任總統副總統,在臺南市各村(里),臺南市,　新化區,東榮里,106,958,1819,2883,19,2902,0,2902,964,3866,75.0647
第15任總統副總統,在臺南市各村(里),臺南市,　新化區,護國里,65,696,1195,1956,15,1971,0,1971,698,2669,73.8479
第15任總統副總統,在臺南市各村(里),臺南市,　新化區,太平里,139,952,2223,3314,29,3343,0,3343,928,4271,78.2721
第15任總統副總統,在臺南市各村(里),臺南市,　新化區,協興里,101,766,1553,2420,22,2442,0,2442,748,3190,76.5517
第15任總統副總統,在臺南市各村(里),臺南市,　新化區,唪口里,65,435,1116,1616,8,1624,0,1624,486,2110,76.9668
第15任總統副總統,在臺南市各村(里),臺南市,　新化區,北勢里,39,290,750,1079,13,1092,0,1092,328,1420,76.9014
第15任總統副總統,在臺南市各村(里),臺南市,　新化區,豐榮里,92,746,1527,2365,33,2398,0,2398,733,3131,76.5889
第15任總統副總統,在臺南市各村(里),臺南市,　新化區,全興里,81,677,1306,2064,24,2088,0,2088,605,2693,77.5343
第15任總統副總統,在臺南市各村(里),臺南市,　新化區,崙頂里,68,402,1101,1571,20,1591,0,1591,395,1986,80.1108
第15任總統副總統,在臺南市各村(里),臺南市,　新化區,知義里,56,502,1060,1618,12,1630,0,1630,533,2163,75.3583
第15任總統副總統,在臺南市各村(里),臺南市,　新化區,山脚里,41,301,711,1053,10,1063,0,1063,330,1393,76.3101
第15任總統副總統,在臺南市各村(里),臺南市,　新化區,大坑里,6,73,258,337,4,341,0,341,93,434,78.5714
第15任總統副總統,在臺南市各村(里),臺南市,　新化區,𦰡拔里,47,527,947,1521,15,1536,0,1536,541,2077,73.9528
第15任總統副總統,在臺南市各村(里),臺南市,　新化區,羊林里,10,204,460,674,6,680,0,680,203,883,77.0102
第15任總統副總統,在臺南市各村(里),臺南市,　新化區,礁坑里,12,133,570,715,3,718,0,718,259,977,73.4903
第15任總統副總統,在臺南市各村(里),臺南市,　善化區,東關里,19,239,551,809,6,815,0,815,297,1112,73.2914
第15任總統副總統,在臺南市各村(里),臺南市,　善化區,坐駕里,128,865,1931,2924,38,2962,0,2962,848,3810,77.7428
第15任總統副總統,在臺南市各村(里),臺南市,　善化區,光文里,135,1189,2641,3965,40,4005,0,4005,1186,5191,77.1528
第15任總統副總統,在臺南市各村(里),臺南市,　善化區,文昌里,58,552,1324,1934,22,1956,0,1956,673,2629,74.4009
第15任總統副總統,在臺南市各村(里),臺南市,　善化區,南關里,48,307,990,1345,15,1360,0,1360,384,1744,77.9817
第15任總統副總統,在臺南市各村(里),臺南市,　善化區,頂街里,28,238,599,865,10,875,0,875,231,1106,79.1139
第15任總統副總統,在臺南市各村(里),臺南市,　善化區,文正里,47,303,832,1182,16,1198,0,1198,341,1539,77.8428
第15任總統副總統,在臺南市各村(里),臺南市,　善化區,胡家里,30,139,725,894,11,905,0,905,312,1217,74.3632
第15任總統副總統,在臺南市各村(里),臺南市,　善化區,胡厝里,38,306,1150,1494,16,1510,0,1510,446,1956,77.1984
第15任總統副總統,在臺南市各村(里),臺南市,　善化區,什乃里,24,208,706,938,7,945,0,945,270,1215,77.7778
第15任總統副總統,在臺南市各村(里),臺南市,　善化區,溪美里,46,398,940,1384,10,1394,0,1394,454,1848,75.4329
第15任總統副總統,在臺南市各村(里),臺南市,　善化區,六分里,17,123,407,547,2,549,0,549,150,699,78.5408
第15任總統副總統,在臺南市各村(里),臺南市,　善化區,六德里,35,153,579,767,8,775,0,775,264,1039,74.5910
第15任總統副總統,在臺南市各村(里),臺南市,　善化區,田寮里,23,283,938,1244,13,1257,0,1257,396,1653,76.0436
第15任總統副總統,在臺南市各村(里),臺南市,　善化區,昌隆里,33,296,1028,1357,22,1379,0,1379,551,1930,71.4508
第15任總統副總統,在臺南市各村(里),臺南市,　善化區,牛庄里,38,279,878,1195,16,1211,0,1211,387,1598,75.7822
第15任總統副總統,在臺南市各村(里),臺南市,　善化區,嘉北里,38,251,878,1167,12,1179,0,1179,328,1507,78.2349
第15任總統副總統,在臺南市各村(里),臺南市,　善化區,嘉南里,14,160,613,787,12,799,0,799,284,1083,73.7765
第15任總統副總統,在臺南市各村(里),臺南市,　善化區,小新里,114,856,2251,3221,33,3254,0,3254,992,4246,76.6368
第15任總統副總統,在臺南市各村(里),臺南市,　善化區,蓮潭里,108,437,1553,2098,17,2115,0,2115,538,2653,79.7211
第15任總統副總統,在臺南市各村(里),臺南市,　新市區,新市里,73,576,1471,2120,19,2139,0,2139,697,2836,75.4231
第15任總統副總統,在臺南市各村(里),臺南市,　新市區,新和里,162,1279,3317,4758,50,4808,0,4808,1380,6188,77.6988
第15任總統副總統,在臺南市各村(里),臺南市,　新市區,社內里,67,369,1541,1977,17,1994,0,1994,561,2555,78.0431
第15任總統副總統,在臺南市各村(里),臺南市,　新市區,大洲里,10,93,403,506,1,507,0,507,163,670,75.6716
第15任總統副總統,在臺南市各村(里),臺南市,　新市區,豐華里,21,153,514,688,6,694,0,694,188,882,78.6848
第15任總統副總統,在臺南市各村(里),臺南市,　新市區,三舍里,35,270,819,1124,11,1135,0,1135,355,1490,76.1745
第15任總統副總統,在臺南市各村(里),臺南市,　新市區,大營里,92,696,1620,2408,30,2438,0,2438,755,3193,76.3545
第15任總統副總統,在臺南市各村(里),臺南市,　新市區,大社里,120,658,2542,3320,29,3349,0,3349,1004,4353,76.9354
第15任總統副總統,在臺南市各村(里),臺南市,　新市區,潭頂里,38,305,1009,1352,9,1361,0,1361,401,1762,77.2418
第15任總統副總統,在臺南市各村(里),臺南市,　新市區,港墘里,75,606,1833,2514,27,2541,0,2541,732,3273,77.6352
第15任總統副總統,在臺南市各村(里),臺南市,　新市區,永就里,81,607,1466,2154,25,2179,0,2179,665,2844,76.6174
第15任總統副總統,在臺南市各村(里),臺南市,　安定區,蘇林里,47,380,1166,1593,23,1616,0,1616,440,2056,78.5992
第15任總統副總統,在臺南市各村(里),臺南市,　安定區,蘇厝里,45,333,1089,1467,13,1480,0,1480,487,1967,75.2415
第15任總統副總統,在臺南市各村(里),臺南市,　安定區,安定里,32,263,737,1032,7,1039,0,1039,339,1378,75.3991
第15任總統副總統,在臺南市各村(里),臺南市,　安定區,安加里,36,372,1112,1520,22,1542,0,1542,544,2086,73.9214
第15任總統副總統,在臺南市各村(里),臺南市,　安定區,港尾里,40,267,802,1109,10,1119,0,1119,342,1461,76.5914
第15任總統副總統,在臺南市各村(里),臺南市,　安定區,中榮里,31,256,960,1247,12,1259,0,1259,367,1626,77.4293
第15任總統副總統,在臺南市各村(里),臺南市,　安定區,港口里,75,590,1461,2126,27,2153,0,2153,665,2818,76.4017
第15任總統副總統,在臺南市各村(里),臺南市,　安定區,港南里,63,489,1436,1988,25,2013,0,2013,566,2579,78.0535
第15任總統副總統,在臺南市各村(里),臺南市,　安定區,嘉同里,70,418,1261,1749,23,1772,0,1772,526,2298,77.1105
第15任總統副總統,在臺南市各村(里),臺南市,　安定區,中沙里,11,147,409,567,3,570,0,570,136,706,80.7365
第15任總統副總統,在臺南市各村(里),臺南市,　安定區,新吉里,57,411,1354,1822,19,1841,0,1841,560,2401,76.6764
第15任總統副總統,在臺南市各村(里),臺南市,　安定區,海寮里,49,520,1306,1875,28,1903,0,1903,608,2511,75.7865
第15任總統副總統,在臺南市各村(里),臺南市,　安定區,文科里,44,260,902,1206,10,1216,0,1216,331,1547,78.6037
第15任總統副總統,在臺南市各村(里),臺南市,　山上區,明和里,40,304,849,1193,10,1203,0,1203,450,1653,72.7768
第15任總統副總統,在臺南市各村(里),臺南市,　山上區,南洲里,32,309,738,1079,20,1099,0,1099,390,1489,73.8079
第15任總統副總統,在臺南市各村(里),臺南市,　山上區,山上里,14,233,429,676,10,686,0,686,256,942,72.8238
第15任總統副總統,在臺南市各村(里),臺南市,　山上區,新莊里,24,153,518,695,2,697,0,697,218,915,76.1749
第15任總統副總統,在臺南市各村(里),臺南市,　山上區,玉峯里,8,109,259,376,1,377,0,377,161,538,70.0743
第15任總統副總統,在臺南市各村(里),臺南市,　山上區,平陽里,9,107,165,281,5,286,0,286,83,369,77.5068
第15任總統副總統,在臺南市各村(里),臺南市,　山上區,豐德里,12,70,190,272,3,275,0,275,107,382,71.9895
第15任總統副總統,在臺南市各村(里),臺南市,　玉井區,玉井里,37,380,441,858,6,864,0,864,343,1207,71.5824
第15任總統副總統,在臺南市各村(里),臺南市,　玉井區,玉田里,86,1072,1356,2514,21,2535,0,2535,1008,3543,71.5495
第15任總統副總統,在臺南市各村(里),臺南市,　玉井區,中正里,32,321,462,815,9,824,0,824,343,1167,70.6084
第15任總統副總統,在臺南市各村(里),臺南市,　玉井區,竹圍里,22,367,557,946,18,964,0,964,425,1389,69.4024
第15任總統副總統,在臺南市各村(里),臺南市,　玉井區,沙田里,5,154,180,339,5,344,0,344,138,482,71.3693
第15任總統副總統,在臺南市各村(里),臺南市,　玉井區,三埔里,11,123,201,335,3,338,0,338,144,482,70.1245
第15任總統副總統,在臺南市各村(里),臺南市,　玉井區,三和里,16,224,309,549,3,552,0,552,181,733,75.3070
第15任總統副總統,在臺南市各村(里),臺南市,　玉井區,望明里,34,385,552,971,13,984,0,984,405,1389,70.8423
第15任總統副總統,在臺南市各村(里),臺南市,　玉井區,層林里,8,175,232,415,7,422,0,422,170,592,71.2838
第15任總統副總統,在臺南市各村(里),臺南市,　玉井區,豐里里,29,251,355,635,14,649,0,649,280,929,69.8601
第15任總統副總統,在臺南市各村(里),臺南市,　楠西區,楠西里,37,621,551,1209,10,1219,0,1219,554,1773,68.7535
第15任總統副總統,在臺南市各村(里),臺南市,　楠西區,灣丘里,22,351,356,729,9,738,0,738,363,1101,67.0300
第15任總統副總統,在臺南市各村(里),臺南市,　楠西區,密枝里,12,232,203,447,8,455,0,455,220,675,67.4074
第15任總統副總統,在臺南市各村(里),臺南市,　楠西區,照興里,21,302,318,641,10,651,0,651,296,947,68.7434
第15任總統副總統,在臺南市各村(里),臺南市,　楠西區,鹿田里,23,304,293,620,3,623,0,623,248,871,71.5270
第15任總統副總統,在臺南市各村(里),臺南市,　楠西區,龜丹里,15,215,237,467,9,476,0,476,171,647,73.5703
第15任總統副總統,在臺南市各村(里),臺南市,　楠西區,東勢里,37,744,767,1548,15,1563,0,1563,603,2166,72.1607
第15任總統副總統,在臺南市各村(里),臺南市,　南化區,南化里,32,397,585,1014,7,1021,0,1021,323,1344,75.9673
第15任總統副總統,在臺南市各村(里),臺南市,　南化區,小崙里,20,222,264,506,6,512,0,512,267,779,65.7253
第15任總統副總統,在臺南市各村(里),臺南市,　南化區,東和里,13,154,267,434,4,438,0,438,182,620,70.6452
第15任總統副總統,在臺南市各村(里),臺南市,　南化區,西埔里,15,204,286,505,3,508,0,508,247,755,67.2848
第15任總統副總統,在臺南市各村(里),臺南市,　南化區,中坑里,8,124,160,292,1,293,0,293,109,402,72.8856
第15任總統副總統,在臺南市各村(里),臺南市,　南化區,北平里,12,124,244,380,6,386,0,386,154,540,71.4815
第15任總統副總統,在臺南市各村(里),臺南市,　南化區,北寮里,18,339,435,792,8,800,0,800,338,1138,70.2988
第15任總統副總統,在臺南市各村(里),臺南市,　南化區,玉山里,15,328,376,719,8,727,0,727,302,1029,70.6511
第15任總統副總統,在臺南市各村(里),臺南市,　南化區,關山里,29,244,280,553,3,556,0,556,362,918,60.5664
第15任總統副總統,在臺南市各村(里),臺南市,　左鎮區,光和里,5,93,150,248,0,248,0,248,138,386,64.2487
第15任總統副總統,在臺南市各村(里),臺南市,　左鎮區,榮和里,5,121,308,434,3,437,0,437,171,608,71.8750
第15任總統副總統,在臺南市各村(里),臺南市,　左鎮區,左鎮里,10,95,222,327,2,329,0,329,136,465,70.7527
第15任總統副總統,在臺南市各村(里),臺南市,　左鎮區,中正里,17,190,261,468,4,472,0,472,243,715,66.0140
第15任總統副總統,在臺南市各村(里),臺南市,　左鎮區,睦光里,6,76,147,229,6,235,0,235,91,326,72.0859
第15任總統副總統,在臺南市各村(里),臺南市,　左鎮區,內庄里,4,117,148,269,2,271,0,271,115,386,70.2073
第15任總統副總統,在臺南市各村(里),臺南市,　左鎮區,岡林里,9,74,178,261,4,265,0,265,135,400,66.2500
第15任總統副總統,在臺南市各村(里),臺南市,　左鎮區,草山里,4,62,109,175,3,178,0,178,116,294,60.5442
第15任總統副總統,在臺南市各村(里),臺南市,　左鎮區,二寮里,5,32,101,138,3,141,0,141,38,179,78.7709
第15任總統副總統,在臺南市各村(里),臺南市,　左鎮區,澄山里,5,67,237,309,4,313,0,313,178,491,63.7475
第15任總統副總統,在臺南市各村(里),臺南市,　仁德區,太子里,135,980,2990,4105,34,4139,0,4139,1106,5245,78.9133
第15任總統副總統,在臺南市各村(里),臺南市,　仁德區,土庫里,68,437,1596,2101,24,2125,0,2125,586,2711,78.3844
第15任總統副總統,在臺南市各村(里),臺南市,　仁德區,一甲里,92,550,1386,2028,26,2054,0,2054,519,2573,79.8290
第15任總統副總統,在臺南市各村(里),臺南市,　仁德區,仁德里,208,1650,3468,5326,48,5374,1,5375,1797,7172,74.9303
第15任總統副總統,在臺南市各村(里),臺南市,　仁德區,仁義里,288,2087,4525,6900,72,6972,2,6974,1817,8791,79.3084
第15任總統副總統,在臺南市各村(里),臺南市,　仁德區,新田里,101,719,1766,2586,31,2617,0,2617,685,3302,79.2550
第15任總統副總統,在臺南市各村(里),臺南市,　仁德區,後壁里,274,1889,4715,6878,84,6962,0,6962,2019,8981,77.5192
第15任總統副總統,在臺南市各村(里),臺南市,　仁德區,上崙里,155,1219,3018,4392,48,4440,0,4440,1331,5771,76.9364
第15任總統副總統,在臺南市各村(里),臺南市,　仁德區,文賢里,56,494,1189,1739,16,1755,0,1755,449,2204,79.6279
第15任總統副總統,在臺南市各村(里),臺南市,　仁德區,保安里,73,594,1406,2073,15,2088,0,2088,594,2682,77.8523
第15任總統副總統,在臺南市各村(里),臺南市,　仁德區,成功里,133,1528,1866,3527,38,3565,1,3566,1071,4637,76.8816
第15任總統副總統,在臺南市各村(里),臺南市,　仁德區,仁和里,38,800,285,1123,9,1132,0,1132,300,1432,79.0503
第15任總統副總統,在臺南市各村(里),臺南市,　仁德區,仁愛里,36,424,438,898,8,906,0,906,286,1192,76.0067
第15任總統副總統,在臺南市各村(里),臺南市,　仁德區,二行里,72,454,1014,1540,20,1560,0,1560,475,2035,76.6585
第15任總統副總統,在臺南市各村(里),臺南市,　仁德區,大甲里,57,403,1155,1615,25,1640,0,1640,427,2067,79.3420
第15任總統副總統,在臺南市各村(里),臺南市,　仁德區,中洲里,50,557,1407,2014,25,2039,0,2039,572,2611,78.0927
第15任總統副總統,在臺南市各村(里),臺南市,　歸仁區,南保里,142,1177,3138,4457,44,4501,0,4501,1248,5749,78.2919
第15任總統副總統,在臺南市各村(里),臺南市,　歸仁區,南興里,109,864,2265,3238,24,3262,0,3262,825,4087,79.8140
第15任總統副總統,在臺南市各村(里),臺南市,　歸仁區,六甲里,75,676,1920,2671,29,2700,0,2700,1020,3720,72.5806
第15任總統副總統,在臺南市各村(里),臺南市,　歸仁區,歸南里,62,458,1214,1734,21,1755,0,1755,453,2208,79.4837
第15任總統副總統,在臺南市各村(里),臺南市,　歸仁區,後市里,88,694,1648,2430,16,2446,0,2446,701,3147,77.7248
第15任總統副總統,在臺南市各村(里),臺南市,　歸仁區,文化里,67,651,1525,2243,10,2253,0,2253,614,2867,78.5839
第15任總統副總統,在臺南市各村(里),臺南市,　歸仁區,辜厝里,106,690,1702,2498,16,2514,0,2514,686,3200,78.5625
第15任總統副總統,在臺南市各村(里),臺南市,　歸仁區,新厝里,57,433,1382,1872,22,1894,0,1894,486,2380,79.5798
第15任總統副總統,在臺南市各村(里),臺南市,　歸仁區,許厝里,82,641,1692,2415,31,2446,0,2446,727,3173,77.0879
第15任總統副總統,在臺南市各村(里),臺南市,　歸仁區,看西里,48,380,1176,1604,25,1629,0,1629,413,2042,79.7747
第15任總統副總統,在臺南市各村(里),臺南市,　歸仁區,看東里,52,386,931,1369,19,1388,0,1388,356,1744,79.5872
第15任總統副總統,在臺南市各村(里),臺南市,　歸仁區,崙頂里,86,576,1663,2325,22,2347,0,2347,557,2904,80.8196
第15任總統副總統,在臺南市各村(里),臺南市,　歸仁區,沙崙里,8,136,357,501,6,507,0,507,164,671,75.5589
第15任總統副總統,在臺南市各村(里),臺南市,　歸仁區,大潭里,44,312,1064,1420,14,1434,0,1434,383,1817,78.9213
第15任總統副總統,在臺南市各村(里),臺南市,　歸仁區,武東里,47,325,824,1196,8,1204,0,1204,546,1750,68.8000
第15任總統副總統,在臺南市各村(里),臺南市,　歸仁區,歸仁里,55,541,1125,1721,20,1741,0,1741,473,2214,78.6360
第15任總統副總統,在臺南市各村(里),臺南市,　歸仁區,八甲里,71,517,1344,1932,31,1963,0,1963,525,2488,78.8987
第15任總統副總統,在臺南市各村(里),臺南市,　歸仁區,七甲里,93,612,1764,2469,27,2496,0,2496,634,3130,79.7444
第15任總統副總統,在臺南市各村(里),臺南市,　歸仁區,媽廟里,52,366,1084,1502,10,1512,0,1512,398,1910,79.1623
第15任總統副總統,在臺南市各村(里),臺南市,　歸仁區,西埔里,37,304,977,1318,16,1334,0,1334,342,1676,79.5943
第15任總統副總統,在臺南市各村(里),臺南市,　歸仁區,大廟里,74,546,1655,2275,30,2305,0,2305,605,2910,79.2096
第15任總統副總統,在臺南市各村(里),臺南市,　關廟區,關廟里,69,477,1088,1634,18,1652,0,1652,450,2102,78.5918
第15任總統副總統,在臺南市各村(里),臺南市,　關廟區,山西里,45,391,1135,1571,16,1587,0,1587,415,2002,79.2707
第15任總統副總統,在臺南市各村(里),臺南市,　關廟區,香洋里,91,749,1636,2476,30,2506,0,2506,724,3230,77.5851
第15任總統副總統,在臺南市各村(里),臺南市,　關廟區,北勢里,46,452,1357,1855,14,1869,0,1869,528,2397,77.9725
第15任總統副總統,在臺南市各村(里),臺南市,　關廟區,新埔里,23,209,532,764,6,770,0,770,229,999,77.0771
第15任總統副總統,在臺南市各村(里),臺南市,　關廟區,新光里,11,112,398,521,8,529,0,529,185,714,74.0896
第15任總統副總統,在臺南市各村(里),臺南市,　關廟區,五甲里,82,745,1595,2422,20,2442,0,2442,637,3079,79.3115
第15任總統副總統,在臺南市各村(里),臺南市,　關廟區,東勢里,74,626,1639,2339,23,2362,0,2362,689,3051,77.4172
第15任總統副總統,在臺南市各村(里),臺南市,　關廟區,松腳里,43,384,1083,1510,13,1523,0,1523,372,1895,80.3694
第15任總統副總統,在臺南市各村(里),臺南市,　關廟區,花園里,96,665,1822,2583,26,2609,0,2609,742,3351,77.8574
第15任總統副總統,在臺南市各村(里),臺南市,　關廟區,深坑里,43,312,752,1107,6,1113,0,1113,340,1453,76.6001
第15任總統副總統,在臺南市各村(里),臺南市,　關廟區,布袋里,25,201,696,922,4,926,0,926,252,1178,78.6078
第15任總統副總統,在臺南市各村(里),臺南市,　關廟區,南雄里,31,276,825,1132,5,1137,0,1137,329,1466,77.5580
第15任總統副總統,在臺南市各村(里),臺南市,　關廟區,埤頭里,39,376,972,1387,10,1397,0,1397,443,1840,75.9239
第15任總統副總統,在臺南市各村(里),臺南市,　關廟區,下湖里,11,107,250,368,0,368,0,368,104,472,77.9661
第15任總統副總統,在臺南市各村(里),臺南市,　龍崎區,崎頂里,20,231,514,765,13,778,0,778,236,1014,76.7258
第15任總統副總統,在臺南市各村(里),臺南市,　龍崎區,土崎里,20,131,297,448,3,451,0,451,167,618,72.9773
第15任總統副總統,在臺南市各村(里),臺南市,　龍崎區,中坑里,1,26,70,97,2,99,0,99,48,147,67.3469
第15任總統副總統,在臺南市各村(里),臺南市,　龍崎區,楠坑里,9,91,179,279,0,279,0,279,86,365,76.4384
第15任總統副總統,在臺南市各村(里),臺南市,　龍崎區,牛埔里,9,65,177,251,2,253,0,253,69,322,78.5714
第15任總統副總統,在臺南市各村(里),臺南市,　龍崎區,大坪里,9,90,119,218,6,224,0,224,81,305,73.4426
第15任總統副總統,在臺南市各村(里),臺南市,　龍崎區,龍船里,15,137,152,304,3,307,0,307,110,417,73.6211
第15任總統副總統,在臺南市各村(里),臺南市,　龍崎區,石𥕢里,13,105,185,303,0,303,0,303,122,425,71.2941
第15任總統副總統,在臺南市各村(里),臺南市,　永康區,五王里,163,1353,2563,4079,42,4121,0,4121,1433,5554,74.1988
第15任總統副總統,在臺南市各村(里),臺南市,　永康區,三合里,87,896,1572,2555,29,2584,0,2584,813,3397,76.0671
第15任總統副總統,在臺南市各村(里),臺南市,　永康區,六合里,173,1353,2429,3955,52,4007,2,4009,1312,5321,75.3054
第15任總統副總統,在臺南市各村(里),臺南市,　永康區,網寮里,200,1438,3393,5031,57,5088,0,5088,1607,6695,75.9970
第15任總統副總統,在臺南市各村(里),臺南市,　永康區,二王里,224,2004,3483,5711,58,5769,0,5769,1815,7584,76.0680
第15任總統副總統,在臺南市各村(里),臺南市,　永康區,永康里,211,1727,3854,5792,77,5869,0,5869,2759,8628,68.0227
第15任總統副總統,在臺南市各村(里),臺南市,　永康區,埔園里,229,1379,3669,5277,61,5338,0,5338,1597,6935,76.9719
第15任總統副總統,在臺南市各村(里),臺南市,　永康區,龍埔里,111,664,1846,2621,33,2654,0,2654,752,3406,77.9213
第15任總統副總統,在臺南市各村(里),臺南市,　永康區,正強里,199,1633,3823,5655,57,5712,0,5712,1675,7387,77.3250
第15任總統副總統,在臺南市各村(里),臺南市,　永康區,大橋里,168,1372,2729,4269,32,4301,1,4302,1227,5529,77.7898
第15任總統副總統,在臺南市各村(里),臺南市,　永康區,東橋里,191,1353,3516,5060,42,5102,0,5102,1436,6538,78.0361
第15任總統副總統,在臺南市各村(里),臺南市,　永康區,西橋里,101,674,1472,2247,14,2261,0,2261,755,3016,74.9668
第15任總統副總統,在臺南市各村(里),臺南市,　永康區,安康里,152,1094,2242,3488,43,3531,0,3531,1203,4734,74.5881
第15任總統副總統,在臺南市各村(里),臺南市,　永康區,蔦松里,55,366,966,1387,11,1398,0,1398,402,1800,77.6667
第15任總統副總統,在臺南市各村(里),臺南市,　永康區,三民里,27,305,765,1097,14,1111,0,1111,337,1448,76.7265
第15任總統副總統,在臺南市各村(里),臺南市,　永康區,塩行里,141,968,2513,3622,29,3651,0,3651,1112,4763,76.6534
第15任總統副總統,在臺南市各村(里),臺南市,　永康區,塩興里,117,736,1825,2678,20,2698,0,2698,915,3613,74.6748
第15任總統副總統,在臺南市各村(里),臺南市,　永康區,塩洲里,170,1133,2951,4254,45,4299,0,4299,1236,5535,77.6694
第15任總統副總統,在臺南市各村(里),臺南市,　永康區,甲頂里,79,452,1173,1704,15,1719,0,1719,477,2196,78.2787
第15任總統副總統,在臺南市各村(里),臺南市,　永康區,尚頂里,117,753,1926,2796,20,2816,2,2818,864,3682,76.4802
第15任總統副總統,在臺南市各村(里),臺南市,　永康區,龍潭里,159,1068,3182,4409,66,4475,1,4476,1466,5942,75.3113
第15任總統副總統,在臺南市各村(里),臺南市,　永康區,永明里,144,1016,2154,3314,31,3345,0,3345,999,4344,77.0028
第15任總統副總統,在臺南市各村(里),臺南市,　永康區,王行里,71,418,1381,1870,20,1890,0,1890,539,2429,77.8098
第15任總統副總統,在臺南市各村(里),臺南市,　永康區,烏竹里,90,535,1423,2048,13,2061,0,2061,581,2642,78.0091
第15任總統副總統,在臺南市各村(里),臺南市,　永康區,西勢里,151,1212,3137,4500,41,4541,0,4541,1328,5869,77.3726
第15任總統副總統,在臺南市各村(里),臺南市,　永康區,新樹里,58,333,1148,1539,20,1559,0,1559,479,2038,76.4966
第15任總統副總統,在臺南市各村(里),臺南市,　永康區,大灣里,99,566,1882,2547,23,2570,0,2570,755,3325,77.2932
第15任總統副總統,在臺南市各村(里),臺南市,　永康區,東灣里,71,651,1899,2621,21,2642,0,2642,792,3434,76.9365
第15任總統副總統,在臺南市各村(里),臺南市,　永康區,西灣里,201,1440,3745,5386,41,5427,0,5427,1612,7039,77.0990
第15任總統副總統,在臺南市各村(里),臺南市,　永康區,南灣里,99,682,2079,2860,18,2878,0,2878,854,3732,77.1168
第15任總統副總統,在臺南市各村(里),臺南市,　永康區,崑山里,148,1252,2962,4362,35,4397,0,4397,1257,5654,77.7680
第15任總統副總統,在臺南市各村(里),臺南市,　永康區,北灣里,109,735,2175,3019,39,3058,0,3058,863,3921,77.9903
第15任總統副總統,在臺南市各村(里),臺南市,　永康區,北興里,126,937,2558,3621,20,3641,0,3641,1059,4700,77.4681
第15任總統副總統,在臺南市各村(里),臺南市,　永康區,復興里,38,768,552,1358,17,1375,0,1375,560,1935,71.0594
第15任總統副總統,在臺南市各村(里),臺南市,　永康區,光復里,11,215,128,354,5,359,0,359,154,513,69.9805
第15任總統副總統,在臺南市各村(里),臺南市,　永康區,建國里,57,703,605,1365,15,1380,0,1380,463,1843,74.8779
第15任總統副總統,在臺南市各村(里),臺南市,　永康區,復國里,236,2469,3430,6135,70,6205,0,6205,2094,8299,74.7680
第15任總統副總統,在臺南市各村(里),臺南市,　永康區,復華里,253,2536,3945,6734,66,6800,0,6800,2196,8996,75.5892
第15任總統副總統,在臺南市各村(里),臺南市,　永康區,神洲里,39,366,381,786,6,792,0,792,313,1105,71.6742
第15任總統副總統,在臺南市各村(里),臺南市,　永康區,成功里,66,894,607,1567,20,1587,0,1587,456,2043,77.6799
第15任總統副總統,在臺南市各村(里),臺南市,　永康區,中華里,83,904,1179,2166,22,2188,0,2188,580,2768,79.0462
第15任總統副總統,在臺南市各村(里),臺南市,　永康區,中興里,105,1017,1366,2488,28,2516,0,2516,759,3275,76.8244
第15任總統副總統,在臺南市各村(里),臺南市,　永康區,勝利里,233,2195,3117,5545,53,5598,0,5598,1908,7506,74.5803
第15任總統副總統,在臺南市各村(里),臺南市,　東區,崇信里,89,914,1758,2761,45,2806,0,2806,1459,4265,65.7913
第15任總統副總統,在臺南市各村(里),臺南市,　東區,崇學里,80,752,1345,2177,30,2207,0,2207,614,2821,78.2347
第15任總統副總統,在臺南市各村(里),臺南市,　東區,大學里,36,338,488,862,10,872,0,872,228,1100,79.2727
第15任總統副總統,在臺南市各村(里),臺南市,　東區,成大里,54,576,765,1395,24,1419,0,1419,501,1920,73.9063
第15任總統副總統,在臺南市各村(里),臺南市,　東區,東門里,58,428,873,1359,16,1375,0,1375,439,1814,75.7993
第15任總統副總統,在臺南市各村(里),臺南市,　東區,圍下里,74,476,861,1411,19,1430,0,1430,417,1847,77.4228
第15任總統副總統,在臺南市各村(里),臺南市,　東區,中西里,106,798,1385,2289,28,2317,0,2317,688,3005,77.1048
第15任總統副總統,在臺南市各村(里),臺南市,　東區,東安里,29,299,613,941,7,948,0,948,380,1328,71.3855
第15任總統副總統,在臺南市各村(里),臺南市,　東區,忠孝里,146,1288,1745,3179,30,3209,1,3210,929,4139,77.5308
第15任總統副總統,在臺南市各村(里),臺南市,　東區,大福里,42,443,717,1202,16,1218,0,1218,427,1645,74.0426
第15任總統副總統,在臺南市各村(里),臺南市,　東區,大德里,42,390,697,1129,5,1134,0,1134,371,1505,75.3488
第15任總統副總統,在臺南市各村(里),臺南市,　東區,路東里,51,474,644,1169,15,1184,0,1184,369,1553,76.2395
第15任總統副總統,在臺南市各村(里),臺南市,　東區,大同里,61,714,1277,2052,21,2073,0,2073,779,2852,72.6858
第15任總統副總統,在臺南市各村(里),臺南市,　東區,泉南里,126,1139,2180,3445,40,3485,0,3485,1119,4604,75.6950
第15任總統副總統,在臺南市各村(里),臺南市,　東區,龍山里,143,1184,2088,3415,33,3448,0,3448,1049,4497,76.6733
第15任總統副總統,在臺南市各村(里),臺南市,　東區,德光里,137,1109,1774,3020,25,3045,0,3045,831,3876,78.5604
第15任總統副總統,在臺南市各村(里),臺南市,　東區,崇德里,126,1245,2031,3402,45,3447,0,3447,884,4331,79.5890
第15任總統副總統,在臺南市各村(里),臺南市,　東區,崇善里,155,1232,2460,3847,36,3883,0,3883,999,4882,79.5371
第15任總統副總統,在臺南市各村(里),臺南市,　東區,崇成里,81,806,1309,2196,26,2222,0,2222,616,2838,78.2946
第15任總統副總統,在臺南市各村(里),臺南市,　東區,崇文里,165,1650,2664,4479,52,4531,0,4531,1173,5704,79.4355
第15任總統副總統,在臺南市各村(里),臺南市,　東區,東智里,72,699,1150,1921,17,1938,0,1938,604,2542,76.2392
第15任總統副總統,在臺南市各村(里),臺南市,　東區,大智里,184,1919,2797,4900,41,4941,0,4941,1456,6397,77.2393
第15任總統副總統,在臺南市各村(里),臺南市,　東區,德高里,79,755,1524,2358,18,2376,0,2376,653,3029,78.4417
第15任總統副總統,在臺南市各村(里),臺南市,　東區,仁和里,114,1073,2057,3244,32,3276,1,3277,1073,4350,75.3103
第15任總統副總統,在臺南市各村(里),臺南市,　東區,和平里,154,1243,2336,3733,40,3773,0,3773,1100,4873,77.4266
第15任總統副總統,在臺南市各村(里),臺南市,　東區,虎尾里,136,1282,2386,3804,48,3852,0,3852,1011,4863,79.2104
第15任總統副總統,在臺南市各村(里),臺南市,　東區,裕聖里,172,1298,2000,3470,37,3507,0,3507,820,4327,81.0492
第15任總統副總統,在臺南市各村(里),臺南市,　東區,復興里,79,781,1630,2490,25,2515,0,2515,697,3212,78.3001
第15任總統副總統,在臺南市各村(里),臺南市,　東區,自強里,183,1343,2266,3792,48,3840,0,3840,1163,5003,76.7539
第15任總統副總統,在臺南市各村(里),臺南市,　東區,東聖里,65,580,1067,1712,12,1724,0,1724,503,2227,77.4136
第15任總統副總統,在臺南市各村(里),臺南市,　東區,關聖里,140,1274,1884,3298,34,3332,0,3332,896,4228,78.8079
第15任總統副總統,在臺南市各村(里),臺南市,　東區,南聖里,82,714,1131,1927,20,1947,0,1947,435,2382,81.7380
第15任總統副總統,在臺南市各村(里),臺南市,　東區,文聖里,146,1166,1925,3237,34,3271,0,3271,779,4050,80.7654
第15任總統副總統,在臺南市各村(里),臺南市,　東區,後甲里,67,801,1317,2185,21,2206,0,2206,612,2818,78.2825
第15任總統副總統,在臺南市各村(里),臺南市,　東區,東光里,146,1430,2094,3670,37,3707,0,3707,1000,4707,78.7550
第15任總統副總統,在臺南市各村(里),臺南市,　東區,東明里,78,865,1261,2204,22,2226,0,2226,633,2859,77.8594
第15任總統副總統,在臺南市各村(里),臺南市,　東區,莊敬里,107,993,1649,2749,17,2766,0,2766,718,3484,79.3915
第15任總統副總統,在臺南市各村(里),臺南市,　東區,小東里,116,1207,1801,3124,36,3160,0,3160,967,4127,76.5689
第15任總統副總統,在臺南市各村(里),臺南市,　東區,新東里,82,681,1081,1844,22,1866,0,1866,500,2366,78.8673
第15任總統副總統,在臺南市各村(里),臺南市,　東區,崇誨里,63,808,966,1837,11,1848,0,1848,528,2376,77.7778
第15任總統副總統,在臺南市各村(里),臺南市,　東區,衛國里,37,414,646,1097,17,1114,0,1114,380,1494,74.5649
第15任總統副總統,在臺南市各村(里),臺南市,　東區,裕農里,93,738,1338,2169,26,2195,0,2195,644,2839,77.3160
第15任總統副總統,在臺南市各村(里),臺南市,　東區,富強里,100,1032,2241,3373,43,3416,1,3417,945,4362,78.3127
第15任總統副總統,在臺南市各村(里),臺南市,　東區,富裕里,64,492,1077,1633,17,1650,0,1650,492,2142,77.0308
第15任總統副總統,在臺南市各村(里),臺南市,　東區,崇明里,101,1201,1742,3044,27,3071,0,3071,823,3894,78.8649
第15任總統副總統,在臺南市各村(里),臺南市,　南區,大恩里,101,979,1459,2539,19,2558,0,2558,733,3291,77.7271
第15任總統副總統,在臺南市各村(里),臺南市,　南區,大林里,46,672,938,1656,16,1672,0,1672,518,2190,76.3470
第15任總統副總統,在臺南市各村(里),臺南市,　南區,大忠里,107,1221,2095,3423,35,3458,0,3458,986,4444,77.8128
第15任總統副總統,在臺南市各村(里),臺南市,　南區,新生里,107,1500,931,2538,26,2564,0,2564,767,3331,76.9739
第15任總統副總統,在臺南市各村(里),臺南市,　南區,竹溪里,59,445,720,1224,10,1234,0,1234,357,1591,77.5613
第15任總統副總統,在臺南市各村(里),臺南市,　南區,明德里,36,354,573,963,12,975,0,975,334,1309,74.4843
第15任總統副總統,在臺南市各村(里),臺南市,　南區,大成里,25,361,719,1105,16,1121,0,1121,302,1423,78.7772
第15任總統副總統,在臺南市各村(里),臺南市,　南區,田寮里,100,782,1534,2416,27,2443,0,2443,658,3101,78.7810
第15任總統副總統,在臺南市各村(里),臺南市,　南區,新興里,56,606,1311,1973,23,1996,0,1996,681,2677,74.5611
第15任總統副總統,在臺南市各村(里),臺南市,　南區,再興里,63,482,1151,1696,28,1724,0,1724,506,2230,77.3094
第15任總統副總統,在臺南市各村(里),臺南市,　南區,廣州里,44,472,1229,1745,15,1760,0,1760,455,2215,79.4582
第15任總統副總統,在臺南市各村(里),臺南市,　南區,新昌里,76,520,1083,1679,15,1694,0,1694,504,2198,77.0701
第15任總統副總統,在臺南市各村(里),臺南市,　南區,文華里,86,756,1676,2518,24,2542,0,2542,654,3196,79.5369
第15任總統副總統,在臺南市各村(里),臺南市,　南區,文南里,116,1180,2549,3845,38,3883,0,3883,1090,4973,78.0816
第15任總統副總統,在臺南市各村(里),臺南市,　南區,金華里,130,1051,2508,3689,38,3727,0,3727,1168,4895,76.1389
第15任總統副總統,在臺南市各村(里),臺南市,　南區,國宅里,72,605,1516,2193,25,2218,0,2218,650,2868,77.3361
第15任總統副總統,在臺南市各村(里),臺南市,　南區,鹽埕里,87,757,1969,2813,20,2833,0,2833,817,3650,77.6164
第15任總統副總統,在臺南市各村(里),臺南市,　南區,光明里,99,759,2277,3135,34,3169,0,3169,934,4103,77.2362
第15任總統副總統,在臺南市各村(里),臺南市,　南區,明亮里,100,713,1906,2719,29,2748,0,2748,766,3514,78.2015
第15任總統副總統,在臺南市各村(里),臺南市,　南區,府南里,128,1066,2343,3537,42,3579,0,3579,1119,4698,76.1814
第15任總統副總統,在臺南市各村(里),臺南市,　南區,明興里,94,572,1806,2472,34,2506,0,2506,743,3249,77.1314
第15任總統副總統,在臺南市各村(里),臺南市,　南區,郡南里,80,759,1811,2650,28,2678,0,2678,783,3461,77.3765
第15任總統副總統,在臺南市各村(里),臺南市,　南區,建南里,142,1045,2755,3942,32,3974,0,3974,976,4950,80.2828
第15任總統副總統,在臺南市各村(里),臺南市,　南區,南都里,85,498,1163,1746,14,1760,0,1760,918,2678,65.7207
第15任總統副總統,在臺南市各村(里),臺南市,　南區,南華里,57,536,1153,1746,16,1762,0,1762,601,2363,74.5662
第15任總統副總統,在臺南市各村(里),臺南市,　南區,開南里,166,1203,2768,4137,41,4178,0,4178,1411,5589,74.7540
第15任總統副總統,在臺南市各村(里),臺南市,　南區,彰南里,54,336,816,1206,15,1221,0,1221,353,1574,77.5731
第15任總統副總統,在臺南市各村(里),臺南市,　南區,鯤鯓里,41,361,886,1288,17,1305,0,1305,417,1722,75.7840
第15任總統副總統,在臺南市各村(里),臺南市,　南區,喜北里,42,334,1233,1609,21,1630,0,1630,475,2105,77.4347
第15任總統副總統,在臺南市各村(里),臺南市,　南區,喜南里,15,153,742,910,5,915,0,915,287,1202,76.1231
第15任總統副總統,在臺南市各村(里),臺南市,　南區,喜東里,29,314,1223,1566,15,1581,0,1581,434,2015,78.4615
第15任總統副總統,在臺南市各村(里),臺南市,　南區,省躬里,98,566,1968,2632,28,2660,0,2660,823,3483,76.3709
第15任總統副總統,在臺南市各村(里),臺南市,　南區,永寧里,30,281,1005,1316,19,1335,0,1335,360,1695,78.7611
第15任總統副總統,在臺南市各村(里),臺南市,　南區,松安里,37,264,1042,1343,18,1361,0,1361,358,1719,79.1739
第15任總統副總統,在臺南市各村(里),臺南市,　南區,佛壇里,59,336,1502,1897,13,1910,0,1910,491,2401,79.5502
第15任總統副總統,在臺南市各村(里),臺南市,　南區,同安里,43,349,1237,1629,12,1641,0,1641,489,2130,77.0423
第15任總統副總統,在臺南市各村(里),臺南市,　南區,興農里,80,363,1479,1922,15,1937,0,1937,531,2468,78.4846
第15任總統副總統,在臺南市各村(里),臺南市,　北區,開元里,97,895,1530,2522,31,2553,1,2554,811,3365,75.8692
第15任總統副總統,在臺南市各村(里),臺南市,　北區,元寶里,104,901,1805,2810,31,2841,0,2841,1051,3892,72.9959
第15任總統副總統,在臺南市各村(里),臺南市,　北區,合興里,104,845,1654,2603,30,2633,0,2633,754,3387,77.7384
第15任總統副總統,在臺南市各村(里),臺南市,　北區,力行里,62,672,1080,1814,21,1835,0,1835,550,2385,76.9392
第15任總統副總統,在臺南市各村(里),臺南市,　北區,重興里,61,548,815,1424,15,1439,0,1439,374,1813,79.3712
第15任總統副總統,在臺南市各村(里),臺南市,　北區,東興里,51,656,820,1527,11,1538,0,1538,419,1957,78.5897
第15任總統副總統,在臺南市各村(里),臺南市,　北區,長勝里,125,1474,1224,2823,36,2859,0,2859,1008,3867,73.9333
第15任總統副總統,在臺南市各村(里),臺南市,　北區,振興里,53,490,876,1419,24,1443,0,1443,468,1911,75.5102
第15任總統副總統,在臺南市各村(里),臺南市,　北區,仁愛里,57,553,952,1562,16,1578,0,1578,439,2017,78.2350
第15任總統副總統,在臺南市各村(里),臺南市,　北區,中樓里,42,359,651,1052,20,1072,0,1072,361,1433,74.8081
第15任總統副總統,在臺南市各村(里),臺南市,　北區,永祥里,97,811,1361,2269,18,2287,0,2287,700,2987,76.5651
第15任總統副總統,在臺南市各村(里),臺南市,　北區,北門里,148,1356,2378,3882,46,3928,1,3929,1235,5164,76.0651
第15任總統副總統,在臺南市各村(里),臺南市,　北區,大光里,144,1787,1598,3529,30,3559,0,3559,1220,4779,74.4716
第15任總統副總統,在臺南市各村(里),臺南市,　北區,大興里,93,762,1295,2150,23,2173,0,2173,775,2948,73.7110
第15任總統副總統,在臺南市各村(里),臺南市,　北區,公園里,53,506,710,1269,17,1286,0,1286,501,1787,71.9642
第15任總統副總統,在臺南市各村(里),臺南市,　北區,北華里,88,748,1764,2600,38,2638,0,2638,1395,4033,65.4104
第15任總統副總統,在臺南市各村(里),臺南市,　北區,長興里,76,604,1323,2003,15,2018,0,2018,691,2709,74.4924
第15任總統副總統,在臺南市各村(里),臺南市,　北區,小北里,119,858,1922,2899,36,2935,0,2935,923,3858,76.0757
第15任總統副總統,在臺南市各村(里),臺南市,　北區,正覺里,112,583,1681,2376,22,2398,0,2398,713,3111,77.0813
第15任總統副總統,在臺南市各村(里),臺南市,　北區,成功里,134,923,2289,3346,26,3372,0,3372,939,4311,78.2185
第15任總統副總統,在臺南市各村(里),臺南市,　北區,華德里,94,725,1694,2513,27,2540,0,2540,677,3217,78.9555
第15任總統副總統,在臺南市各村(里),臺南市,　北區,福德里,122,989,2179,3290,39,3329,0,3329,841,4170,79.8321
第15任總統副總統,在臺南市各村(里),臺南市,　北區,成德里,136,992,2093,3221,23,3244,0,3244,908,4152,78.1310
第15任總統副總統,在臺南市各村(里),臺南市,　北區,和順里,161,1140,2329,3630,33,3663,0,3663,1045,4708,77.8037
第15任總統副總統,在臺南市各村(里),臺南市,　北區,立人里,61,540,1308,1909,22,1931,0,1931,577,2508,76.9936
第15任總統副總統,在臺南市各村(里),臺南市,　北區,雙安里,79,582,1062,1723,15,1738,0,1738,473,2211,78.6070
第15任總統副總統,在臺南市各村(里),臺南市,　北區,文成里,98,651,1471,2220,27,2247,0,2247,621,2868,78.3473
第15任總統副總統,在臺南市各村(里),臺南市,　北區,元美里,94,624,1545,2263,27,2290,0,2290,570,2860,80.0699
第15任總統副總統,在臺南市各村(里),臺南市,　北區,文元里,85,642,1756,2483,25,2508,0,2508,737,3245,77.2881
第15任總統副總統,在臺南市各村(里),臺南市,　北區,大和里,95,680,1992,2767,29,2796,0,2796,773,3569,78.3413
第15任總統副總統,在臺南市各村(里),臺南市,　北區,大港里,152,1187,2697,4036,32,4068,0,4068,1153,5221,77.9161
第15任總統副總統,在臺南市各村(里),臺南市,　北區,大豐里,114,839,2207,3160,32,3192,0,3192,1002,4194,76.1087
第15任總統副總統,在臺南市各村(里),臺南市,　北區,賢北里,104,762,1871,2737,33,2770,0,2770,716,3486,79.4607
第15任總統副總統,在臺南市各村(里),臺南市,　安南區,東和里,99,503,1416,2018,22,2040,0,2040,558,2598,78.5219
第15任總統副總統,在臺南市各村(里),臺南市,　安南區,塭南里,124,841,2458,3423,33,3456,0,3456,946,4402,78.5098
第15任總統副總統,在臺南市各村(里),臺南市,　安南區,州南里,123,962,2620,3705,32,3737,0,3737,1091,4828,77.4027
第15任總統副總統,在臺南市各村(里),臺南市,　安南區,州北里,134,823,2411,3368,45,3413,0,3413,975,4388,77.7803
第15任總統副總統,在臺南市各村(里),臺南市,　安南區,安順里,123,914,2449,3486,32,3518,0,3518,1006,4524,77.7630
第15任總統副總統,在臺南市各村(里),臺南市,　安南區,新順里,176,1205,3077,4458,39,4497,0,4497,1318,5815,77.3345
第15任總統副總統,在臺南市各村(里),臺南市,　安南區,頂安里,138,738,2546,3422,29,3451,0,3451,967,4418,78.1123
第15任總統副總統,在臺南市各村(里),臺南市,　安南區,安慶里,161,1011,3303,4475,46,4521,0,4521,1347,5868,77.0450
第15任總統副總統,在臺南市各村(里),臺南市,　安南區,溪北里,86,550,1477,2113,19,2132,0,2132,575,2707,78.7588
第15任總統副總統,在臺南市各村(里),臺南市,　安南區,安和里,44,393,1113,1550,23,1573,0,1573,523,2096,75.0477
第15任總統副總統,在臺南市各村(里),臺南市,　安南區,安西里,93,676,1930,2699,26,2725,0,2725,723,3448,79.0313
第15任總統副總統,在臺南市各村(里),臺南市,　安南區,溪頂里,115,901,2291,3307,34,3341,0,3341,938,4279,78.0790
第15任總統副總統,在臺南市各村(里),臺南市,　安南區,安東里,78,461,1543,2082,34,2116,0,2116,596,2712,78.0236
第15任總統副總統,在臺南市各村(里),臺南市,　安南區,鳳凰里,113,854,2176,3143,25,3168,0,3168,1140,4308,73.5376
第15任總統副總統,在臺南市各村(里),臺南市,　安南區,梅花里,101,738,2051,2890,38,2928,0,2928,985,3913,74.8275
第15任總統副總統,在臺南市各村(里),臺南市,　安南區,理想里,128,837,2456,3421,26,3447,0,3447,981,4428,77.8455
第15任總統副總統,在臺南市各村(里),臺南市,　安南區,海東里,153,940,2853,3946,19,3965,0,3965,1406,5371,73.8224
第15任總統副總統,在臺南市各村(里),臺南市,　安南區,大安里,96,700,1954,2750,36,2786,0,2786,791,3577,77.8865
第15任總統副總統,在臺南市各村(里),臺南市,　安南區,原佃里,71,388,1120,1579,17,1596,0,1596,510,2106,75.7835
第15任總統副總統,在臺南市各村(里),臺南市,　安南區,長安里,139,772,2449,3360,23,3383,0,3383,1136,4519,74.8617
第15任總統副總統,在臺南市各村(里),臺南市,　安南區,公親里,31,186,648,865,12,877,0,877,262,1139,76.9974
第15任總統副總統,在臺南市各村(里),臺南市,　安南區,布袋里,37,316,766,1119,6,1125,0,1125,351,1476,76.2195
第15任總統副總統,在臺南市各村(里),臺南市,　安南區,總頭里,46,307,977,1330,19,1349,0,1349,443,1792,75.2790
第15任總統副總統,在臺南市各村(里),臺南市,　安南區,南興里,51,266,956,1273,14,1287,0,1287,460,1747,73.6691
第15任總統副總統,在臺南市各村(里),臺南市,　安南區,學東里,46,387,1166,1599,13,1612,0,1612,666,2278,70.7638
第15任總統副總統,在臺南市各村(里),臺南市,　安南區,公塭里,17,164,577,758,7,765,0,765,181,946,80.8668
第15任總統副總統,在臺南市各村(里),臺南市,　安南區,佃東里,99,625,1691,2415,31,2446,0,2446,856,3302,74.0763
第15任總統副總統,在臺南市各村(里),臺南市,　安南區,佃西里,55,310,1050,1415,23,1438,0,1438,514,1952,73.6680
第15任總統副總統,在臺南市各村(里),臺南市,　安南區,淵西里,74,576,1794,2444,34,2478,0,2478,822,3300,75.0909
第15任總統副總統,在臺南市各村(里),臺南市,　安南區,海西里,72,543,1392,2007,27,2034,0,2034,672,2706,75.1663
第15任總統副總統,在臺南市各村(里),臺南市,　安南區,溪心里,191,1328,3617,5136,53,5189,0,5189,2226,7415,69.9798
第15任總統副總統,在臺南市各村(里),臺南市,　安南區,淵東里,101,781,2400,3282,40,3322,1,3323,1134,4457,74.5344
第15任總統副總統,在臺南市各村(里),臺南市,　安南區,淵中里,84,602,1734,2420,19,2439,0,2439,789,3228,75.5576
第15任總統副總統,在臺南市各村(里),臺南市,　安南區,溪墘里,76,564,1682,2322,20,2342,0,2342,655,2997,78.1448
第15任總統副總統,在臺南市各村(里),臺南市,　安南區,海佃里,109,748,2338,3195,36,3231,0,3231,916,4147,77.9117
第15任總統副總統,在臺南市各村(里),臺南市,　安南區,國安里,69,425,1230,1724,21,1745,0,1745,451,2196,79.4627
第15任總統副總統,在臺南市各村(里),臺南市,　安南區,溪東里,123,788,2017,2928,31,2959,0,2959,827,3786,78.1564
第15任總統副總統,在臺南市各村(里),臺南市,　安南區,安富里,140,932,2894,3966,45,4011,0,4011,1326,5337,75.1546
第15任總統副總統,在臺南市各村(里),臺南市,　安南區,幸福里,93,590,2015,2698,35,2733,0,2733,770,3503,78.0188
第15任總統副總統,在臺南市各村(里),臺南市,　安南區,海南里,54,360,1082,1496,15,1511,1,1512,429,1941,77.8465
第15任總統副總統,在臺南市各村(里),臺南市,　安南區,城東里,51,286,719,1056,12,1068,0,1068,475,1543,69.2158
第15任總統副總統,在臺南市各村(里),臺南市,　安南區,城南里,70,507,1619,2196,24,2220,0,2220,817,3037,73.0985
第15任總統副總統,在臺南市各村(里),臺南市,　安南區,青草里,37,211,727,975,11,986,0,986,451,1437,68.6152
第15任總統副總統,在臺南市各村(里),臺南市,　安南區,城西里,39,229,755,1023,7,1030,0,1030,333,1363,75.5686
第15任總統副總統,在臺南市各村(里),臺南市,　安南區,城北里,38,257,800,1095,18,1113,0,1113,372,1485,74.9495
第15任總統副總統,在臺南市各村(里),臺南市,　安南區,城中里,39,241,519,799,10,809,0,809,207,1016,79.6260
第15任總統副總統,在臺南市各村(里),臺南市,　安南區,砂崙里,36,191,726,953,7,960,0,960,299,1259,76.2510
第15任總統副總統,在臺南市各村(里),臺南市,　安南區,顯宮里,35,295,691,1021,8,1029,0,1029,383,1412,72.8754
第15任總統副總統,在臺南市各村(里),臺南市,　安南區,鹿耳里,31,206,415,652,13,665,0,665,238,903,73.6434
第15任總統副總統,在臺南市各村(里),臺南市,　安南區,四草里,31,411,893,1335,18,1353,0,1353,449,1802,75.0832
第15任總統副總統,在臺南市各村(里),臺南市,　安南區,塩田里,37,397,701,1135,14,1149,0,1149,335,1484,77.4259
第15任總統副總統,在臺南市各村(里),臺南市,　安平區,文平里,146,1232,2406,3784,41,3825,0,3825,1046,4871,78.5260
第15任總統副總統,在臺南市各村(里),臺南市,　安平區,建平里,131,1142,2443,3716,52,3768,0,3768,1146,4914,76.6789
第15任總統副總統,在臺南市各村(里),臺南市,　安平區,怡平里,118,940,1935,2993,42,3035,0,3035,1048,4083,74.3326
第15任總統副總統,在臺南市各村(里),臺南市,　安平區,華平里,120,1137,2223,3480,32,3512,0,3512,1139,4651,75.5106
第15任總統副總統,在臺南市各村(里),臺南市,　安平區,平通里,186,1565,3159,4910,57,4967,0,4967,1934,6901,71.9751
第15任總統副總統,在臺南市各村(里),臺南市,　安平區,億載里,101,676,1370,2147,27,2174,0,2174,640,2814,77.2566
第15任總統副總統,在臺南市各村(里),臺南市,　安平區,育平里,219,1871,3385,5475,56,5531,0,5531,1933,7464,74.1024
第15任總統副總統,在臺南市各村(里),臺南市,　安平區,國平里,211,1741,3428,5380,48,5428,0,5428,1634,7062,76.8621
第15任總統副總統,在臺南市各村(里),臺南市,　安平區,漁光里,7,87,198,292,2,294,0,294,133,427,68.8525
第15任總統副總統,在臺南市各村(里),臺南市,　安平區,平安里,96,724,1631,2451,25,2476,0,2476,784,3260,75.9509
第15任總統副總統,在臺南市各村(里),臺南市,　安平區,天妃里,84,670,1722,2476,23,2499,0,2499,772,3271,76.3987
第15任總統副總統,在臺南市各村(里),臺南市,　安平區,王城里,52,609,1292,1953,21,1974,0,1974,739,2713,72.7608
第15任總統副總統,在臺南市各村(里),臺南市,　安平區,金城里,52,550,870,1472,11,1483,0,1483,471,1954,75.8956
第15任總統副總統,在臺南市各村(里),臺南市,　中西區,赤嵌里,105,782,1826,2713,27,2740,0,2740,920,3660,74.8634
第15任總統副總統,在臺南市各村(里),臺南市,　中西區,郡王里,81,742,1448,2271,28,2299,0,2299,688,2987,76.9669
第15任總統副總統,在臺南市各村(里),臺南市,　中西區,法華里,102,688,1219,2009,35,2044,0,2044,602,2646,77.2487
第15任總統副總統,在臺南市各村(里),臺南市,　中西區,開山里,80,509,1248,1837,29,1866,0,1866,602,2468,75.6078
第15任總統副總統,在臺南市各村(里),臺南市,　中西區,永華里,69,563,1221,1853,32,1885,0,1885,591,2476,76.1309
第15任總統副總統,在臺南市各村(里),臺南市,　中西區,藥王里,76,695,1747,2518,29,2547,0,2547,834,3381,75.3327
第15任總統副總統,在臺南市各村(里),臺南市,　中西區,光賢里,99,692,1855,2646,31,2677,0,2677,743,3420,78.2749
第15任總統副總統,在臺南市各村(里),臺南市,　中西區,大涼里,79,625,1190,1894,26,1920,0,1920,559,2479,77.4506
第15任總統副總統,在臺南市各村(里),臺南市,　中西區,西湖里,213,1386,2601,4200,51,4251,0,4251,1159,5410,78.5767
第15任總統副總統,在臺南市各村(里),臺南市,　中西區,西賢里,152,1174,2435,3761,52,3813,0,3813,952,4765,80.0210
第15任總統副總統,在臺南市各村(里),臺南市,　中西區,城隍里,100,784,1757,2641,28,2669,0,2669,898,3567,74.8248
第15任總統副總統,在臺南市各村(里),臺南市,　中西區,南美里,70,726,1592,2388,22,2410,0,2410,782,3192,75.5013
第15任總統副總統,在臺南市各村(里),臺南市,　中西區,南門里,83,737,1092,1912,20,1932,0,1932,545,2477,77.9976
第15任總統副總統,在臺南市各村(里),臺南市,　中西區,小西門里,97,757,1394,2248,28,2276,0,2276,772,3048,74.6719
第15任總統副總統,在臺南市各村(里),臺南市,　中西區,五條港里,51,463,999,1513,8,1521,0,1521,511,2032,74.8524
第15任總統副總統,在臺南市各村(里),臺南市,　中西區,兌悅里,96,742,1810,2648,26,2674,0,2674,1164,3838,69.6717
第15任總統副總統,在臺南市各村(里),臺南市,　中西區,淺草里,59,569,1101,1729,16,1745,0,1745,695,2440,71.5164
第15任總統副總統,在臺南市各村(里),臺南市,　中西區,府前里,48,414,941,1403,24,1427,0,1427,513,1940,73.5567
第15任總統副總統,在臺南市各村(里),臺南市,　中西區,南廠里,107,799,2004,2910,34,2944,0,2944,967,3911,75.2749
第15任總統副總統,在臺南市各村(里),臺南市,　中西區,西和里,124,861,1852,2837,30,2867,0,2867,771,3638,78.8070
第15任總統副總統,在臺北市各村(里),臺北市,　松山區,莊敬里,173,1555,1718,3446,62,3508,0,3508,1022,4530,77.4393
第15任總統副總統,在臺北市各村(里),臺北市,　松山區,東榮里,174,2173,2660,5007,73,5080,0,5080,1409,6489,78.2863
第15任總統副總統,在臺北市各村(里),臺北市,　松山區,三民里,192,2010,2175,4377,65,4442,0,4442,1321,5763,77.0779
第15任總統副總統,在臺北市各村(里),臺北市,　松山區,新益里,133,1257,1686,3076,45,3121,0,3121,797,3918,79.6580
第15任總統副總統,在臺北市各村(里),臺北市,　松山區,富錦里,147,1541,1654,3342,53,3395,0,3395,952,4347,78.0998
第15任總統副總統,在臺北市各村(里),臺北市,　松山區,新東里,138,1431,1706,3275,50,3325,0,3325,859,4184,79.4694
第15任總統副總統,在臺北市各村(里),臺北市,　松山區,富泰里,130,1490,1390,3010,45,3055,0,3055,864,3919,77.9536
第15任總統副總統,在臺北市各村(里),臺北市,　松山區,介壽里,105,1167,1492,2764,39,2803,0,2803,781,3584,78.2087
第15任總統副總統,在臺北市各村(里),臺北市,　松山區,精忠里,99,1238,1393,2730,35,2765,1,2766,838,3604,76.7203
第15任總統副總統,在臺北市各村(里),臺北市,　松山區,東光里,202,2156,2330,4688,53,4741,0,4741,1345,6086,77.9001
第15任總統副總統,在臺北市各村(里),臺北市,　松山區,龍田里,308,3566,2599,6473,116,6589,0,6589,1735,8324,79.1567
第15任總統副總統,在臺北市各村(里),臺北市,　松山區,東昌里,79,641,972,1692,15,1707,0,1707,465,2172,78.5912
第15任總統副總統,在臺北市各村(里),臺北市,　松山區,東勢里,113,1131,1468,2712,40,2752,0,2752,823,3575,76.9790
第15任總統副總統,在臺北市各村(里),臺北市,　松山區,中華里,174,1836,1993,4003,57,4060,0,4060,1135,5195,78.1521
第15任總統副總統,在臺北市各村(里),臺北市,　松山區,民有里,223,2266,3193,5682,89,5771,0,5771,1664,7435,77.6194
第15任總統副總統,在臺北市各村(里),臺北市,　松山區,民福里,185,2075,1982,4242,66,4308,0,4308,1244,5552,77.5937
第15任總統副總統,在臺北市各村(里),臺北市,　松山區,松基里,97,962,1297,2356,39,2395,0,2395,707,3102,77.2083
第15任總統副總統,在臺北市各村(里),臺北市,　松山區,安平里,237,2187,3142,5566,78,5644,0,5644,1609,7253,77.8161
第15任總統副總統,在臺北市各村(里),臺北市,　松山區,鵬程里,152,1823,1638,3613,58,3671,0,3671,987,4658,78.8106
第15任總統副總統,在臺北市各村(里),臺北市,　松山區,自強里,290,3980,2178,6448,82,6530,0,6530,1812,8342,78.2786
第15任總統副總統,在臺北市各村(里),臺北市,　松山區,慈祐里,238,1650,2691,4579,57,4636,0,4636,2435,7071,65.5636
第15任總統副總統,在臺北市各村(里),臺北市,　松山區,吉祥里,235,2433,2789,5457,55,5512,0,5512,1646,7158,77.0047
第15任總統副總統,在臺北市各村(里),臺北市,　松山區,新聚里,216,2103,2878,5197,53,5250,0,5250,1551,6801,77.1945
第15任總統副總統,在臺北市各村(里),臺北市,　松山區,復盛里,183,1909,2045,4137,53,4190,0,4190,1216,5406,77.5065
第15任總統副總統,在臺北市各村(里),臺北市,　松山區,中正里,258,2252,3239,5749,84,5833,1,5834,1717,7551,77.2480
第15任總統副總統,在臺北市各村(里),臺北市,　松山區,中崙里,105,1037,1352,2494,32,2526,0,2526,734,3260,77.4847
第15任總統副總統,在臺北市各村(里),臺北市,　松山區,美仁里,87,882,1281,2250,23,2273,0,2273,581,2854,79.6426
第15任總統副總統,在臺北市各村(里),臺北市,　松山區,吉仁里,114,1026,1308,2448,33,2481,0,2481,778,3259,76.1276
第15任總統副總統,在臺北市各村(里),臺北市,　松山區,敦化里,177,1759,2412,4348,54,4402,0,4402,1209,5611,78.4530
第15任總統副總統,在臺北市各村(里),臺北市,　松山區,復源里,74,930,1023,2027,24,2051,0,2051,568,2619,78.3123
第15任總統副總統,在臺北市各村(里),臺北市,　松山區,復建里,133,1247,1391,2771,51,2822,0,2822,833,3655,77.2093
第15任總統副總統,在臺北市各村(里),臺北市,　松山區,復勢里,187,1561,2264,4012,48,4060,0,4060,1171,5231,77.6142
第15任總統副總統,在臺北市各村(里),臺北市,　松山區,福成里,78,644,868,1590,35,1625,0,1625,521,2146,75.7223
第15任總統副總統,在臺北市各村(里),臺北市,　信義區,西村里,116,1869,1122,3107,38,3145,0,3145,1882,5027,62.5622
第15任總統副總統,在臺北市各村(里),臺北市,　信義區,正和里,126,1482,1309,2917,41,2958,0,2958,897,3855,76.7315
第15任總統副總統,在臺北市各村(里),臺北市,　信義區,興隆里,68,842,726,1636,16,1652,1,1653,649,2302,71.7637
第15任總統副總統,在臺北市各村(里),臺北市,　信義區,中興里,86,971,1066,2123,20,2143,0,2143,854,2997,71.5048
第15任總統副總統,在臺北市各村(里),臺北市,　信義區,新仁里,80,1049,951,2080,28,2108,0,2108,670,2778,75.8819
第15任總統副總統,在臺北市各村(里),臺北市,　信義區,興雅里,189,1633,1857,3679,45,3724,1,3725,1162,4887,76.2022
第15任總統副總統,在臺北市各村(里),臺北市,　信義區,敦厚里,147,1451,1708,3306,56,3362,0,3362,1076,4438,75.7548
第15任總統副總統,在臺北市各村(里),臺北市,　信義區,廣居里,198,2230,2408,4836,64,4900,0,4900,1521,6421,76.3121
第15任總統副總統,在臺北市各村(里),臺北市,　信義區,安康里,276,2890,3174,6340,82,6422,0,6422,2033,8455,75.9551
第15任總統副總統,在臺北市各村(里),臺北市,　信義區,六藝里,100,892,1371,2363,32,2395,0,2395,701,3096,77.3579
第15任總統副總統,在臺北市各村(里),臺北市,　信義區,雅祥里,136,1335,1809,3280,42,3322,0,3322,975,4297,77.3098
第15任總統副總統,在臺北市各村(里),臺北市,　信義區,五常里,85,1015,1265,2365,28,2393,0,2393,744,3137,76.2831
第15任總統副總統,在臺北市各村(里),臺北市,　信義區,五全里,127,1232,1901,3260,38,3298,0,3298,921,4219,78.1702
第15任總統副總統,在臺北市各村(里),臺北市,　信義區,永吉里,73,805,1697,2575,30,2605,1,2606,796,3402,76.5726
第15任總統副總統,在臺北市各村(里),臺北市,　信義區,長春里,112,1124,1602,2838,33,2871,2,2873,883,3756,76.4377
第15任總統副總統,在臺北市各村(里),臺北市,　信義區,四育里,153,1421,2164,3738,33,3771,0,3771,1020,4791,78.7101
第15任總統副總統,在臺北市各村(里),臺北市,　信義區,四維里,167,1542,1811,3520,45,3565,0,3565,1073,4638,76.8650
第15任總統副總統,在臺北市各村(里),臺北市,　信義區,永春里,141,1242,1856,3239,41,3280,0,3280,985,4265,76.9050
第15任總統副總統,在臺北市各村(里),臺北市,　信義區,富台里,119,1488,1176,2783,41,2824,0,2824,874,3698,76.3656
第15任總統副總統,在臺北市各村(里),臺北市,　信義區,國業里,205,2082,2358,4645,70,4715,1,4716,1484,6200,76.0484
第15任總統副總統,在臺北市各村(里),臺北市,　信義區,松隆里,56,594,743,1393,10,1403,0,1403,533,1936,72.4690
第15任總統副總統,在臺北市各村(里),臺北市,　信義區,松友里,187,1883,2139,4209,45,4254,1,4255,1310,5565,76.4420
第15任總統副總統,在臺北市各村(里),臺北市,　信義區,松光里,132,1319,1771,3222,43,3265,0,3265,1026,4291,76.0895
第15任總統副總統,在臺北市各村(里),臺北市,　信義區,中坡里,121,1210,1588,2919,46,2965,0,2965,848,3813,77.7603
第15任總統副總統,在臺北市各村(里),臺北市,　信義區,中行里,227,2040,2955,5222,57,5279,1,5280,1521,6801,77.6209
第15任總統副總統,在臺北市各村(里),臺北市,　信義區,大道里,176,1610,2254,4040,67,4107,26,4133,1141,5274,77.8726
第15任總統副總統,在臺北市各村(里),臺北市,　信義區,大仁里,116,1124,1414,2654,30,2684,0,2684,825,3509,76.4890
第15任總統副總統,在臺北市各村(里),臺北市,　信義區,景新里,121,1622,1489,3232,40,3272,0,3272,1062,4334,75.4961
第15任總統副總統,在臺北市各村(里),臺北市,　信義區,惠安里,183,2174,2035,4392,38,4430,0,4430,1275,5705,77.6512
第15任總統副總統,在臺北市各村(里),臺北市,　信義區,三張里,232,2803,2723,5758,71,5829,0,5829,1814,7643,76.2659
第15任總統副總統,在臺北市各村(里),臺北市,　信義區,三犁里,154,1630,1608,3392,45,3437,0,3437,1093,4530,75.8720
第15任總統副總統,在臺北市各村(里),臺北市,　信義區,六合里,169,2251,1967,4387,49,4436,0,4436,1466,5902,75.1610
第15任總統副總統,在臺北市各村(里),臺北市,　信義區,泰和里,210,2256,2485,4951,73,5024,0,5024,1704,6728,74.6730
第15任總統副總統,在臺北市各村(里),臺北市,　信義區,景聯里,173,1371,1563,3107,46,3153,0,3153,850,4003,78.7659
第15任總統副總統,在臺北市各村(里),臺北市,　信義區,景勤里,91,1247,1216,2554,32,2586,0,2586,822,3408,75.8803
第15任總統副總統,在臺北市各村(里),臺北市,　信義區,雙和里,217,2217,2245,4679,57,4736,0,4736,1333,6069,78.0359
第15任總統副總統,在臺北市各村(里),臺北市,　信義區,嘉興里,98,914,1097,2109,21,2130,0,2130,653,2783,76.5361
第15任總統副總統,在臺北市各村(里),臺北市,　信義區,黎順里,99,1209,1291,2599,33,2632,1,2633,927,3560,73.9326
第15任總統副總統,在臺北市各村(里),臺北市,　信義區,黎平里,210,2121,2307,4638,55,4693,0,4693,1334,6027,77.8663
第15任總統副總統,在臺北市各村(里),臺北市,　信義區,黎忠里,145,1431,1548,3124,56,3180,0,3180,979,4159,76.4607
第15任總統副總統,在臺北市各村(里),臺北市,　信義區,黎安里,57,732,516,1305,27,1332,0,1332,473,1805,73.7950
第15任總統副總統,在臺北市各村(里),臺北市,　大安區,德安里,128,1788,1540,3456,37,3493,0,3493,1280,4773,73.1825
第15任總統副總統,在臺北市各村(里),臺北市,　大安區,仁慈里,129,1396,1762,3287,43,3330,0,3330,995,4325,76.9942
第15任總統副總統,在臺北市各村(里),臺北市,　大安區,和安里,191,1975,1971,4137,65,4202,1,4203,1337,5540,75.8484
第15任總統副總統,在臺北市各村(里),臺北市,　大安區,民炤里,196,2106,2561,4863,73,4936,0,4936,1731,6667,74.0363
第15任總統副總統,在臺北市各村(里),臺北市,　大安區,仁愛里,96,1437,1446,2979,34,3013,0,3013,1349,4362,69.0738
第15任總統副總統,在臺北市各村(里),臺北市,　大安區,義村里,158,2032,1472,3662,45,3707,0,3707,1184,4891,75.7923
第15任總統副總統,在臺北市各村(里),臺北市,　大安區,民輝里,146,1868,2204,4218,68,4286,0,4286,1494,5780,74.1522
第15任總統副總統,在臺北市各村(里),臺北市,　大安區,昌隆里,74,873,1085,2032,34,2066,0,2066,723,2789,74.0767
第15任總統副總統,在臺北市各村(里),臺北市,　大安區,誠安里,104,1121,1291,2516,39,2555,0,2555,1017,3572,71.5286
第15任總統副總統,在臺北市各村(里),臺北市,　大安區,光武里,179,2076,2230,4485,82,4567,0,4567,1727,6294,72.5612
第15任總統副總統,在臺北市各村(里),臺北市,　大安區,龍坡里,167,1658,1691,3516,54,3570,1,3571,1128,4699,75.9736
第15任總統副總統,在臺北市各村(里),臺北市,　大安區,龍泉里,133,1307,1603,3043,30,3073,2,3075,965,4040,76.0644
第15任總統副總統,在臺北市各村(里),臺北市,　大安區,古風里,116,1178,1399,2693,41,2734,1,2735,828,3563,76.7331
第15任總統副總統,在臺北市各村(里),臺北市,　大安區,古莊里,196,2008,2351,4555,57,4612,0,4612,1482,6094,75.6810
第15任總統副總統,在臺北市各村(里),臺北市,　大安區,龍安里,157,1789,2092,4038,59,4097,1,4098,2497,6595,62.1228
第15任總統副總統,在臺北市各村(里),臺北市,　大安區,錦安里,145,1650,1753,3548,53,3601,2,3603,1170,4773,75.4452
第15任總統副總統,在臺北市各村(里),臺北市,　大安區,福住里,167,1587,1975,3729,71,3800,0,3800,1254,5054,75.1880
第15任總統副總統,在臺北市各村(里),臺北市,　大安區,永康里,115,1060,1082,2257,32,2289,0,2289,732,3021,75.7696
第15任總統副總統,在臺北市各村(里),臺北市,　大安區,光明里,86,939,1158,2183,31,2214,0,2214,702,2916,75.9259
第15任總統副總統,在臺北市各村(里),臺北市,　大安區,錦泰里,80,1106,1067,2253,22,2275,0,2275,671,2946,77.2234
第15任總統副總統,在臺北市各村(里),臺北市,　大安區,錦華里,155,1600,1807,3562,52,3614,0,3614,971,4585,78.8222
第15任總統副總統,在臺北市各村(里),臺北市,　大安區,龍圖里,165,2072,1993,4230,58,4288,0,4288,1466,5754,74.5221
第15任總統副總統,在臺北市各村(里),臺北市,　大安區,新龍里,194,2423,1691,4308,63,4371,0,4371,1197,5568,78.5022
第15任總統副總統,在臺北市各村(里),臺北市,　大安區,龍陣里,79,1069,1070,2218,31,2249,0,2249,735,2984,75.3686
第15任總統副總統,在臺北市各村(里),臺北市,　大安區,龍雲里,119,1373,1551,3043,32,3075,0,3075,1012,4087,75.2386
第15任總統副總統,在臺北市各村(里),臺北市,　大安區,龍生里,183,1954,1946,4083,59,4142,5,4147,1243,5390,76.8460
第15任總統副總統,在臺北市各村(里),臺北市,　大安區,住安里,115,1529,1469,3113,54,3167,0,3167,1232,4399,71.9936
第15任總統副總統,在臺北市各村(里),臺北市,　大安區,義安里,145,1640,1547,3332,37,3369,0,3369,1197,4566,73.7845
第15任總統副總統,在臺北市各村(里),臺北市,　大安區,通化里,185,1563,2209,3957,52,4009,0,4009,1326,5335,75.1453
第15任總統副總統,在臺北市各村(里),臺北市,　大安區,通安里,148,1585,1743,3476,47,3523,0,3523,1116,4639,75.9431
第15任總統副總統,在臺北市各村(里),臺北市,　大安區,臨江里,126,1199,1343,2668,32,2700,3,2703,860,3563,75.7788
第15任總統副總統,在臺北市各村(里),臺北市,　大安區,法治里,109,1418,1285,2812,45,2857,0,2857,962,3819,74.8102
第15任總統副總統,在臺北市各村(里),臺北市,　大安區,全安里,100,1330,1276,2706,36,2742,0,2742,994,3736,73.3940
第15任總統副總統,在臺北市各村(里),臺北市,　大安區,群賢里,159,1861,1696,3716,57,3773,0,3773,1247,5020,75.1594
第15任總統副總統,在臺北市各村(里),臺北市,　大安區,群英里,220,2769,1568,4557,65,4622,0,4622,1308,5930,77.9427
第15任總統副總統,在臺北市各村(里),臺北市,　大安區,虎嘯里,122,1147,1158,2427,43,2470,1,2471,790,3261,75.7436
第15任總統副總統,在臺北市各村(里),臺北市,　大安區,臥龍里,60,640,620,1320,15,1335,0,1335,408,1743,76.5921
第15任總統副總統,在臺北市各村(里),臺北市,　大安區,龍淵里,232,2550,2951,5733,90,5823,0,5823,1656,7479,77.8580
第15任總統副總統,在臺北市各村(里),臺北市,　大安區,龍門里,101,1226,1350,2677,19,2696,0,2696,851,3547,76.0079
第15任總統副總統,在臺北市各村(里),臺北市,　大安區,大學里,236,2488,2688,5412,73,5485,1,5486,1650,7136,76.8638
第15任總統副總統,在臺北市各村(里),臺北市,　大安區,芳和里,140,1754,1796,3690,44,3734,0,3734,1207,4941,75.5717
第15任總統副總統,在臺北市各村(里),臺北市,　大安區,黎元里,139,1557,1844,3540,44,3584,0,3584,1100,4684,76.5158
第15任總統副總統,在臺北市各村(里),臺北市,　大安區,黎孝里,235,2307,2562,5104,76,5180,0,5180,1440,6620,78.2477
第15任總統副總統,在臺北市各村(里),臺北市,　大安區,黎和里,119,1575,1451,3145,29,3174,2,3176,954,4130,76.8523
第15任總統副總統,在臺北市各村(里),臺北市,　大安區,建安里,124,1398,1410,2932,32,2964,0,2964,1160,4124,71.8720
第15任總統副總統,在臺北市各村(里),臺北市,　大安區,建倫里,132,1733,1785,3650,48,3698,0,3698,1471,5169,71.5419
第15任總統副總統,在臺北市各村(里),臺北市,　大安區,敦安里,146,1694,1942,3782,36,3818,2,3820,1366,5186,73.6213
第15任總統副總統,在臺北市各村(里),臺北市,　大安區,正聲里,125,1394,1330,2849,48,2897,0,2897,1106,4003,72.3707
第15任總統副總統,在臺北市各村(里),臺北市,　大安區,敦煌里,157,1629,1895,3681,48,3729,0,3729,1256,4985,74.8044
第15任總統副總統,在臺北市各村(里),臺北市,　大安區,華聲里,102,1240,1255,2597,42,2639,0,2639,944,3583,73.6534
第15任總統副總統,在臺北市各村(里),臺北市,　大安區,車層里,140,1797,1944,3881,39,3920,0,3920,1394,5314,73.7674
第15任總統副總統,在臺北市各村(里),臺北市,　大安區,光信里,196,2175,2345,4716,64,4780,0,4780,1559,6339,75.4062
第15任總統副總統,在臺北市各村(里),臺北市,　大安區,學府里,63,847,724,1634,21,1655,0,1655,591,2246,73.6866
第15任總統副總統,在臺北市各村(里),臺北市,　中山區,正守里,108,826,1164,2098,45,2143,0,2143,689,2832,75.6709
第15任總統副總統,在臺北市各村(里),臺北市,　中山區,正義里,156,1396,1715,3267,41,3308,0,3308,1317,4625,71.5243
第15任總統副總統,在臺北市各村(里),臺北市,　中山區,正得里,79,997,1251,2327,34,2361,0,2361,888,3249,72.6685
第15任總統副總統,在臺北市各村(里),臺北市,　中山區,民安里,120,1072,1735,2927,40,2967,0,2967,927,3894,76.1941
第15任總統副總統,在臺北市各村(里),臺北市,　中山區,康樂里,67,766,824,1657,18,1675,0,1675,643,2318,72.2606
第15任總統副總統,在臺北市各村(里),臺北市,　中山區,中山里,210,1692,2411,4313,55,4368,0,4368,1648,6016,72.6064
第15任總統副總統,在臺北市各村(里),臺北市,　中山區,聚盛里,125,1185,1327,2637,41,2678,0,2678,1034,3712,72.1444
第15任總統副總統,在臺北市各村(里),臺北市,　中山區,集英里,217,1506,2780,4503,40,4543,0,4543,1476,6019,75.4777
第15任總統副總統,在臺北市各村(里),臺北市,　中山區,聚葉里,116,979,1448,2543,35,2578,0,2578,940,3518,73.2803
第15任總統副總統,在臺北市各村(里),臺北市,　中山區,恆安里,128,1274,1647,3049,38,3087,0,3087,1189,4276,72.1936
第15任總統副總統,在臺北市各村(里),臺北市,　中山區,晴光里,144,1479,1826,3449,47,3496,0,3496,1360,4856,71.9934
第15任總統副總統,在臺北市各村(里),臺北市,　中山區,圓山里,149,1026,1549,2724,34,2758,0,2758,912,3670,75.1499
第15任總統副總統,在臺北市各村(里),臺北市,　中山區,新庄里,131,1224,1944,3299,43,3342,0,3342,968,4310,77.5406
第15任總統副總統,在臺北市各村(里),臺北市,　中山區,劍潭里,105,1611,648,2364,36,2400,0,2400,734,3134,76.5795
第15任總統副總統,在臺北市各村(里),臺北市,　中山區,大直里,261,2614,2960,5835,78,5913,0,5913,1637,7550,78.3179
第15任總統副總統,在臺北市各村(里),臺北市,　中山區,成功里,181,1656,2203,4040,57,4097,0,4097,1229,5326,76.9245
第15任總統副總統,在臺北市各村(里),臺北市,　中山區,永安里,232,2428,3178,5838,110,5948,0,5948,1807,7755,76.6989
第15任總統副總統,在臺北市各村(里),臺北市,　中山區,金泰里,263,2034,2384,4681,66,4747,0,4747,1433,6180,76.8123
第15任總統副總統,在臺北市各村(里),臺北市,　中山區,北安里,60,842,827,1729,25,1754,0,1754,468,2222,78.9379
第15任總統副總統,在臺北市各村(里),臺北市,　中山區,新喜里,177,1155,2084,3416,44,3460,0,3460,1045,4505,76.8036
第15任總統副總統,在臺北市各村(里),臺北市,　中山區,新福里,134,1104,2123,3361,42,3403,0,3403,1016,4419,77.0084
第15任總統副總統,在臺北市各村(里),臺北市,　中山區,松江里,186,1522,2431,4139,47,4186,0,4186,1199,5385,77.7344
第15任總統副總統,在臺北市各村(里),臺北市,　中山區,新生里,117,1193,1903,3213,45,3258,1,3259,983,4242,76.8034
第15任總統副總統,在臺北市各村(里),臺北市,　中山區,中庄里,146,1141,1998,3285,42,3327,0,3327,1116,4443,74.8818
第15任總統副總統,在臺北市各村(里),臺北市,　中山區,大佳里,30,186,453,669,9,678,0,678,214,892,76.0090
第15任總統副總統,在臺北市各村(里),臺北市,　中山區,行政里,183,1565,2255,4003,50,4053,0,4053,2650,6703,60.4655
第15任總統副總統,在臺北市各村(里),臺北市,　中山區,行仁里,226,1857,3253,5336,71,5407,0,5407,1558,6965,77.6310
第15任總統副總統,在臺北市各村(里),臺北市,　中山區,行孝里,129,906,1653,2688,25,2713,0,2713,855,3568,76.0370
第15任總統副總統,在臺北市各村(里),臺北市,　中山區,下埤里,252,1845,2937,5034,61,5095,0,5095,1418,6513,78.2282
第15任總統副總統,在臺北市各村(里),臺北市,　中山區,江寧里,222,1787,2553,4562,69,4631,0,4631,1311,5942,77.9367
第15任總統副總統,在臺北市各村(里),臺北市,　中山區,江山里,218,1854,2916,4988,56,5044,0,5044,1400,6444,78.2744
第15任總統副總統,在臺北市各村(里),臺北市,　中山區,中吉里,156,1243,2202,3601,39,3640,1,3641,1105,4746,76.6962
第15任總統副總統,在臺北市各村(里),臺北市,　中山區,中原里,138,1239,2032,3409,47,3456,0,3456,973,4429,78.0312
第15任總統副總統,在臺北市各村(里),臺北市,　中山區,興亞里,155,1280,2009,3444,49,3493,0,3493,1115,4608,75.8030
第15任總統副總統,在臺北市各村(里),臺北市,　中山區,中央里,87,932,1334,2353,40,2393,0,2393,631,3024,79.1336
第15任總統副總統,在臺北市各村(里),臺北市,　中山區,朱馥里,150,1513,2024,3687,47,3734,0,3734,1227,4961,75.2671
第15任總統副總統,在臺北市各村(里),臺北市,　中山區,龍洲里,152,1971,1300,3423,46,3469,0,3469,946,4415,78.5730
第15任總統副總統,在臺北市各村(里),臺北市,　中山區,朱園里,230,1091,1727,3048,38,3086,0,3086,850,3936,78.4045
第15任總統副總統,在臺北市各村(里),臺北市,　中山區,埤頭里,83,875,1181,2139,30,2169,0,2169,685,2854,75.9986
第15任總統副總統,在臺北市各村(里),臺北市,　中山區,朱崙里,78,731,1073,1882,39,1921,0,1921,584,2505,76.6866
第15任總統副總統,在臺北市各村(里),臺北市,　中山區,力行里,153,1496,2290,3939,57,3996,0,3996,1240,5236,76.3178
第15任總統副總統,在臺北市各村(里),臺北市,　中山區,復華里,113,1398,1470,2981,46,3027,0,3027,966,3993,75.8077
第15任總統副總統,在臺北市各村(里),臺北市,　中正區,永功里,173,1484,2162,3819,55,3874,0,3874,1192,5066,76.4706
第15任總統副總統,在臺北市各村(里),臺北市,　中正區,永昌里,146,1396,1775,3317,43,3360,0,3360,994,4354,77.1704
第15任總統副總統,在臺北市各村(里),臺北市,　中正區,龍興里,115,945,1270,2330,23,2353,0,2353,664,3017,77.9914
第15任總統副總統,在臺北市各村(里),臺北市,　中正區,忠勤里,162,1876,2059,4097,58,4155,0,4155,1507,5662,73.3840
第15任總統副總統,在臺北市各村(里),臺北市,　中正區,廈安里,139,1036,1519,2694,30,2724,0,2724,765,3489,78.0739
第15任總統副總統,在臺北市各村(里),臺北市,　中正區,愛國里,74,776,1078,1928,36,1964,0,1964,611,2575,76.2718
第15任總統副總統,在臺北市各村(里),臺北市,　中正區,南門里,94,806,777,1677,24,1701,0,1701,473,2174,78.2429
第15任總統副總統,在臺北市各村(里),臺北市,　中正區,龍光里,92,960,991,2043,27,2070,0,2070,575,2645,78.2609
第15任總統副總統,在臺北市各村(里),臺北市,　中正區,南福里,336,2891,3443,6670,91,6761,1,6762,1850,8612,78.5067
第15任總統副總統,在臺北市各村(里),臺北市,　中正區,龍福里,146,1421,1829,3396,40,3436,0,3436,957,4393,78.2153
第15任總統副總統,在臺北市各村(里),臺北市,　中正區,新營里,252,2613,2502,5367,82,5449,0,5449,1480,6929,78.6405
第15任總統副總統,在臺北市各村(里),臺北市,　中正區,建國里,39,409,452,900,11,911,0,911,288,1199,75.9800
第15任總統副總統,在臺北市各村(里),臺北市,　中正區,光復里,100,961,1211,2272,24,2296,0,2296,806,3102,74.0168
第15任總統副總統,在臺北市各村(里),臺北市,　中正區,黎明里,84,854,962,1900,22,1922,0,1922,721,2643,72.7204
第15任總統副總統,在臺北市各村(里),臺北市,　中正區,梅花里,92,853,1102,2047,36,2083,0,2083,602,2685,77.5791
第15任總統副總統,在臺北市各村(里),臺北市,　中正區,幸福里,128,1355,1514,2997,56,3053,0,3053,1782,4835,63.1437
第15任總統副總統,在臺北市各村(里),臺北市,　中正區,幸市里,112,1206,1545,2863,49,2912,0,2912,944,3856,75.5187
第15任總統副總統,在臺北市各村(里),臺北市,　中正區,東門里,98,1170,1130,2398,39,2437,0,2437,734,3171,76.8527
第15任總統副總統,在臺北市各村(里),臺北市,　中正區,文北里,142,1461,1907,3510,50,3560,0,3560,1096,4656,76.4605
第15任總統副總統,在臺北市各村(里),臺北市,　中正區,文祥里,208,2066,2480,4754,79,4833,1,4834,1459,6293,76.7996
第15任總統副總統,在臺北市各村(里),臺北市,　中正區,三愛里,236,2277,2775,5288,75,5363,0,5363,1699,7062,75.9417
第15任總統副總統,在臺北市各村(里),臺北市,　中正區,水源里,89,806,1013,1908,17,1925,0,1925,643,2568,74.9611
第15任總統副總統,在臺北市各村(里),臺北市,　中正區,富水里,86,804,686,1576,17,1593,0,1593,550,2143,74.3350
第15任總統副總統,在臺北市各村(里),臺北市,　中正區,文盛里,89,709,865,1663,19,1682,0,1682,495,2177,77.2623
第15任總統副總統,在臺北市各村(里),臺北市,　中正區,林興里,128,1461,1411,3000,43,3043,0,3043,978,4021,75.6777
第15任總統副總統,在臺北市各村(里),臺北市,　中正區,河堤里,133,1394,1439,2966,32,2998,0,2998,1003,4001,74.9313
第15任總統副總統,在臺北市各村(里),臺北市,　中正區,頂東里,172,1731,2030,3933,41,3974,0,3974,1186,5160,77.0155
第15任總統副總統,在臺北市各村(里),臺北市,　中正區,網溪里,155,1722,1929,3806,46,3852,0,3852,1131,4983,77.3028
第15任總統副總統,在臺北市各村(里),臺北市,　中正區,板溪里,86,970,1097,2153,32,2185,0,2185,646,2831,77.1812
第15任總統副總統,在臺北市各村(里),臺北市,　中正區,螢圃里,171,1678,1786,3635,50,3685,0,3685,1146,4831,76.2782
第15任總統副總統,在臺北市各村(里),臺北市,　中正區,螢雪里,111,1370,1444,2925,45,2970,0,2970,857,3827,77.6065
第15任總統副總統,在臺北市各村(里),臺北市,　大同區,玉泉里,68,667,1198,1933,22,1955,0,1955,581,2536,77.0899
第15任總統副總統,在臺北市各村(里),臺北市,　大同區,建明里,81,723,1273,2077,24,2101,1,2102,782,2884,72.8502
第15任總統副總統,在臺北市各村(里),臺北市,　大同區,建功里,145,969,1911,3025,41,3066,0,3066,994,4060,75.5172
第15任總統副總統,在臺北市各村(里),臺北市,　大同區,建泰里,115,730,1507,2352,30,2382,0,2382,703,3085,77.2123
第15任總統副總統,在臺北市各村(里),臺北市,　大同區,永樂里,152,999,2243,3394,26,3420,0,3420,1070,4490,76.1693
第15任總統副總統,在臺北市各村(里),臺北市,　大同區,朝陽里,116,961,1773,2850,44,2894,0,2894,956,3850,75.1688
第15任總統副總統,在臺北市各村(里),臺北市,　大同區,星明里,149,1318,2263,3730,40,3770,0,3770,1208,4978,75.7332
第15任總統副總統,在臺北市各村(里),臺北市,　大同區,光能里,159,1023,2093,3275,37,3312,0,3312,885,4197,78.9135
第15任總統副總統,在臺北市各村(里),臺北市,　大同區,大有里,139,861,2083,3083,40,3123,2,3125,903,4028,77.5323
第15任總統副總統,在臺北市各村(里),臺北市,　大同區,延平里,136,936,1659,2731,31,2762,0,2762,880,3642,75.8375
第15任總統副總統,在臺北市各村(里),臺北市,　大同區,雙連里,260,1836,3742,5838,83,5921,0,5921,1810,7731,76.5878
第15任總統副總統,在臺北市各村(里),臺北市,　大同區,南芳里,95,825,1658,2578,28,2606,0,2606,795,3401,76.6245
第15任總統副總統,在臺北市各村(里),臺北市,　大同區,民權里,185,1303,2458,3946,56,4002,0,4002,1182,5184,77.1991
第15任總統副總統,在臺北市各村(里),臺北市,　大同區,景星里,69,496,1081,1646,31,1677,0,1677,625,2302,72.8497
第15任總統副總統,在臺北市各村(里),臺北市,　大同區,隆和里,74,565,1300,1939,29,1968,0,1968,615,2583,76.1905
第15任總統副總統,在臺北市各村(里),臺北市,　大同區,蓬萊里,143,1029,2062,3234,42,3276,0,3276,967,4243,77.2095
第15任總統副總統,在臺北市各村(里),臺北市,　大同區,國順里,71,482,1173,1726,15,1741,0,1741,560,2301,75.6628
第15任總統副總統,在臺北市各村(里),臺北市,　大同區,國慶里,112,936,1924,2972,31,3003,0,3003,840,3843,78.1421
第15任總統副總統,在臺北市各村(里),臺北市,　大同區,揚雅里,114,698,1594,2406,28,2434,0,2434,1587,4021,60.5322
第15任總統副總統,在臺北市各村(里),臺北市,　大同區,斯文里,142,947,1971,3060,53,3113,0,3113,1030,4143,75.1388
第15任總統副總統,在臺北市各村(里),臺北市,　大同區,鄰江里,211,1304,2812,4327,60,4387,0,4387,1246,5633,77.8803
第15任總統副總統,在臺北市各村(里),臺北市,　大同區,至聖里,228,1667,3354,5249,58,5307,2,5309,1602,6911,76.7906
第15任總統副總統,在臺北市各村(里),臺北市,　大同區,老師里,167,1095,2606,3868,36,3904,0,3904,1158,5062,77.1237
第15任總統副總統,在臺北市各村(里),臺北市,　大同區,重慶里,192,1489,2525,4206,55,4261,0,4261,1226,5487,77.6563
第15任總統副總統,在臺北市各村(里),臺北市,　大同區,保安里,140,814,1743,2697,31,2728,0,2728,765,3493,78.0991
第15任總統副總統,在臺北市各村(里),臺北市,　萬華區,福星里,137,1562,1687,3386,42,3428,0,3428,1296,4724,72.5656
第15任總統副總統,在臺北市各村(里),臺北市,　萬華區,萬壽里,70,929,987,1986,30,2016,0,2016,920,2936,68.6649
第15任總統副總統,在臺北市各村(里),臺北市,　萬華區,西門里,100,1057,1193,2350,29,2379,0,2379,903,3282,72.4863
第15任總統副總統,在臺北市各村(里),臺北市,　萬華區,新起里,192,1725,2468,4385,60,4445,0,4445,1513,5958,74.6056
第15任總統副總統,在臺北市各村(里),臺北市,　萬華區,菜園里,182,1448,2404,4034,49,4083,3,4086,1289,5375,75.9628
第15任總統副總統,在臺北市各村(里),臺北市,　萬華區,青山里,140,1393,2176,3709,35,3744,0,3744,1366,5110,73.2681
第15任總統副總統,在臺北市各村(里),臺北市,　萬華區,富民里,125,1075,1993,3193,43,3236,0,3236,1095,4331,74.7172
第15任總統副總統,在臺北市各村(里),臺北市,　萬華區,福音里,110,934,1538,2582,31,2613,0,2613,790,3403,76.7852
第15任總統副總統,在臺北市各村(里),臺北市,　萬華區,仁德里,138,1155,1858,3151,36,3187,0,3187,997,4184,76.1711
第15任總統副總統,在臺北市各村(里),臺北市,　萬華區,富福里,117,1059,2011,3187,36,3223,0,3223,2181,5404,59.6410
第15任總統副總統,在臺北市各村(里),臺北市,　萬華區,柳鄉里,138,1083,2079,3300,29,3329,0,3329,1158,4487,74.1921
第15任總統副總統,在臺北市各村(里),臺北市,　萬華區,華江里,262,1885,3344,5491,70,5561,0,5561,1780,7341,75.7526
第15任總統副總統,在臺北市各村(里),臺北市,　萬華區,糖廍里,133,1238,2141,3512,46,3558,0,3558,1175,4733,75.1743
第15任總統副總統,在臺北市各村(里),臺北市,　萬華區,綠堤里,108,1069,1558,2735,42,2777,0,2777,937,3714,74.7711
第15任總統副總統,在臺北市各村(里),臺北市,　萬華區,頂碩里,182,1516,2976,4674,70,4744,0,4744,1416,6160,77.0130
第15任總統副總統,在臺北市各村(里),臺北市,　萬華區,雙園里,147,981,1807,2935,50,2985,0,2985,863,3848,77.5728
第15任總統副總統,在臺北市各村(里),臺北市,　萬華區,和平里,182,1362,2973,4517,61,4578,2,4580,1420,6000,76.3000
第15任總統副總統,在臺北市各村(里),臺北市,　萬華區,和德里,171,1340,2629,4140,52,4192,0,4192,1549,5741,73.0186
第15任總統副總統,在臺北市各村(里),臺北市,　萬華區,全德里,117,991,1616,2724,45,2769,0,2769,822,3591,77.1094
第15任總統副總統,在臺北市各村(里),臺北市,　萬華區,日善里,107,830,1469,2406,30,2436,0,2436,682,3118,78.1270
第15任總統副總統,在臺北市各村(里),臺北市,　萬華區,忠德里,126,943,1798,2867,37,2904,0,2904,886,3790,76.6227
第15任總統副總統,在臺北市各村(里),臺北市,　萬華區,錦德里,158,1216,2253,3627,34,3661,0,3661,1144,4805,76.1915
第15任總統副總統,在臺北市各村(里),臺北市,　萬華區,孝德里,96,657,1436,2189,20,2209,0,2209,572,2781,79.4319
第15任總統副總統,在臺北市各村(里),臺北市,　萬華區,壽德里,117,1217,1937,3271,39,3310,0,3310,1018,4328,76.4787
第15任總統副總統,在臺北市各村(里),臺北市,　萬華區,銘德里,121,1055,1903,3079,51,3130,0,3130,943,4073,76.8475
第15任總統副總統,在臺北市各村(里),臺北市,　萬華區,保德里,81,794,1284,2159,24,2183,0,2183,614,2797,78.0479
第15任總統副總統,在臺北市各村(里),臺北市,　萬華區,榮德里,104,853,1471,2428,39,2467,0,2467,661,3128,78.8683
第15任總統副總統,在臺北市各村(里),臺北市,　萬華區,華中里,154,1445,2504,4103,45,4148,0,4148,1170,5318,77.9992
第15任總統副總統,在臺北市各村(里),臺北市,　萬華區,興德里,122,1025,1768,2915,40,2955,0,2955,1003,3958,74.6589
第15任總統副總統,在臺北市各村(里),臺北市,　萬華區,日祥里,186,2005,1715,3906,60,3966,0,3966,1175,5141,77.1445
第15任總統副總統,在臺北市各村(里),臺北市,　萬華區,忠貞里,141,1786,1243,3170,46,3216,0,3216,1027,4243,75.7954
第15任總統副總統,在臺北市各村(里),臺北市,　萬華區,新忠里,95,1511,704,2310,23,2333,0,2333,671,3004,77.6631
第15任總統副總統,在臺北市各村(里),臺北市,　萬華區,新和里,254,3459,2050,5763,81,5844,0,5844,1471,7315,79.8906
第15任總統副總統,在臺北市各村(里),臺北市,　萬華區,新安里,194,1850,1817,3861,53,3914,0,3914,1417,5331,73.4196
第15任總統副總統,在臺北市各村(里),臺北市,　萬華區,凌霄里,118,1222,1108,2448,29,2477,0,2477,706,3183,77.8197
第15任總統副總統,在臺北市各村(里),臺北市,　萬華區,騰雲里,83,1030,968,2081,29,2110,0,2110,558,2668,79.0855
第15任總統副總統,在臺北市各村(里),臺北市,　文山區,景行里,228,1962,2480,4670,60,4730,0,4730,1345,6075,77.8601
第15任總統副總統,在臺北市各村(里),臺北市,　文山區,景東里,209,2285,1991,4485,66,4551,0,4551,1390,5941,76.6033
第15任總統副總統,在臺北市各村(里),臺北市,　文山區,景美里,137,1539,1607,3283,41,3324,1,3325,950,4275,77.7544
第15任總統副總統,在臺北市各村(里),臺北市,　文山區,景慶里,178,1887,2063,4128,36,4164,0,4164,1294,5458,76.2917
第15任總統副總統,在臺北市各村(里),臺北市,　文山區,景仁里,170,1685,1583,3438,51,3489,1,3490,1008,4498,77.5678
第15任總統副總統,在臺北市各村(里),臺北市,　文山區,景華里,156,1849,1742,3747,37,3784,0,3784,1072,4856,77.9242
第15任總統副總統,在臺北市各村(里),臺北市,　文山區,萬有里,178,1764,1680,3622,49,3671,0,3671,1013,4684,78.3732
第15任總統副總統,在臺北市各村(里),臺北市,　文山區,萬祥里,117,1317,1509,2943,43,2986,0,2986,902,3888,76.8004
第15任總統副總統,在臺北市各村(里),臺北市,　文山區,萬隆里,199,2362,2132,4693,71,4764,0,4764,1292,6056,78.6658
第15任總統副總統,在臺北市各村(里),臺北市,　文山區,萬年里,171,1557,1784,3512,54,3566,0,3566,1048,4614,77.2865
第15任總統副總統,在臺北市各村(里),臺北市,　文山區,萬和里,84,1269,825,2178,18,2196,0,2196,613,2809,78.1773
第15任總統副總統,在臺北市各村(里),臺北市,　文山區,萬盛里,133,1552,1470,3155,46,3201,0,3201,920,4121,77.6753
第15任總統副總統,在臺北市各村(里),臺北市,　文山區,興豐里,155,1591,1466,3212,38,3250,0,3250,866,4116,78.9602
第15任總統副總統,在臺北市各村(里),臺北市,　文山區,興邦里,141,1780,1354,3275,56,3331,0,3331,926,4257,78.2476
第15任總統副總統,在臺北市各村(里),臺北市,　文山區,興光里,100,1093,950,2143,35,2178,0,2178,667,2845,76.5554
第15任總統副總統,在臺北市各村(里),臺北市,　文山區,興家里,226,2510,2261,4997,64,5061,0,5061,1340,6401,79.0658
第15任總統副總統,在臺北市各村(里),臺北市,　文山區,興得里,167,1899,1777,3843,59,3902,0,3902,1125,5027,77.6208
第15任總統副總統,在臺北市各村(里),臺北市,　文山區,興業里,152,1983,1525,3660,45,3705,0,3705,1041,4746,78.0657
第15任總統副總統,在臺北市各村(里),臺北市,　文山區,興安里,177,2346,1860,4383,73,4456,0,4456,1229,5685,78.3817
第15任總統副總統,在臺北市各村(里),臺北市,　文山區,興福里,159,1734,1747,3640,45,3685,0,3685,982,4667,78.9586
第15任總統副總統,在臺北市各村(里),臺北市,　文山區,興旺里,259,2779,2241,5279,84,5363,0,5363,1698,7061,75.9524
第15任總統副總統,在臺北市各村(里),臺北市,　文山區,興泰里,115,1275,1232,2622,38,2660,0,2660,797,3457,76.9453
第15任總統副總統,在臺北市各村(里),臺北市,　文山區,興昌里,194,2197,1850,4241,63,4304,0,4304,1393,5697,75.5485
第15任總統副總統,在臺北市各村(里),臺北市,　文山區,試院里,198,2386,1963,4547,65,4612,0,4612,1219,5831,79.0945
第15任總統副總統,在臺北市各村(里),臺北市,　文山區,華興里,268,2901,2662,5831,66,5897,0,5897,1699,7596,77.6330
第15任總統副總統,在臺北市各村(里),臺北市,　文山區,明義里,125,1287,1278,2690,38,2728,1,2729,960,3689,73.9496
第15任總統副總統,在臺北市各村(里),臺北市,　文山區,明興里,207,2213,2013,4433,71,4504,0,4504,1405,5909,76.2227
第15任總統副總統,在臺北市各村(里),臺北市,　文山區,木柵里,249,3091,2352,5692,80,5772,0,5772,1715,7487,77.0936
第15任總統副總統,在臺北市各村(里),臺北市,　文山區,木新里,229,2637,3017,5883,77,5960,0,5960,2864,8824,67.5431
第15任總統副總統,在臺北市各村(里),臺北市,　文山區,順興里,218,2215,2373,4806,77,4883,0,4883,1363,6246,78.1780
第15任總統副總統,在臺北市各村(里),臺北市,　文山區,忠順里,118,1504,1100,2722,39,2761,0,2761,772,3533,78.1489
第15任總統副總統,在臺北市各村(里),臺北市,　文山區,樟林里,250,2715,2401,5366,87,5453,0,5453,1665,7118,76.6086
第15任總統副總統,在臺北市各村(里),臺北市,　文山區,樟新里,164,1707,1662,3533,60,3593,0,3593,1037,4630,77.6026
第15任總統副總統,在臺北市各村(里),臺北市,　文山區,樟文里,146,1833,2016,3995,60,4055,0,4055,1113,5168,78.4636
第15任總統副總統,在臺北市各村(里),臺北市,　文山區,樟腳里,174,1653,1815,3642,52,3694,0,3694,1026,4720,78.2627
第15任總統副總統,在臺北市各村(里),臺北市,　文山區,樟樹里,153,1420,1573,3146,35,3181,0,3181,865,4046,78.6209
第15任總統副總統,在臺北市各村(里),臺北市,　文山區,萬芳里,243,2525,2301,5069,61,5130,0,5130,1553,6683,76.7619
第15任總統副總統,在臺北市各村(里),臺北市,　文山區,萬美里,192,2434,2093,4719,56,4775,0,4775,1516,6291,75.9021
第15任總統副總統,在臺北市各村(里),臺北市,　文山區,博嘉里,185,1749,1796,3730,48,3778,0,3778,1254,5032,75.0795
第15任總統副總統,在臺北市各村(里),臺北市,　文山區,萬興里,238,2457,2659,5354,91,5445,0,5445,1530,6975,78.0645
第15任總統副總統,在臺北市各村(里),臺北市,　文山區,政大里,231,2107,2205,4543,61,4604,0,4604,1360,5964,77.1965
第15任總統副總統,在臺北市各村(里),臺北市,　文山區,指南里,96,1078,1355,2529,34,2563,0,2563,822,3385,75.7164
第15任總統副總統,在臺北市各村(里),臺北市,　文山區,老泉里,13,178,366,557,9,566,0,566,187,753,75.1660
第15任總統副總統,在臺北市各村(里),臺北市,　南港區,南港里,175,1529,2178,3882,55,3937,0,3937,1603,5540,71.0650
第15任總統副總統,在臺北市各村(里),臺北市,　南港區,中南里,108,869,1402,2379,31,2410,0,2410,787,3197,75.3832
第15任總統副總統,在臺北市各村(里),臺北市,　南港區,三重里,201,1949,2522,4672,65,4737,0,4737,1545,6282,75.4059
第15任總統副總統,在臺北市各村(里),臺北市,　南港區,新富里,133,892,1553,2578,29,2607,0,2607,763,3370,77.3591
第15任總統副總統,在臺北市各村(里),臺北市,　南港區,中研里,272,2428,3450,6150,84,6234,0,6234,1687,7921,78.7022
第15任總統副總統,在臺北市各村(里),臺北市,　南港區,九如里,186,1985,1986,4157,54,4211,0,4211,1255,5466,77.0399
第15任總統副總統,在臺北市各村(里),臺北市,　南港區,舊莊里,267,2095,3245,5607,97,5704,0,5704,1920,7624,74.8164
第15任總統副總統,在臺北市各村(里),臺北市,　南港區,東新里,199,1824,2711,4734,57,4791,0,4791,1374,6165,77.7129
第15任總統副總統,在臺北市各村(里),臺北市,　南港區,重陽里,158,1448,1774,3380,51,3431,0,3431,993,4424,77.5542
第15任總統副總統,在臺北市各村(里),臺北市,　南港區,東明里,152,1323,1537,3012,39,3051,0,3051,924,3975,76.7547
第15任總統副總統,在臺北市各村(里),臺北市,　南港區,西新里,141,993,1973,3107,47,3154,0,3154,886,4040,78.0693
第15任總統副總統,在臺北市各村(里),臺北市,　南港區,玉成里,150,1131,1827,3108,29,3137,0,3137,957,4094,76.6243
第15任總統副總統,在臺北市各村(里),臺北市,　南港區,合成里,185,1821,2480,4486,53,4539,0,4539,1232,5771,78.6519
第15任總統副總統,在臺北市各村(里),臺北市,　南港區,新光里,101,1110,1238,2449,23,2472,0,2472,704,3176,77.8338
第15任總統副總統,在臺北市各村(里),臺北市,　南港區,聯成里,150,1514,1732,3396,53,3449,0,3449,909,4358,79.1418
第15任總統副總統,在臺北市各村(里),臺北市,　南港區,萬福里,135,1340,1504,2979,39,3018,0,3018,709,3727,80.9767
第15任總統副總統,在臺北市各村(里),臺北市,　南港區,鴻福里,137,1254,1674,3065,34,3099,0,3099,795,3894,79.5840
第15任總統副總統,在臺北市各村(里),臺北市,　南港區,百福里,151,1378,1929,3458,53,3511,0,3511,1066,4577,76.7096
第15任總統副總統,在臺北市各村(里),臺北市,　南港區,成福里,247,2326,2521,5094,64,5158,0,5158,1350,6508,79.2563
第15任總統副總統,在臺北市各村(里),臺北市,　南港區,仁福里,161,1759,1733,3653,53,3706,0,3706,1020,4726,78.4173
第15任總統副總統,在臺北市各村(里),臺北市,　內湖區,西湖里,203,1898,2816,4917,65,4982,0,4982,1306,6288,79.2303
第15任總統副總統,在臺北市各村(里),臺北市,　內湖區,西康里,339,2791,3161,6291,83,6374,0,6374,1833,8207,77.6654
第15任總統副總統,在臺北市各村(里),臺北市,　內湖區,西安里,208,1893,2338,4439,73,4512,0,4512,1221,5733,78.7023
第15任總統副總統,在臺北市各村(里),臺北市,　內湖區,港墘里,173,1611,2213,3997,62,4059,0,4059,1062,5121,79.2619
第15任總統副總統,在臺北市各村(里),臺北市,　內湖區,港都里,173,1437,2053,3663,33,3696,0,3696,935,4631,79.8100
第15任總統副總統,在臺北市各村(里),臺北市,　內湖區,港富里,264,2463,3478,6205,72,6277,0,6277,1723,8000,78.4625
第15任總統副總統,在臺北市各村(里),臺北市,　內湖區,港華里,278,2407,3301,5986,71,6057,0,6057,1556,7613,79.5613
第15任總統副總統,在臺北市各村(里),臺北市,　內湖區,內湖里,171,1840,2095,4106,73,4179,1,4180,1262,5442,76.7916
第15任總統副總統,在臺北市各村(里),臺北市,　內湖區,湖濱里,283,2616,2641,5540,74,5614,0,5614,1487,7101,79.0593
第15任總統副總統,在臺北市各村(里),臺北市,　內湖區,紫星里,227,2167,3008,5402,51,5453,5,5458,1394,6852,79.5826
第15任總統副總統,在臺北市各村(里),臺北市,　內湖區,大湖里,150,1573,1929,3652,39,3691,0,3691,993,4684,78.8002
第15任總統副總統,在臺北市各村(里),臺北市,　內湖區,金龍里,170,1469,1936,3575,42,3617,0,3617,1023,4640,77.9526
第15任總統副總統,在臺北市各村(里),臺北市,　內湖區,金瑞里,185,1815,2356,4356,61,4417,0,4417,1240,5657,78.0803
第15任總統副總統,在臺北市各村(里),臺北市,　內湖區,碧山里,192,1955,2484,4631,67,4698,1,4699,1348,6047,77.6914
第15任總統副總統,在臺北市各村(里),臺北市,　內湖區,紫雲里,200,1874,1728,3802,40,3842,0,3842,1049,4891,78.5524
第15任總統副總統,在臺北市各村(里),臺北市,　內湖區,清白里,279,2533,2827,5639,85,5724,1,5725,1557,7282,78.6048
第15任總統副總統,在臺北市各村(里),臺北市,　內湖區,葫洲里,247,1993,2326,4566,50,4616,0,4616,1249,5865,78.7042
第15任總統副總統,在臺北市各村(里),臺北市,　內湖區,紫陽里,242,2238,2934,5414,76,5490,0,5490,1493,6983,78.6195
第15任總統副總統,在臺北市各村(里),臺北市,　內湖區,瑞陽里,237,2698,2322,5257,61,5318,0,5318,1347,6665,79.7899
第15任總統副總統,在臺北市各村(里),臺北市,　內湖區,瑞光里,144,1570,1405,3119,37,3156,0,3156,854,4010,78.7032
第15任總統副總統,在臺北市各村(里),臺北市,　內湖區,五分里,310,2462,3763,6535,89,6624,0,6624,2025,8649,76.5869
第15任總統副總統,在臺北市各村(里),臺北市,　內湖區,東湖里,221,1831,2839,4891,65,4956,0,4956,1345,6301,78.6542
第15任總統副總統,在臺北市各村(里),臺北市,　內湖區,樂康里,282,2096,2954,5332,85,5417,1,5418,1660,7078,76.5329
第15任總統副總統,在臺北市各村(里),臺北市,　內湖區,內溝里,159,1258,1685,3102,28,3130,1,3131,917,4048,77.3221
第15任總統副總統,在臺北市各村(里),臺北市,　內湖區,週美里,266,2054,3167,5487,76,5563,0,5563,1640,7203,77.2317
第15任總統副總統,在臺北市各村(里),臺北市,　內湖區,行善里,227,1813,2553,4593,58,4651,0,4651,1292,5943,78.2601
第15任總統副總統,在臺北市各村(里),臺北市,　內湖區,石潭里,135,1077,1345,2557,38,2595,0,2595,817,3412,76.0551
第15任總統副總統,在臺北市各村(里),臺北市,　內湖區,湖興里,208,1988,2649,4845,61,4906,0,4906,2551,7457,65.7905
第15任總統副總統,在臺北市各村(里),臺北市,　內湖區,湖元里,148,1447,1942,3537,34,3571,0,3571,1040,4611,77.4452
第15任總統副總統,在臺北市各村(里),臺北市,　內湖區,安湖里,271,1933,2816,5020,58,5078,0,5078,1354,6432,78.9490
第15任總統副總統,在臺北市各村(里),臺北市,　內湖區,秀湖里,195,1905,2013,4113,63,4176,1,4177,1220,5397,77.3763
第15任總統副總統,在臺北市各村(里),臺北市,　內湖區,安泰里,185,1443,1860,3488,49,3537,1,3538,1088,4626,76.4591
第15任總統副總統,在臺北市各村(里),臺北市,　內湖區,金湖里,298,2691,3044,6033,89,6122,1,6123,1727,7850,77.9873
第15任總統副總統,在臺北市各村(里),臺北市,　內湖區,康寧里,259,2430,2915,5604,79,5683,2,5685,1605,7290,77.9561
第15任總統副總統,在臺北市各村(里),臺北市,　內湖區,明湖里,185,1352,1976,3513,55,3568,0,3568,904,4472,79.7853
第15任總統副總統,在臺北市各村(里),臺北市,　內湖區,蘆洲里,36,263,498,797,8,805,1,806,313,1119,71.9392
第15任總統副總統,在臺北市各村(里),臺北市,　內湖區,麗山里,164,1392,2279,3835,51,3886,0,3886,1108,4994,77.8134
第15任總統副總統,在臺北市各村(里),臺北市,　內湖區,寶湖里,277,2639,2834,5750,96,5846,0,5846,1685,7531,77.6258
第15任總統副總統,在臺北市各村(里),臺北市,　內湖區,南湖里,165,1522,1786,3473,52,3525,0,3525,990,4515,78.0731
第15任總統副總統,在臺北市各村(里),臺北市,　士林區,天母里,175,1810,2215,4200,60,4260,0,4260,1344,5604,76.0171
第15任總統副總統,在臺北市各村(里),臺北市,　士林區,三玉里,141,1500,2162,3803,59,3862,0,3862,1127,4989,77.4103
第15任總統副總統,在臺北市各村(里),臺北市,　士林區,天福里,175,1621,2267,4063,51,4114,0,4114,1233,5347,76.9403
第15任總統副總統,在臺北市各村(里),臺北市,　士林區,天祿里,149,1244,2002,3395,39,3434,5,3439,1039,4478,76.6860
第15任總統副總統,在臺北市各村(里),臺北市,　士林區,天壽里,134,1346,1743,3223,47,3270,0,3270,1022,4292,76.1883
第15任總統副總統,在臺北市各村(里),臺北市,　士林區,天山里,142,1931,2396,4469,53,4522,0,4522,1438,5960,75.8725
第15任總統副總統,在臺北市各村(里),臺北市,　士林區,天和里,186,1984,2637,4807,47,4854,1,4855,1545,6400,75.8438
第15任總統副總統,在臺北市各村(里),臺北市,　士林區,天玉里,217,2238,3038,5493,60,5553,0,5553,1790,7343,75.6230
第15任總統副總統,在臺北市各村(里),臺北市,　士林區,德行里,144,1122,1682,2948,23,2971,0,2971,823,3794,78.3079
第15任總統副總統,在臺北市各村(里),臺北市,　士林區,德華里,158,1308,2230,3696,43,3739,0,3739,1076,4815,77.6532
第15任總統副總統,在臺北市各村(里),臺北市,　士林區,忠誠里,138,1925,1609,3672,37,3709,0,3709,1111,4820,76.9502
第15任總統副總統,在臺北市各村(里),臺北市,　士林區,蘭雅里,246,2242,3230,5718,58,5776,1,5777,1731,7508,76.9313
第15任總統副總統,在臺北市各村(里),臺北市,　士林區,蘭興里,173,1587,2387,4147,49,4196,0,4196,1249,5445,77.0615
第15任總統副總統,在臺北市各村(里),臺北市,　士林區,仁勇里,90,837,1549,2476,30,2506,0,2506,804,3310,75.7100
第15任總統副總統,在臺北市各村(里),臺北市,　士林區,義信里,65,792,1170,2027,31,2058,0,2058,717,2775,74.1622
第15任總統副總統,在臺北市各村(里),臺北市,　士林區,福林里,75,794,1068,1937,30,1967,0,1967,611,2578,76.2995
第15任總統副總統,在臺北市各村(里),臺北市,　士林區,福德里,133,1267,1638,3038,29,3067,1,3068,2126,5194,59.0489
第15任總統副總統,在臺北市各村(里),臺北市,　士林區,福志里,209,2257,2626,5092,68,5160,9,5169,1394,6563,78.6226
第15任總統副總統,在臺北市各村(里),臺北市,　士林區,舊佳里,148,1492,2454,4094,36,4130,0,4130,1274,5404,76.4249
第15任總統副總統,在臺北市各村(里),臺北市,　士林區,福佳里,214,1859,2938,5011,59,5070,0,5070,1470,6540,77.5229
第15任總統副總統,在臺北市各村(里),臺北市,　士林區,後港里,224,1727,3292,5243,60,5303,0,5303,1685,6988,75.8872
第15任總統副總統,在臺北市各村(里),臺北市,　士林區,福中里,193,1424,2773,4390,47,4437,1,4438,1270,5708,77.7330
第15任總統副總統,在臺北市各村(里),臺北市,　士林區,前港里,133,946,1813,2892,39,2931,2,2933,853,3786,77.4168
第15任總統副總統,在臺北市各村(里),臺北市,　士林區,百齡里,212,1490,2928,4630,39,4669,1,4670,1284,5954,78.4179
第15任總統副總統,在臺北市各村(里),臺北市,　士林區,承德里,151,1435,1982,3568,36,3604,0,3604,1165,4769,75.5714
第15任總統副總統,在臺北市各村(里),臺北市,　士林區,福華里,152,1435,2389,3976,39,4015,0,4015,1363,5378,74.6560
第15任總統副總統,在臺北市各村(里),臺北市,　士林區,明勝里,131,1211,1937,3279,38,3317,0,3317,941,4258,77.9004
第15任總統副總統,在臺北市各村(里),臺北市,　士林區,福順里,143,1079,2375,3597,34,3631,0,3631,1052,4683,77.5358
第15任總統副總統,在臺北市各村(里),臺北市,　士林區,富光里,163,1119,2552,3834,47,3881,0,3881,1181,5062,76.6693
第15任總統副總統,在臺北市各村(里),臺北市,　士林區,葫蘆里,197,1778,3048,5023,55,5078,0,5078,1301,6379,79.6050
第15任總統副總統,在臺北市各村(里),臺北市,　士林區,葫東里,115,806,1765,2686,34,2720,0,2720,827,3547,76.6845
第15任總統副總統,在臺北市各村(里),臺北市,　士林區,社子里,151,1256,2800,4207,42,4249,0,4249,1275,5524,76.9189
第15任總統副總統,在臺北市各村(里),臺北市,　士林區,社新里,275,1692,3901,5868,55,5923,1,5924,1863,7787,76.0627
第15任總統副總統,在臺北市各村(里),臺北市,　士林區,社園里,187,1270,3311,4768,42,4810,0,4810,1396,6206,77.5056
第15任總統副總統,在臺北市各村(里),臺北市,　士林區,永倫里,166,1370,3149,4685,44,4729,0,4729,1443,6172,76.6202
第15任總統副總統,在臺北市各村(里),臺北市,　士林區,福安里,101,576,2494,3171,38,3209,0,3209,1043,4252,75.4704
第15任總統副總統,在臺北市各村(里),臺北市,　士林區,富洲里,161,878,2956,3995,56,4051,0,4051,1242,5293,76.5350
第15任總統副總統,在臺北市各村(里),臺北市,　士林區,岩山里,84,978,1166,2228,35,2263,0,2263,685,2948,76.7639
第15任總統副總統,在臺北市各村(里),臺北市,　士林區,名山里,201,1970,2503,4674,56,4730,0,4730,1363,6093,77.6301
第15任總統副總統,在臺北市各村(里),臺北市,　士林區,聖山里,144,1530,1668,3342,36,3378,1,3379,931,4310,78.3759
第15任總統副總統,在臺北市各村(里),臺北市,　士林區,芝山里,212,1967,2720,4899,74,4973,0,4973,1468,6441,77.2085
第15任總統副總統,在臺北市各村(里),臺北市,　士林區,東山里,123,1611,1631,3365,35,3400,0,3400,1012,4412,77.0626
第15任總統副總統,在臺北市各村(里),臺北市,　士林區,永福里,34,246,529,809,16,825,0,825,299,1124,73.3986
第15任總統副總統,在臺北市各村(里),臺北市,　士林區,公館里,33,239,625,897,11,908,0,908,310,1218,74.5484
第15任總統副總統,在臺北市各村(里),臺北市,　士林區,新安里,46,427,799,1272,7,1279,0,1279,433,1712,74.7079
第15任總統副總統,在臺北市各村(里),臺北市,　士林區,陽明里,85,773,1052,1910,21,1931,0,1931,775,2706,71.3599
第15任總統副總統,在臺北市各村(里),臺北市,　士林區,菁山里,47,356,644,1047,16,1063,1,1064,372,1436,74.0251
第15任總統副總統,在臺北市各村(里),臺北市,　士林區,平等里,24,231,762,1017,6,1023,0,1023,299,1322,77.3828
第15任總統副總統,在臺北市各村(里),臺北市,　士林區,溪山里,26,313,619,958,13,971,0,971,340,1311,74.0656
第15任總統副總統,在臺北市各村(里),臺北市,　士林區,翠山里,74,1070,679,1823,19,1842,0,1842,555,2397,76.8461
第15任總統副總統,在臺北市各村(里),臺北市,　士林區,臨溪里,85,824,978,1887,21,1908,0,1908,682,2590,73.6680
第15任總統副總統,在臺北市各村(里),臺北市,　北投區,建民里,146,1052,1677,2875,30,2905,0,2905,826,3731,77.8612
第15任總統副總統,在臺北市各村(里),臺北市,　北投區,文林里,118,1024,1735,2877,33,2910,1,2911,798,3709,78.4578
第15任總統副總統,在臺北市各村(里),臺北市,　北投區,石牌里,149,1243,2121,3513,19,3532,10,3542,940,4482,78.8041
第15任總統副總統,在臺北市各村(里),臺北市,　北投區,福興里,210,1700,2651,4561,48,4609,0,4609,1239,5848,78.8133
第15任總統副總統,在臺北市各村(里),臺北市,　北投區,榮光里,201,1683,2639,4523,65,4588,0,4588,1441,6029,76.0989
第15任總統副總統,在臺北市各村(里),臺北市,　北投區,榮華里,188,1939,2686,4813,83,4896,1,4897,1402,6299,77.7266
第15任總統副總統,在臺北市各村(里),臺北市,　北投區,裕民里,221,2016,2768,5005,72,5077,0,5077,1506,6583,77.1229
第15任總統副總統,在臺北市各村(里),臺北市,　北投區,振華里,206,2036,2616,4858,62,4920,1,4921,1514,6435,76.4569
第15任總統副總統,在臺北市各村(里),臺北市,　北投區,永和里,213,2310,3354,5877,64,5941,0,5941,1851,7792,76.2449
第15任總統副總統,在臺北市各村(里),臺北市,　北投區,永欣里,174,2225,2685,5084,65,5149,0,5149,1608,6757,76.2025
第15任總統副總統,在臺北市各村(里),臺北市,　北投區,永明里,128,1260,1730,3118,38,3156,2,3158,875,4033,78.2544
第15任總統副總統,在臺北市各村(里),臺北市,　北投區,東華里,124,1247,1540,2911,47,2958,0,2958,736,3694,80.0758
第15任總統副總統,在臺北市各村(里),臺北市,　北投區,吉利里,205,1885,2299,4389,54,4443,1,4444,1228,5672,78.3322
第15任總統副總統,在臺北市各村(里),臺北市,　北投區,吉慶里,135,1091,2036,3262,45,3307,0,3307,880,4187,78.9826
第15任總統副總統,在臺北市各村(里),臺北市,　北投區,尊賢里,107,1051,1883,3041,40,3081,0,3081,844,3925,78.4968
第15任總統副總統,在臺北市各村(里),臺北市,　北投區,立賢里,139,1267,2085,3491,39,3530,0,3530,1011,4541,77.7362
第15任總統副總統,在臺北市各村(里),臺北市,　北投區,立農里,277,2122,3458,5857,79,5936,0,5936,1601,7537,78.7581
第15任總統副總統,在臺北市各村(里),臺北市,　北投區,八仙里,163,1300,2127,3590,43,3633,0,3633,1155,4788,75.8772
第15任總統副總統,在臺北市各村(里),臺北市,　北投區,洲美里,46,369,1016,1431,12,1443,0,1443,373,1816,79.4604
第15任總統副總統,在臺北市各村(里),臺北市,　北投區,奇岩里,306,2667,3927,6900,87,6987,2,6989,2095,9084,76.9155
第15任總統副總統,在臺北市各村(里),臺北市,　北投區,清江里,207,2034,3343,5584,77,5661,2,5663,2595,8258,68.5517
第15任總統副總統,在臺北市各村(里),臺北市,　北投區,中央里,245,1814,3315,5374,53,5427,0,5427,1829,7256,74.7933
第15任總統副總統,在臺北市各村(里),臺北市,　北投區,長安里,150,1499,2321,3970,54,4024,1,4025,1343,5368,74.9627
第15任總統副總統,在臺北市各村(里),臺北市,　北投區,大同里,153,1231,2391,3775,63,3838,0,3838,1150,4988,76.9447
第15任總統副總統,在臺北市各村(里),臺北市,　北投區,溫泉里,135,1600,2572,4307,56,4363,0,4363,1387,5750,75.8783
第15任總統副總統,在臺北市各村(里),臺北市,　北投區,林泉里,81,798,998,1877,30,1907,0,1907,793,2700,70.6296
第15任總統副總統,在臺北市各村(里),臺北市,　北投區,中心里,180,1633,2255,4068,50,4118,0,4118,1523,5641,73.0012
第15任總統副總統,在臺北市各村(里),臺北市,　北投區,中庸里,107,954,1668,2729,36,2765,0,2765,913,3678,75.1767
第15任總統副總統,在臺北市各村(里),臺北市,　北投區,開明里,153,1862,2342,4357,62,4419,1,4420,1308,5728,77.1473
第15任總統副總統,在臺北市各村(里),臺北市,　北投區,中和里,137,1369,1751,3257,31,3288,0,3288,990,4278,76.8583
第15任總統副總統,在臺北市各村(里),臺北市,　北投區,智仁里,156,1551,2175,3882,49,3931,1,3932,1256,5188,75.7710
第15任總統副總統,在臺北市各村(里),臺北市,　北投區,秀山里,90,885,1135,2110,23,2133,0,2133,705,2838,75.1586
第15任總統副總統,在臺北市各村(里),臺北市,　北投區,文化里,112,1477,1124,2713,28,2741,0,2741,755,3496,78.4039
第15任總統副總統,在臺北市各村(里),臺北市,　北投區,豐年里,114,1141,1630,2885,22,2907,0,2907,879,3786,76.7829
第15任總統副總統,在臺北市各村(里),臺北市,　北投區,稻香里,136,1559,1828,3523,34,3557,0,3557,1185,4742,75.0105
第15任總統副總統,在臺北市各村(里),臺北市,　北投區,桃源里,171,1316,2450,3937,43,3980,0,3980,1198,5178,76.8637
第15任總統副總統,在臺北市各村(里),臺北市,　北投區,一德里,186,1634,2997,4817,49,4866,0,4866,1493,6359,76.5215
第15任總統副總統,在臺北市各村(里),臺北市,　北投區,關渡里,306,2678,4233,7217,94,7311,4,7315,2469,9784,74.7240
第15任總統副總統,在臺北市各村(里),臺北市,　北投區,泉源里,59,499,981,1539,10,1549,0,1549,573,2122,72.9972
第15任總統副總統,在臺北市各村(里),臺北市,　北投區,湖山里,48,410,626,1084,12,1096,0,1096,400,1496,73.2620
第15任總統副總統,在臺北市各村(里),臺北市,　北投區,大屯里,34,195,542,771,10,781,0,781,300,1081,72.2479
第15任總統副總統,在臺北市各村(里),臺北市,　北投區,湖田里,27,225,350,602,4,606,0,606,229,835,72.5749
第15任總統副總統,在臺中市各村(里),臺中市,　中區,綠川里,47,405,719,1171,5,1176,0,1176,427,1603,73.3624
第15任總統副總統,在臺中市各村(里),臺中市,　中區,繼光里,44,362,646,1052,8,1060,0,1060,400,1460,72.6027
第15任總統副總統,在臺中市各村(里),臺中市,　中區,公園里,36,348,567,951,5,956,0,956,405,1361,70.2425
第15任總統副總統,在臺中市各村(里),臺中市,　中區,光復里,64,568,780,1412,16,1428,0,1428,546,1974,72.3404
第15任總統副總統,在臺中市各村(里),臺中市,　中區,大墩里,74,493,800,1367,17,1384,0,1384,552,1936,71.4876
第15任總統副總統,在臺中市各村(里),臺中市,　中區,柳川里,49,530,659,1238,10,1248,0,1248,556,1804,69.1796
第15任總統副總統,在臺中市各村(里),臺中市,　中區,大誠里,74,632,910,1616,27,1643,0,1643,642,2285,71.9037
第15任總統副總統,在臺中市各村(里),臺中市,　中區,中華里,54,485,712,1251,18,1269,0,1269,538,1807,70.2269
第15任總統副總統,在臺中市各村(里),臺中市,　東區,新庄里,87,675,1141,1903,23,1926,0,1926,981,2907,66.2539
第15任總統副總統,在臺中市各村(里),臺中市,　東區,振興里,103,732,1485,2320,28,2348,0,2348,713,3061,76.7070
第15任總統副總統,在臺中市各村(里),臺中市,　東區,東橋里,153,814,1891,2858,35,2893,0,2893,781,3674,78.7425
第15任總統副總統,在臺中市各村(里),臺中市,　東區,東興里,99,681,1329,2109,30,2139,0,2139,604,2743,77.9803
第15任總統副總統,在臺中市各村(里),臺中市,　東區,泉源里,66,454,890,1410,24,1434,0,1434,429,1863,76.9726
第15任總統副總統,在臺中市各村(里),臺中市,　東區,干城里,55,518,829,1402,25,1427,0,1427,416,1843,77.4281
第15任總統副總統,在臺中市各村(里),臺中市,　東區,旱溪里,93,654,1132,1879,22,1901,0,1901,492,2393,79.4400
第15任總統副總統,在臺中市各村(里),臺中市,　東區,樂成里,57,513,1040,1610,18,1628,1,1629,533,2162,75.3006
第15任總統副總統,在臺中市各村(里),臺中市,　東區,東門里,223,1491,3432,5146,49,5195,0,5195,1269,6464,80.3682
第15任總統副總統,在臺中市各村(里),臺中市,　東區,十甲里,181,1157,2169,3507,40,3547,0,3547,1032,4579,77.4623
第15任總統副總統,在臺中市各村(里),臺中市,　東區,東英里,239,1867,3241,5347,64,5411,2,5413,1464,6877,78.6826
第15任總統副總統,在臺中市各村(里),臺中市,　東區,東南里,134,1048,1537,2719,32,2751,0,2751,844,3595,76.5229
第15任總統副總統,在臺中市各村(里),臺中市,　東區,東勢里,91,774,1017,1882,25,1907,1,1908,645,2553,74.6964
第15任總統副總統,在臺中市各村(里),臺中市,　東區,合作里,178,1511,1288,2977,27,3004,0,3004,927,3931,76.4182
第15任總統副總統,在臺中市各村(里),臺中市,　東區,富仁里,125,1747,1065,2937,44,2981,0,2981,1022,4003,74.4691
第15任總統副總統,在臺中市各村(里),臺中市,　東區,富台里,57,694,461,1212,19,1231,0,1231,439,1670,73.7126
第15任總統副總統,在臺中市各村(里),臺中市,　東區,東信里,310,2105,4167,6582,77,6659,0,6659,1853,8512,78.2307
第15任總統副總統,在臺中市各村(里),臺中市,　南區,長春里,70,513,831,1414,19,1433,0,1433,426,1859,77.0845
第15任總統副總統,在臺中市各村(里),臺中市,　南區,長榮里,93,688,1066,1847,16,1863,0,1863,516,2379,78.3102
第15任總統副總統,在臺中市各村(里),臺中市,　南區,城隍里,117,985,1544,2646,37,2683,0,2683,819,3502,76.6134
第15任總統副總統,在臺中市各村(里),臺中市,　南區,國光里,117,1051,1680,2848,41,2889,0,2889,859,3748,77.0811
第15任總統副總統,在臺中市各村(里),臺中市,　南區,南門里,130,1022,1535,2687,18,2705,0,2705,673,3378,80.0770
第15任總統副總統,在臺中市各村(里),臺中市,　南區,德義里,100,818,1196,2114,23,2137,0,2137,639,2776,76.9813
第15任總統副總統,在臺中市各村(里),臺中市,　南區,積善里,95,666,1158,1919,23,1942,0,1942,534,2476,78.4330
第15任總統副總統,在臺中市各村(里),臺中市,　南區,江川里,76,801,1203,2080,20,2100,0,2100,588,2688,78.1250
第15任總統副總統,在臺中市各村(里),臺中市,　南區,新榮里,188,1295,1644,3127,40,3167,0,3167,1050,4217,75.1008
第15任總統副總統,在臺中市各村(里),臺中市,　南區,福興里,127,1115,1670,2912,33,2945,0,2945,785,3730,78.9544
第15任總統副總統,在臺中市各村(里),臺中市,　南區,福平里,210,1478,2261,3949,50,3999,0,3999,1157,5156,77.5601
第15任總統副總統,在臺中市各村(里),臺中市,　南區,福順里,221,1532,2319,4072,50,4122,0,4122,1168,5290,77.9206
第15任總統副總統,在臺中市各村(里),臺中市,　南區,和平里,139,994,1597,2730,30,2760,0,2760,973,3733,73.9352
第15任總統副總統,在臺中市各村(里),臺中市,　南區,平和里,124,927,1559,2610,29,2639,0,2639,744,3383,78.0077
第15任總統副總統,在臺中市各村(里),臺中市,　南區,南和里,243,2001,2742,4986,50,5036,0,5036,2063,7099,70.9396
第15任總統副總統,在臺中市各村(里),臺中市,　南區,永興里,306,2229,3229,5764,61,5825,0,5825,1642,7467,78.0099
第15任總統副總統,在臺中市各村(里),臺中市,　南區,永和里,149,1253,1833,3235,34,3269,0,3269,1007,4276,76.4500
第15任總統副總統,在臺中市各村(里),臺中市,　南區,樹義里,480,3119,4819,8418,92,8510,0,8510,2457,10967,77.5964
第15任總統副總統,在臺中市各村(里),臺中市,　南區,工學里,262,1902,2670,4834,64,4898,0,4898,1434,6332,77.3531
第15任總統副總統,在臺中市各村(里),臺中市,　南區,樹德里,377,2365,3471,6213,85,6298,0,6298,1623,7921,79.5102
第15任總統副總統,在臺中市各村(里),臺中市,　南區,西川里,174,1229,1744,3147,29,3176,0,3176,916,4092,77.6149
第15任總統副總統,在臺中市各村(里),臺中市,　南區,崇倫里,227,1502,2327,4056,43,4099,0,4099,1111,5210,78.6756
第15任總統副總統,在臺中市各村(里),臺中市,　西區,三民里,54,525,655,1234,15,1249,0,1249,908,2157,57.9045
第15任總統副總統,在臺中市各村(里),臺中市,　西區,利民里,52,445,513,1010,10,1020,0,1020,334,1354,75.3323
第15任總統副總統,在臺中市各村(里),臺中市,　西區,民生里,67,537,709,1313,12,1325,0,1325,391,1716,77.2145
第15任總統副總統,在臺中市各村(里),臺中市,　西區,廣民里,43,394,590,1027,14,1041,0,1041,362,1403,74.1981
第15任總統副總統,在臺中市各村(里),臺中市,　西區,平和里,67,582,727,1376,20,1396,0,1396,457,1853,75.3373
第15任總統副總統,在臺中市各村(里),臺中市,　西區,東昇里,70,694,958,1722,28,1750,0,1750,492,2242,78.0553
第15任總統副總統,在臺中市各村(里),臺中市,　西區,公民里,167,1359,2035,3561,34,3595,0,3595,1074,4669,76.9972
第15任總統副總統,在臺中市各村(里),臺中市,　西區,藍興里,152,1093,1701,2946,37,2983,0,2983,823,3806,78.3762
第15任總統副總統,在臺中市各村(里),臺中市,　西區,公舘里,193,1595,2412,4200,47,4247,0,4247,1307,5554,76.4674
第15任總統副總統,在臺中市各村(里),臺中市,　西區,安龍里,91,806,1217,2114,25,2139,0,2139,640,2779,76.9701
第15任總統副總統,在臺中市各村(里),臺中市,　西區,吉龍里,250,1873,2567,4690,61,4751,0,4751,1556,6307,75.3290
第15任總統副總統,在臺中市各村(里),臺中市,　西區,土庫里,171,1570,2433,4174,50,4224,0,4224,1251,5475,77.1507
第15任總統副總統,在臺中市各村(里),臺中市,　西區,大忠里,178,1305,1879,3362,33,3395,0,3395,850,4245,79.9764
第15任總統副總統,在臺中市各村(里),臺中市,　西區,民龍里,115,1010,1227,2352,23,2375,0,2375,814,3189,74.4748
第15任總統副總統,在臺中市各村(里),臺中市,　西區,和龍里,61,581,1003,1645,22,1667,0,1667,611,2278,73.1782
第15任總統副總統,在臺中市各村(里),臺中市,　西區,後龍里,95,972,1486,2553,23,2576,0,2576,861,3437,74.9491
第15任總統副總統,在臺中市各村(里),臺中市,　西區,双龍里,97,843,1067,2007,26,2033,0,2033,615,2648,76.7749
第15任總統副總統,在臺中市各村(里),臺中市,　西區,昇平里,214,1571,2368,4153,55,4208,0,4208,1268,5476,76.8444
第15任總統副總統,在臺中市各村(里),臺中市,　西區,中興里,120,919,1639,2678,28,2706,0,2706,777,3483,77.6916
第15任總統副總統,在臺中市各村(里),臺中市,　西區,公益里,102,714,1328,2144,22,2166,0,2166,547,2713,79.8378
第15任總統副總統,在臺中市各村(里),臺中市,　西區,公德里,166,1199,1770,3135,29,3164,0,3164,940,4104,77.0955
第15任總統副總統,在臺中市各村(里),臺中市,　西區,公正里,232,1769,2742,4743,45,4788,0,4788,1190,5978,80.0937
第15任總統副總統,在臺中市各村(里),臺中市,　西區,公平里,173,1462,1925,3560,49,3609,0,3609,1131,4740,76.1392
第15任總統副總統,在臺中市各村(里),臺中市,　西區,忠明里,210,1571,2348,4129,47,4176,0,4176,1394,5570,74.9731
第15任總統副總統,在臺中市各村(里),臺中市,　西區,忠誠里,226,1609,2409,4244,52,4296,0,4296,1256,5552,77.3775
第15任總統副總統,在臺中市各村(里),臺中市,　北區,中正里,41,342,624,1007,15,1022,0,1022,376,1398,73.1044
第15任總統副總統,在臺中市各村(里),臺中市,　北區,六合里,67,359,723,1149,29,1178,0,1178,488,1666,70.7083
第15任總統副總統,在臺中市各村(里),臺中市,　北區,光大里,67,534,823,1424,27,1451,0,1451,564,2015,72.0099
第15任總統副總統,在臺中市各村(里),臺中市,　北區,文莊里,112,1303,1107,2522,26,2548,0,2548,743,3291,77.4233
第15任總統副總統,在臺中市各村(里),臺中市,　北區,大湖里,70,499,937,1506,19,1525,0,1525,617,2142,71.1951
第15任總統副總統,在臺中市各村(里),臺中市,　北區,五常里,54,324,603,981,7,988,0,988,361,1349,73.2394
第15任總統副總統,在臺中市各村(里),臺中市,　北區,錦平里,47,479,727,1253,20,1273,0,1273,502,1775,71.7183
第15任總統副總統,在臺中市各村(里),臺中市,　北區,新北里,72,488,658,1218,18,1236,0,1236,418,1654,74.7279
第15任總統副總統,在臺中市各村(里),臺中市,　北區,新興里,56,482,536,1074,10,1084,0,1084,420,1504,72.0745
第15任總統副總統,在臺中市各村(里),臺中市,　北區,樂英里,78,1261,551,1890,29,1919,0,1919,632,2551,75.2254
第15任總統副總統,在臺中市各村(里),臺中市,　北區,錦村里,133,1032,1203,2368,25,2393,0,2393,677,3070,77.9479
第15任總統副總統,在臺中市各村(里),臺中市,　北區,建成里,194,1589,2234,4017,45,4062,0,4062,1376,5438,74.6966
第15任總統副總統,在臺中市各村(里),臺中市,　北區,建德里,112,1047,1345,2504,28,2532,0,2532,712,3244,78.0518
第15任總統副總統,在臺中市各村(里),臺中市,　北區,錦洲里,122,1081,1222,2425,33,2458,0,2458,764,3222,76.2880
第15任總統副總統,在臺中市各村(里),臺中市,　北區,錦祥里,143,1324,1512,2979,44,3023,0,3023,1002,4025,75.1056
第15任總統副總統,在臺中市各村(里),臺中市,　北區,金華里,83,786,968,1837,17,1854,0,1854,558,2412,76.8657
第15任總統副總統,在臺中市各村(里),臺中市,　北區,金龍里,154,1278,1602,3034,28,3062,0,3062,1169,4231,72.3706
第15任總統副總統,在臺中市各村(里),臺中市,　北區,邱厝里,68,664,931,1663,16,1679,0,1679,542,2221,75.5966
第15任總統副總統,在臺中市各村(里),臺中市,　北區,建興里,219,1614,2339,4172,42,4214,0,4214,1277,5491,76.7438
第15任總統副總統,在臺中市各村(里),臺中市,　北區,頂厝里,155,1281,1649,3085,28,3113,0,3113,884,3997,77.8834
第15任總統副總統,在臺中市各村(里),臺中市,　北區,崇德里,103,1009,1421,2533,29,2562,0,2562,853,3415,75.0220
第15任總統副總統,在臺中市各村(里),臺中市,　北區,賴厝里,134,1340,1501,2975,31,3006,0,3006,1957,4963,60.5682
第15任總統副總統,在臺中市各村(里),臺中市,　北區,賴福里,114,1203,1578,2895,39,2934,0,2934,767,3701,79.2759
第15任總統副總統,在臺中市各村(里),臺中市,　北區,賴興里,144,1182,1443,2769,22,2791,0,2791,859,3650,76.4658
第15任總統副總統,在臺中市各村(里),臺中市,　北區,賴旺里,163,1245,1566,2974,27,3001,0,3001,1164,4165,72.0528
第15任總統副總統,在臺中市各村(里),臺中市,　北區,賴明里,129,1182,1421,2732,30,2762,0,2762,938,3700,74.6486
第15任總統副總統,在臺中市各村(里),臺中市,　北區,梅川里,116,923,1346,2385,20,2405,0,2405,673,3078,78.1352
第15任總統副總統,在臺中市各村(里),臺中市,　北區,賴村里,137,1192,1907,3236,35,3271,0,3271,1056,4327,75.5951
第15任總統副總統,在臺中市各村(里),臺中市,　北區,育德里,135,1086,1472,2693,30,2723,0,2723,805,3528,77.1825
第15任總統副總統,在臺中市各村(里),臺中市,　北區,淡溝里,171,1419,2097,3687,44,3731,0,3731,1161,4892,76.2674
第15任總統副總統,在臺中市各村(里),臺中市,　北區,健行里,218,1736,2804,4758,38,4796,1,4797,1424,6221,77.0937
第15任總統副總統,在臺中市各村(里),臺中市,　北區,明德里,202,1542,2144,3888,41,3929,0,3929,1177,5106,76.9487
第15任總統副總統,在臺中市各村(里),臺中市,　北區,明新里,78,830,1068,1976,27,2003,0,2003,640,2643,75.7851
第15任總統副總統,在臺中市各村(里),臺中市,　北區,長青里,208,1705,2485,4398,44,4442,0,4442,1415,5857,75.8409
第15任總統副總統,在臺中市各村(里),臺中市,　北區,立人里,136,1185,1377,2698,39,2737,0,2737,908,3645,75.0892
第15任總統副總統,在臺中市各村(里),臺中市,　北區,中達里,106,702,1087,1895,31,1926,0,1926,590,2516,76.5501
第15任總統副總統,在臺中市各村(里),臺中市,　西屯區,西安里,174,1323,2119,3616,52,3668,0,3668,987,4655,78.7970
第15任總統副總統,在臺中市各村(里),臺中市,　西屯區,至善里,165,1317,1742,3224,37,3261,0,3261,938,4199,77.6613
第15任總統副總統,在臺中市各村(里),臺中市,　西屯區,西平里,147,1665,1735,3547,51,3598,0,3598,1211,4809,74.8180
第15任總統副總統,在臺中市各村(里),臺中市,　西屯區,西墩里,218,1454,2407,4079,45,4124,0,4124,1316,5440,75.8088
第15任總統副總統,在臺中市各村(里),臺中市,　西屯區,潮洋里,207,1463,2041,3711,59,3770,0,3770,1946,5716,65.9552
第15任總統副總統,在臺中市各村(里),臺中市,　西屯區,龍潭里,20,182,421,623,9,632,0,632,160,792,79.7980
第15任總統副總統,在臺中市各村(里),臺中市,　西屯區,惠來里,494,4270,5144,9908,105,10013,0,10013,3269,13282,75.3877
第15任總統副總統,在臺中市各村(里),臺中市,　西屯區,上石里,219,1424,1922,3565,54,3619,0,3619,1143,4762,75.9975
第15任總統副總統,在臺中市各村(里),臺中市,　西屯區,上安里,208,1432,2071,3711,58,3769,1,3770,1150,4920,76.6057
第15任總統副總統,在臺中市各村(里),臺中市,　西屯區,上德里,172,1287,1631,3090,41,3131,0,3131,898,4029,77.7116
第15任總統副總統,在臺中市各村(里),臺中市,　西屯區,逢甲里,165,1248,1680,3093,36,3129,1,3130,1016,4146,75.4703
第15任總統副總統,在臺中市各村(里),臺中市,　西屯區,逢福里,222,1670,2133,4025,59,4084,0,4084,1122,5206,78.4479
第15任總統副總統,在臺中市各村(里),臺中市,　西屯區,鵬程里,84,1452,451,1987,28,2015,0,2015,660,2675,75.3271
第15任總統副總統,在臺中市各村(里),臺中市,　西屯區,何厝里,100,822,1386,2308,38,2346,0,2346,756,3102,75.6286
第15任總統副總統,在臺中市各村(里),臺中市,　西屯區,何明里,123,1046,1564,2733,26,2759,0,2759,751,3510,78.6040
第15任總統副總統,在臺中市各村(里),臺中市,　西屯區,何南里,134,1284,1725,3143,36,3179,0,3179,907,4086,77.8023
第15任總統副總統,在臺中市各村(里),臺中市,　西屯區,何成里,281,2105,2931,5317,56,5373,0,5373,1595,6968,77.1096
第15任總統副總統,在臺中市各村(里),臺中市,　西屯區,何安里,185,1412,2129,3726,46,3772,0,3772,1207,4979,75.7582
第15任總統副總統,在臺中市各村(里),臺中市,　西屯區,何仁里,217,1661,2682,4560,51,4611,0,4611,1415,6026,76.5184
第15任總統副總統,在臺中市各村(里),臺中市,　西屯區,何德里,139,1040,1519,2698,43,2741,0,2741,773,3514,78.0023
第15任總統副總統,在臺中市各村(里),臺中市,　西屯區,何福里,175,1271,1866,3312,43,3355,0,3355,897,4252,78.9040
第15任總統副總統,在臺中市各村(里),臺中市,　西屯區,何源里,265,2034,2684,4983,54,5037,0,5037,1458,6495,77.5520
第15任總統副總統,在臺中市各村(里),臺中市,　西屯區,大河里,139,969,1766,2874,34,2908,1,2909,760,3669,79.2587
第15任總統副總統,在臺中市各村(里),臺中市,　西屯區,大石里,73,1207,359,1639,30,1669,0,1669,469,2138,78.0636
第15任總統副總統,在臺中市各村(里),臺中市,　西屯區,大福里,125,1044,1135,2304,42,2346,1,2347,768,3115,75.3130
第15任總統副總統,在臺中市各村(里),臺中市,　西屯區,大鵬里,167,1517,1831,3515,31,3546,0,3546,1175,4721,75.1112
第15任總統副總統,在臺中市各村(里),臺中市,　西屯區,港尾里,167,1380,2146,3693,38,3731,0,3731,1070,4801,77.7130
第15任總統副總統,在臺中市各村(里),臺中市,　西屯區,廣福里,78,509,1168,1755,34,1789,0,1789,472,2261,79.1243
第15任總統副總統,在臺中市各村(里),臺中市,　西屯區,林厝里,115,980,1404,2499,32,2531,0,2531,749,3280,77.1646
第15任總統副總統,在臺中市各村(里),臺中市,　西屯區,永安里,457,3593,4895,8945,104,9049,0,9049,3005,12054,75.0705
第15任總統副總統,在臺中市各村(里),臺中市,　西屯區,福安里,124,854,1108,2086,20,2106,0,2106,569,2675,78.7290
第15任總統副總統,在臺中市各村(里),臺中市,　西屯區,福雅里,257,1650,2282,4189,51,4240,0,4240,1216,5456,77.7126
第15任總統副總統,在臺中市各村(里),臺中市,　西屯區,福林里,298,2294,2830,5422,78,5500,0,5500,1573,7073,77.7605
第15任總統副總統,在臺中市各村(里),臺中市,　西屯區,福瑞里,103,932,1032,2067,22,2089,0,2089,757,2846,73.4013
第15任總統副總統,在臺中市各村(里),臺中市,　西屯區,福聯里,109,866,1130,2105,29,2134,0,2134,879,3013,70.8264
第15任總統副總統,在臺中市各村(里),臺中市,　西屯區,福和里,151,996,2059,3206,39,3245,0,3245,969,4214,77.0052
第15任總統副總統,在臺中市各村(里),臺中市,　西屯區,福中里,118,859,1412,2389,33,2422,0,2422,712,3134,77.2814
第15任總統副總統,在臺中市各村(里),臺中市,　西屯區,福恩里,203,1385,1924,3512,42,3554,0,3554,1043,4597,77.3113
第15任總統副總統,在臺中市各村(里),臺中市,　西屯區,協和里,152,1085,2011,3248,43,3291,0,3291,1107,4398,74.8295
第15任總統副總統,在臺中市各村(里),臺中市,　南屯區,南屯里,306,2379,3675,6360,78,6438,0,6438,1760,8198,78.5313
第15任總統副總統,在臺中市各村(里),臺中市,　南屯區,豐樂里,402,3183,4827,8412,112,8524,0,8524,2230,10754,79.2635
第15任總統副總統,在臺中市各村(里),臺中市,　南屯區,楓樹里,188,1651,2679,4518,70,4588,0,4588,1162,5750,79.7913
第15任總統副總統,在臺中市各村(里),臺中市,　南屯區,中和里,190,1114,1993,3297,46,3343,0,3343,928,4271,78.2721
第15任總統副總統,在臺中市各村(里),臺中市,　南屯區,鎮平里,48,318,707,1073,14,1087,0,1087,288,1375,79.0545
第15任總統副總統,在臺中市各村(里),臺中市,　南屯區,春社里,236,1833,2326,4395,52,4447,0,4447,1827,6274,70.8798
第15任總統副總統,在臺中市各村(里),臺中市,　南屯區,春安里,25,255,263,543,9,552,0,552,227,779,70.8601
第15任總統副總統,在臺中市各村(里),臺中市,　南屯區,文山里,408,2648,4437,7493,95,7588,0,7588,2406,9994,75.9256
第15任總統副總統,在臺中市各村(里),臺中市,　南屯區,寶山里,228,1318,2212,3758,44,3802,0,3802,1250,5052,75.2573
第15任總統副總統,在臺中市各村(里),臺中市,　南屯區,新生里,64,470,820,1354,17,1371,0,1371,432,1803,76.0399
第15任總統副總統,在臺中市各村(里),臺中市,　南屯區,永定里,205,1211,2284,3700,35,3735,0,3735,1044,4779,78.1544
第15任總統副總統,在臺中市各村(里),臺中市,　南屯區,三厝里,275,1899,2758,4932,63,4995,0,4995,1363,6358,78.5624
第15任總統副總統,在臺中市各村(里),臺中市,　南屯區,三義里,265,2033,2502,4800,53,4853,0,4853,1276,6129,79.1809
第15任總統副總統,在臺中市各村(里),臺中市,　南屯區,三和里,339,2636,3145,6120,71,6191,0,6191,1687,7878,78.5859
第15任總統副總統,在臺中市各村(里),臺中市,　南屯區,黎明里,129,1599,1483,3211,29,3240,0,3240,889,4129,78.4694
第15任總統副總統,在臺中市各村(里),臺中市,　南屯區,溝墘里,188,1584,2251,4023,47,4070,0,4070,1031,5101,79.7883
第15任總統副總統,在臺中市各村(里),臺中市,　南屯區,大業里,228,1940,2689,4857,41,4898,0,4898,1376,6274,78.0682
第15任總統副總統,在臺中市各村(里),臺中市,　南屯區,惠中里,296,2162,2944,5402,64,5466,0,5466,1515,6981,78.2982
第15任總統副總統,在臺中市各村(里),臺中市,　南屯區,田心里,248,1663,2734,4645,52,4697,0,4697,1275,5972,78.6504
第15任總統副總統,在臺中市各村(里),臺中市,　南屯區,向心里,174,1354,1916,3444,49,3493,0,3493,1630,5123,68.1827
第15任總統副總統,在臺中市各村(里),臺中市,　南屯區,文心里,147,1081,1537,2765,45,2810,0,2810,817,3627,77.4745
第15任總統副總統,在臺中市各村(里),臺中市,　南屯區,同心里,199,1552,2034,3785,44,3829,0,3829,1192,5021,76.2597
第15任總統副總統,在臺中市各村(里),臺中市,　南屯區,大同里,170,1308,2149,3627,30,3657,1,3658,1005,4663,78.4259
第15任總統副總統,在臺中市各村(里),臺中市,　南屯區,大興里,172,1192,1901,3265,50,3315,1,3316,924,4240,78.1840
第15任總統副總統,在臺中市各村(里),臺中市,　南屯區,大誠里,131,1050,1486,2667,21,2688,0,2688,747,3435,78.2533
第15任總統副總統,在臺中市各村(里),臺中市,　北屯區,三光里,266,2151,2754,5171,62,5233,0,5233,1596,6829,76.6291
第15任總統副總統,在臺中市各村(里),臺中市,　北屯區,三和里,187,1796,2263,4246,51,4297,0,4297,1268,5565,77.2147
第15任總統副總統,在臺中市各村(里),臺中市,　北屯區,大坑里,69,569,906,1544,25,1569,0,1569,495,2064,76.0174
第15任總統副總統,在臺中市各村(里),臺中市,　北屯區,大德里,180,1696,1816,3692,42,3734,0,3734,1058,4792,77.9215
第15任總統副總統,在臺中市各村(里),臺中市,　北屯區,仁和里,294,2408,3198,5900,59,5959,0,5959,2858,8817,67.5853
第15任總統副總統,在臺中市各村(里),臺中市,　北屯區,仁美里,341,2418,3455,6214,66,6280,0,6280,1819,8099,77.5404
第15任總統副總統,在臺中市各村(里),臺中市,　北屯區,仁愛里,58,335,390,783,11,794,0,794,255,1049,75.6911
第15任總統副總統,在臺中市各村(里),臺中市,　北屯區,水景里,469,3761,5749,9979,113,10092,0,10092,2878,12970,77.8103
第15任總統副總統,在臺中市各村(里),臺中市,　北屯區,水湳里,237,2047,2589,4873,47,4920,0,4920,1548,6468,76.0668
第15任總統副總統,在臺中市各村(里),臺中市,　北屯區,北屯里,89,1080,1346,2515,18,2533,0,2533,793,3326,76.1575
第15任總統副總統,在臺中市各村(里),臺中市,　北屯區,北京里,98,892,1341,2331,21,2352,0,2352,723,3075,76.4878
第15任總統副總統,在臺中市各村(里),臺中市,　北屯區,北興里,142,995,1278,2415,30,2445,0,2445,735,3180,76.8868
第15任總統副總統,在臺中市各村(里),臺中市,　北屯區,四民里,58,456,695,1209,18,1227,0,1227,294,1521,80.6706
第15任總統副總統,在臺中市各村(里),臺中市,　北屯區,平心里,178,1441,1843,3462,19,3481,0,3481,1125,4606,75.5753
第15任總統副總統,在臺中市各村(里),臺中市,　北屯區,平田里,204,1706,2232,4142,49,4191,0,4191,1314,5505,76.1308
第15任總統副總統,在臺中市各村(里),臺中市,　北屯區,平安里,175,1527,2090,3792,45,3837,0,3837,1197,5034,76.2217
第15任總統副總統,在臺中市各村(里),臺中市,　北屯區,平和里,180,1547,1950,3677,34,3711,0,3711,1181,4892,75.8585
第15任總統副總統,在臺中市各村(里),臺中市,　北屯區,平昌里,124,1398,1733,3255,47,3302,0,3302,1044,4346,75.9779
第15任總統副總統,在臺中市各村(里),臺中市,　北屯區,平陽里,186,1483,1924,3593,25,3618,0,3618,1108,4726,76.5552
第15任總統副總統,在臺中市各村(里),臺中市,　北屯區,平順里,119,888,1346,2353,24,2377,1,2378,731,3109,76.4555
第15任總統副總統,在臺中市各村(里),臺中市,　北屯區,平福里,145,1218,1378,2741,24,2765,0,2765,787,3552,77.8435
第15任總統副總統,在臺中市各村(里),臺中市,　北屯區,平德里,238,1835,2450,4523,50,4573,0,4573,1452,6025,75.9004
第15任總統副總統,在臺中市各村(里),臺中市,　北屯區,平興里,262,1965,2627,4854,60,4914,0,4914,1584,6498,75.6233
第15任總統副總統,在臺中市各村(里),臺中市,　北屯區,民政里,24,274,412,710,9,719,0,719,256,975,73.7436
第15任總統副總統,在臺中市各村(里),臺中市,　北屯區,民德里,33,239,383,655,9,664,0,664,220,884,75.1131
第15任總統副總統,在臺中市各村(里),臺中市,　北屯區,同榮里,223,1648,2110,3981,40,4021,1,4022,1083,5105,78.7659
第15任總統副總統,在臺中市各村(里),臺中市,　北屯區,后庄里,362,3367,3611,7340,84,7424,0,7424,2130,9554,77.7057
第15任總統副總統,在臺中市各村(里),臺中市,　北屯區,和平里,397,2950,4535,7882,88,7970,3,7973,2478,10451,76.2606
第15任總統副總統,在臺中市各村(里),臺中市,　北屯區,忠平里,136,1408,1399,2943,30,2973,0,2973,818,3791,78.4226
第15任總統副總統,在臺中市各村(里),臺中市,　北屯區,東山里,77,504,968,1549,19,1568,0,1568,430,1998,78.4785
第15任總統副總統,在臺中市各村(里),臺中市,　北屯區,東光里,158,1259,1895,3312,29,3341,0,3341,1100,4441,75.2308
第15任總統副總統,在臺中市各村(里),臺中市,　北屯區,松安里,163,1380,2028,3571,34,3605,0,3605,1101,4706,76.6043
第15任總統副總統,在臺中市各村(里),臺中市,　北屯區,松竹里,282,2655,3277,6214,68,6282,0,6282,1805,8087,77.6802
第15任總統副總統,在臺中市各村(里),臺中市,　北屯區,松和里,226,1844,2443,4513,48,4561,0,4561,1653,6214,73.3988
第15任總統副總統,在臺中市各村(里),臺中市,　北屯區,松勇里,184,1587,2112,3883,54,3937,0,3937,1112,5049,77.9758
第15任總統副總統,在臺中市各村(里),臺中市,　北屯區,松茂里,191,1715,1902,3808,40,3848,0,3848,1289,5137,74.9075
第15任總統副總統,在臺中市各村(里),臺中市,　北屯區,松強里,231,1926,2642,4799,55,4854,0,4854,1486,6340,76.5615
第15任總統副總統,在臺中市各村(里),臺中市,　北屯區,軍功里,459,3348,5315,9122,106,9228,0,9228,2535,11763,78.4494
第15任總統副總統,在臺中市各村(里),臺中市,　北屯區,陳平里,183,1409,1789,3381,33,3414,0,3414,1044,4458,76.5814
第15任總統副總統,在臺中市各村(里),臺中市,　北屯區,新平里,155,1384,1422,2961,30,2991,0,2991,1104,4095,73.0403
第15任總統副總統,在臺中市各村(里),臺中市,　北屯區,廍子里,466,3327,4888,8681,85,8766,2,8768,2554,11322,77.4245
第15任總統副總統,在臺中市各村(里),臺中市,　北屯區,舊社里,219,1753,2378,4350,34,4384,0,4384,1373,5757,76.1508
第15任總統副總統,在臺中市各村(里),臺中市,　豐原區,豐原里,71,757,884,1712,19,1731,0,1731,538,2269,76.2891
第15任總統副總統,在臺中市各村(里),臺中市,　豐原區,豐榮里,40,280,506,826,11,837,0,837,257,1094,76.5082
第15任總統副總統,在臺中市各村(里),臺中市,　豐原區,頂街里,30,231,457,718,5,723,0,723,207,930,77.7419
第15任總統副總統,在臺中市各村(里),臺中市,　豐原區,中山里,28,222,402,652,7,659,0,659,149,808,81.5594
第15任總統副總統,在臺中市各村(里),臺中市,　豐原區,下街里,38,205,313,556,2,558,0,558,167,725,76.9655
第15任總統副總統,在臺中市各村(里),臺中市,　豐原區,中陽里,178,1412,2257,3847,43,3890,0,3890,959,4849,80.2227
第15任總統副總統,在臺中市各村(里),臺中市,　豐原區,大湳里,99,645,1091,1835,23,1858,0,1858,577,2435,76.3039
第15任總統副總統,在臺中市各村(里),臺中市,　豐原區,北湳里,105,853,1229,2187,27,2214,0,2214,644,2858,77.4668
第15任總統副總統,在臺中市各村(里),臺中市,　豐原區,東湳里,149,932,1966,3047,31,3078,0,3078,803,3881,79.3095
第15任總統副總統,在臺中市各村(里),臺中市,　豐原區,西湳里,325,2189,4243,6757,77,6834,0,6834,1795,8629,79.1981
第15任總統副總統,在臺中市各村(里),臺中市,　豐原區,豐西里,82,446,690,1218,6,1224,0,1224,370,1594,76.7880
第15任總統副總統,在臺中市各村(里),臺中市,　豐原區,圳寮里,48,325,628,1001,8,1009,0,1009,211,1220,82.7049
第15任總統副總統,在臺中市各村(里),臺中市,　豐原區,豐圳里,143,986,1465,2594,37,2631,0,2631,634,3265,80.5819
第15任總統副總統,在臺中市各村(里),臺中市,　豐原區,富春里,23,199,361,583,4,587,0,587,126,713,82.3282
第15任總統副總統,在臺中市各村(里),臺中市,　豐原區,葫蘆里,26,147,302,475,6,481,0,481,128,609,78.9819
第15任總統副總統,在臺中市各村(里),臺中市,　豐原區,西安里,172,1326,2255,3753,38,3791,0,3791,990,4781,79.2930
第15任總統副總統,在臺中市各村(里),臺中市,　豐原區,西勢里,62,661,966,1689,22,1711,0,1711,407,2118,80.7838
第15任總統副總統,在臺中市各村(里),臺中市,　豐原區,中興里,105,916,1196,2217,34,2251,0,2251,603,2854,78.8718
第15任總統副總統,在臺中市各村(里),臺中市,　豐原區,社皮里,341,2597,4304,7242,84,7326,0,7326,2288,9614,76.2014
第15任總統副總統,在臺中市各村(里),臺中市,　豐原區,三村里,233,1684,2778,4695,58,4753,1,4754,1297,6051,78.5490
第15任總統副總統,在臺中市各村(里),臺中市,　豐原區,東勢里,34,398,678,1110,18,1128,0,1128,306,1434,78.6611
第15任總統副總統,在臺中市各村(里),臺中市,　豐原區,民生里,39,309,545,893,11,904,0,904,229,1133,79.7882
第15任總統副總統,在臺中市各村(里),臺中市,　豐原區,田心里,221,1535,2629,4385,41,4426,0,4426,1778,6204,71.3411
第15任總統副總統,在臺中市各村(里),臺中市,　豐原區,豐田里,352,2633,4671,7656,84,7740,0,7740,2158,9898,78.1976
第15任總統副總統,在臺中市各村(里),臺中市,　豐原區,鎌村里,163,1258,2095,3516,42,3558,0,3558,910,4468,79.6329
第15任總統副總統,在臺中市各村(里),臺中市,　豐原區,陽明里,99,758,1129,1986,25,2011,0,2011,546,2557,78.6469
第15任總統副總統,在臺中市各村(里),臺中市,　豐原區,南陽里,409,2920,4553,7882,80,7962,0,7962,2282,10244,77.7235
第15任總統副總統,在臺中市各村(里),臺中市,　豐原區,北陽里,445,3558,5693,9696,139,9835,0,9835,2803,12638,77.8209
第15任總統副總統,在臺中市各村(里),臺中市,　豐原區,東陽里,55,383,776,1214,9,1223,0,1223,297,1520,80.4605
第15任總統副總統,在臺中市各村(里),臺中市,　豐原區,南村里,187,1307,2467,3961,52,4013,0,4013,1152,5165,77.6960
第15任總統副總統,在臺中市各村(里),臺中市,　豐原區,南田里,117,755,1541,2413,24,2437,0,2437,707,3144,77.5127
第15任總統副總統,在臺中市各村(里),臺中市,　豐原區,南嵩里,122,797,1616,2535,38,2573,0,2573,689,3262,78.8780
第15任總統副總統,在臺中市各村(里),臺中市,　豐原區,翁明里,89,553,940,1582,27,1609,0,1609,498,2107,76.3645
第15任總統副總統,在臺中市各村(里),臺中市,　豐原區,翁子里,109,785,1358,2252,31,2283,1,2284,655,2939,77.6795
第15任總統副總統,在臺中市各村(里),臺中市,　豐原區,翁社里,71,536,1000,1607,21,1628,0,1628,395,2023,80.4745
第15任總統副總統,在臺中市各村(里),臺中市,　豐原區,朴子里,130,723,1658,2511,32,2543,0,2543,688,3231,78.7063
第15任總統副總統,在臺中市各村(里),臺中市,　東勢區,慶福里,39,345,475,859,16,875,0,875,388,1263,69.2795
第15任總統副總統,在臺中市各村(里),臺中市,　東勢區,慶東里,42,526,743,1311,28,1339,0,1339,451,1790,74.8045
第15任總統副總統,在臺中市各村(里),臺中市,　東勢區,上城里,33,311,390,734,11,745,0,745,210,955,78.0105
第15任總統副總統,在臺中市各村(里),臺中市,　東勢區,下城里,21,234,381,636,11,647,0,647,188,835,77.4850
第15任總統副總統,在臺中市各村(里),臺中市,　東勢區,詒福里,46,514,620,1180,15,1195,0,1195,374,1569,76.1632
第15任總統副總統,在臺中市各村(里),臺中市,　東勢區,新盛里,176,1515,1829,3520,53,3573,0,3573,1163,4736,75.4434
第15任總統副總統,在臺中市各村(里),臺中市,　東勢區,福隆里,119,1293,1288,2700,32,2732,0,2732,888,3620,75.4696
第15任總統副總統,在臺中市各村(里),臺中市,　東勢區,隆興里,42,503,482,1027,11,1038,0,1038,389,1427,72.7400
第15任總統副總統,在臺中市各村(里),臺中市,　東勢區,中嵙里,56,616,639,1311,13,1324,0,1324,472,1796,73.7194
第15任總統副總統,在臺中市各村(里),臺中市,　東勢區,泰昌里,101,1319,1075,2495,45,2540,0,2540,816,3356,75.6853
第15任總統副總統,在臺中市各村(里),臺中市,　東勢區,上新里,38,383,316,737,11,748,0,748,201,949,78.8198
第15任總統副總統,在臺中市各村(里),臺中市,　東勢區,廣興里,40,555,461,1056,14,1070,0,1070,295,1365,78.3883
第15任總統副總統,在臺中市各村(里),臺中市,　東勢區,延平里,70,751,787,1608,21,1629,0,1629,506,2135,76.2998
第15任總統副總統,在臺中市各村(里),臺中市,　東勢區,南平里,65,766,538,1369,13,1382,0,1382,392,1774,77.9030
第15任總統副總統,在臺中市各村(里),臺中市,　東勢區,東安里,32,376,339,747,9,756,0,756,224,980,77.1429
第15任總統副總統,在臺中市各村(里),臺中市,　東勢區,中寧里,36,307,270,613,13,626,0,626,204,830,75.4217
第15任總統副總統,在臺中市各村(里),臺中市,　東勢區,北興里,44,509,421,974,12,986,0,986,329,1315,74.9810
第15任總統副總統,在臺中市各村(里),臺中市,　東勢區,粵寧里,63,659,762,1484,18,1502,0,1502,480,1982,75.7820
第15任總統副總統,在臺中市各村(里),臺中市,　東勢區,下新里,50,488,665,1203,22,1225,1,1226,399,1625,75.3846
第15任總統副總統,在臺中市各村(里),臺中市,　東勢區,東新里,65,722,653,1440,14,1454,0,1454,446,1900,76.5263
第15任總統副總統,在臺中市各村(里),臺中市,　東勢區,興隆里,38,296,523,857,17,874,0,874,290,1164,75.0859
第15任總統副總統,在臺中市各村(里),臺中市,　東勢區,茂興里,58,551,624,1233,21,1254,0,1254,509,1763,71.1288
第15任總統副總統,在臺中市各村(里),臺中市,　東勢區,泰興里,23,206,252,481,12,493,0,493,190,683,72.1816
第15任總統副總統,在臺中市各村(里),臺中市,　東勢區,埤頭里,13,180,312,505,5,510,0,510,133,643,79.3157
第15任總統副總統,在臺中市各村(里),臺中市,　東勢區,明正里,27,404,500,931,10,941,0,941,374,1315,71.5589
第15任總統副總統,在臺中市各村(里),臺中市,　大甲區,朝陽里,38,351,597,986,7,993,0,993,318,1311,75.7437
第15任總統副總統,在臺中市各村(里),臺中市,　大甲區,大甲里,42,255,451,748,18,766,0,766,230,996,76.9076
第15任總統副總統,在臺中市各村(里),臺中市,　大甲區,順天里,54,406,676,1136,12,1148,0,1148,360,1508,76.1273
第15任總統副總統,在臺中市各村(里),臺中市,　大甲區,孔門里,9,221,277,507,7,514,0,514,238,752,68.3511
第15任總統副總統,在臺中市各村(里),臺中市,　大甲區,平安里,76,535,912,1523,23,1546,0,1546,451,1997,77.4161
第15任總統副總統,在臺中市各村(里),臺中市,　大甲區,庄美里,95,501,910,1506,20,1526,0,1526,490,2016,75.6944
第15任總統副總統,在臺中市各村(里),臺中市,　大甲區,新美里,109,953,1447,2509,28,2537,0,2537,769,3306,76.7393
第15任總統副總統,在臺中市各村(里),臺中市,　大甲區,岷山里,87,602,812,1501,29,1530,0,1530,485,2015,75.9305
第15任總統副總統,在臺中市各村(里),臺中市,　大甲區,中山里,171,1345,1676,3192,48,3240,0,3240,1066,4306,75.2438
第15任總統副總統,在臺中市各村(里),臺中市,　大甲區,南陽里,26,244,324,594,8,602,0,602,189,791,76.1062
第15任總統副總統,在臺中市各村(里),臺中市,　大甲區,薰風里,30,240,354,624,8,632,0,632,196,828,76.3285
第15任總統副總統,在臺中市各村(里),臺中市,　大甲區,義和里,113,829,1301,2243,25,2268,0,2268,806,3074,73.7801
第15任總統副總統,在臺中市各村(里),臺中市,　大甲區,武陵里,35,357,469,861,11,872,0,872,273,1145,76.1572
第15任總統副總統,在臺中市各村(里),臺中市,　大甲區,文曲里,29,232,502,763,7,770,0,770,290,1060,72.6415
第15任總統副總統,在臺中市各村(里),臺中市,　大甲區,武曲里,60,496,739,1295,22,1317,0,1317,393,1710,77.0175
第15任總統副總統,在臺中市各村(里),臺中市,　大甲區,文武里,194,1385,2228,3807,52,3859,0,3859,1207,5066,76.1745
第15任總統副總統,在臺中市各村(里),臺中市,　大甲區,奉化里,68,546,831,1445,23,1468,0,1468,458,1926,76.2201
第15任總統副總統,在臺中市各村(里),臺中市,　大甲區,德化里,48,370,828,1246,15,1261,0,1261,433,1694,74.4392
第15任總統副總統,在臺中市各村(里),臺中市,　大甲區,江南里,63,320,582,965,17,982,0,982,330,1312,74.8476
第15任總統副總統,在臺中市各村(里),臺中市,　大甲區,頂店里,157,1149,1889,3195,30,3225,0,3225,1053,4278,75.3857
第15任總統副總統,在臺中市各村(里),臺中市,　大甲區,太白里,40,278,555,873,9,882,0,882,325,1207,73.0737
第15任總統副總統,在臺中市各村(里),臺中市,　大甲區,孟春里,136,878,1747,2761,32,2793,0,2793,1035,3828,72.9624
第15任總統副總統,在臺中市各村(里),臺中市,　大甲區,幸福里,80,538,1157,1775,21,1796,0,1796,692,2488,72.1865
第15任總統副總統,在臺中市各村(里),臺中市,　大甲區,日南里,213,1279,2280,3772,62,3834,0,3834,1448,5282,72.5861
第15任總統副總統,在臺中市各村(里),臺中市,　大甲區,龍泉里,41,401,641,1083,11,1094,0,1094,377,1471,74.3712
第15任總統副總統,在臺中市各村(里),臺中市,　大甲區,西岐里,71,462,709,1242,14,1256,0,1256,383,1639,76.6321
第15任總統副總統,在臺中市各村(里),臺中市,　大甲區,銅安里,38,339,582,959,11,970,0,970,358,1328,73.0422
第15任總統副總統,在臺中市各村(里),臺中市,　大甲區,福德里,26,300,455,781,16,797,0,797,282,1079,73.8647
第15任總統副總統,在臺中市各村(里),臺中市,　大甲區,建興里,30,324,701,1055,15,1070,0,1070,357,1427,74.9825
第15任總統副總統,在臺中市各村(里),臺中市,　清水區,鰲峰里,32,292,470,794,11,805,0,805,247,1052,76.5209
第15任總統副總統,在臺中市各村(里),臺中市,　清水區,靈泉里,28,267,435,730,13,743,0,743,183,926,80.2376
第15任總統副總統,在臺中市各村(里),臺中市,　清水區,清水里,78,507,910,1495,19,1514,0,1514,465,1979,76.5033
第15任總統副總統,在臺中市各村(里),臺中市,　清水區,文昌里,24,187,303,514,10,524,0,524,142,666,78.6787
第15任總統副總統,在臺中市各村(里),臺中市,　清水區,南寧里,64,455,818,1337,12,1349,0,1349,402,1751,77.0417
第15任總統副總統,在臺中市各村(里),臺中市,　清水區,西寧里,56,371,751,1178,10,1188,0,1188,327,1515,78.4158
第15任總統副總統,在臺中市各村(里),臺中市,　清水區,北寧里,22,209,317,548,8,556,0,556,122,678,82.0059
第15任總統副總統,在臺中市各村(里),臺中市,　清水區,中興里,27,92,181,300,5,305,0,305,79,384,79.4271
第15任總統副總統,在臺中市各村(里),臺中市,　清水區,西社里,65,499,1048,1612,19,1631,0,1631,495,2126,76.7168
第15任總統副總統,在臺中市各村(里),臺中市,　清水區,南社里,377,2335,4178,6890,81,6971,0,6971,2124,9095,76.6465
第15任總統副總統,在臺中市各村(里),臺中市,　清水區,裕嘉里,59,303,714,1076,18,1094,0,1094,371,1465,74.6758
第15任總統副總統,在臺中市各村(里),臺中市,　清水區,臨江里,48,417,612,1077,17,1094,0,1094,378,1472,74.3207
第15任總統副總統,在臺中市各村(里),臺中市,　清水區,秀水里,155,1130,1834,3119,37,3156,0,3156,1054,4210,74.9644
第15任總統副總統,在臺中市各村(里),臺中市,　清水區,武鹿里,93,773,1500,2366,28,2394,0,2394,862,3256,73.5258
第15任總統副總統,在臺中市各村(里),臺中市,　清水區,海濱里,69,499,905,1473,15,1488,0,1488,504,1992,74.6988
第15任總統副總統,在臺中市各村(里),臺中市,　清水區,槺榔里,180,1241,2642,4063,58,4121,0,4121,1498,5619,73.3405
第15任總統副總統,在臺中市各村(里),臺中市,　清水區,中社里,110,1127,815,2052,23,2075,0,2075,643,2718,76.3429
第15任總統副總統,在臺中市各村(里),臺中市,　清水區,高西里,50,354,450,854,19,873,0,873,397,1270,68.7402
第15任總統副總統,在臺中市各村(里),臺中市,　清水區,高南里,40,325,574,939,13,952,0,952,369,1321,72.0666
第15任總統副總統,在臺中市各村(里),臺中市,　清水區,高東里,43,253,560,856,16,872,0,872,350,1222,71.3584
第15任總統副總統,在臺中市各村(里),臺中市,　清水區,高北里,40,294,434,768,19,787,0,787,350,1137,69.2172
第15任總統副總統,在臺中市各村(里),臺中市,　清水區,高美里,33,360,496,889,16,905,0,905,364,1269,71.3160
第15任總統副總統,在臺中市各村(里),臺中市,　清水區,國姓里,56,406,949,1411,20,1431,0,1431,642,2073,69.0304
第15任總統副總統,在臺中市各村(里),臺中市,　清水區,菁埔里,85,513,1029,1627,13,1640,0,1640,562,2202,74.4777
第15任總統副總統,在臺中市各村(里),臺中市,　清水區,頂湳里,60,387,785,1232,15,1247,0,1247,452,1699,73.3961
第15任總統副總統,在臺中市各村(里),臺中市,　清水區,田寮里,67,503,1183,1753,19,1772,0,1772,666,2438,72.6825
第15任總統副總統,在臺中市各村(里),臺中市,　清水區,橋頭里,264,1662,3445,5371,67,5438,0,5438,1753,7191,75.6223
第15任總統副總統,在臺中市各村(里),臺中市,　清水區,下湳里,82,683,1265,2030,36,2066,0,2066,629,2695,76.6605
第15任總統副總統,在臺中市各村(里),臺中市,　清水區,東山里,40,341,500,881,16,897,0,897,269,1166,76.9297
第15任總統副總統,在臺中市各村(里),臺中市,　清水區,吳厝里,59,355,655,1069,27,1096,0,1096,320,1416,77.4011
第15任總統副總統,在臺中市各村(里),臺中市,　清水區,楊厝里,41,273,523,837,10,847,0,847,279,1126,75.2220
第15任總統副總統,在臺中市各村(里),臺中市,　清水區,海風里,50,333,590,973,14,987,0,987,349,1336,73.8772
第15任總統副總統,在臺中市各村(里),臺中市,　沙鹿區,居仁里,68,367,580,1015,9,1024,0,1024,333,1357,75.4606
第15任總統副總統,在臺中市各村(里),臺中市,　沙鹿區,洛泉里,81,590,890,1561,17,1578,0,1578,374,1952,80.8402
第15任總統副總統,在臺中市各村(里),臺中市,　沙鹿區,沙鹿里,30,225,474,729,9,738,0,738,180,918,80.3922
第15任總統副總統,在臺中市各村(里),臺中市,　沙鹿區,美仁里,21,173,187,381,2,383,0,383,103,486,78.8066
第15任總統副總統,在臺中市各村(里),臺中市,　沙鹿區,興仁里,101,673,1104,1878,15,1893,0,1893,510,2403,78.7765
第15任總統副總統,在臺中市各村(里),臺中市,　沙鹿區,興安里,154,869,1519,2542,30,2572,0,2572,694,3266,78.7508
第15任總統副總統,在臺中市各村(里),臺中市,　沙鹿區,斗抵里,177,1172,1939,3288,33,3321,0,3321,906,4227,78.5664
第15任總統副總統,在臺中市各村(里),臺中市,　沙鹿區,鹿峰里,161,1244,2391,3796,45,3841,0,3841,1100,4941,77.7373
第15任總統副總統,在臺中市各村(里),臺中市,　沙鹿區,鹿寮里,264,1569,3311,5144,59,5203,0,5203,1399,6602,78.8095
第15任總統副總統,在臺中市各村(里),臺中市,　沙鹿區,竹林里,291,2028,3096,5415,62,5477,0,5477,1688,7165,76.4410
第15任總統副總統,在臺中市各村(里),臺中市,　沙鹿區,犁分里,39,264,517,820,14,834,0,834,245,1079,77.2938
第15任總統副總統,在臺中市各村(里),臺中市,　沙鹿區,福興里,157,1073,1465,2695,39,2734,0,2734,847,3581,76.3474
第15任總統副總統,在臺中市各村(里),臺中市,　沙鹿區,北勢里,193,1233,1991,3417,45,3462,0,3462,1208,4670,74.1328
第15任總統副總統,在臺中市各村(里),臺中市,　沙鹿區,晉江里,75,429,802,1306,14,1320,0,1320,337,1657,79.6620
第15任總統副總統,在臺中市各村(里),臺中市,　沙鹿區,六路里,247,1341,2242,3830,58,3888,0,3888,1107,4995,77.8378
第15任總統副總統,在臺中市各村(里),臺中市,　沙鹿區,南勢里,193,849,1407,2449,33,2482,0,2482,741,3223,77.0090
第15任總統副總統,在臺中市各村(里),臺中市,　沙鹿區,埔子里,244,1648,2239,4131,60,4191,0,4191,1113,5304,79.0158
第15任總統副總統,在臺中市各村(里),臺中市,　沙鹿區,三鹿里,351,1935,2811,5097,84,5181,0,5181,1543,6724,77.0523
第15任總統副總統,在臺中市各村(里),臺中市,　沙鹿區,公明里,174,1451,1543,3168,36,3204,0,3204,1031,4235,75.6553
第15任總統副總統,在臺中市各村(里),臺中市,　沙鹿區,清泉里,82,780,860,1722,20,1742,0,1742,519,2261,77.0456
第15任總統副總統,在臺中市各村(里),臺中市,　沙鹿區,西勢里,73,674,829,1576,14,1590,0,1590,463,2053,77.4476
第15任總統副總統,在臺中市各村(里),臺中市,　梧棲區,頂寮里,124,939,1490,2553,46,2599,0,2599,869,3468,74.9423
第15任總統副總統,在臺中市各村(里),臺中市,　梧棲區,下寮里,67,502,873,1442,16,1458,0,1458,461,1919,75.9771
第15任總統副總統,在臺中市各村(里),臺中市,　梧棲區,中正里,138,1047,1530,2715,48,2763,0,2763,1029,3792,72.8639
第15任總統副總統,在臺中市各村(里),臺中市,　梧棲區,中和里,11,137,222,370,6,376,0,376,105,481,78.1705
第15任總統副總統,在臺中市各村(里),臺中市,　梧棲區,文化里,65,301,462,828,7,835,0,835,289,1124,74.2883
第15任總統副總統,在臺中市各村(里),臺中市,　梧棲區,安仁里,12,221,355,588,8,596,0,596,207,803,74.2217
第15任總統副總統,在臺中市各村(里),臺中市,　梧棲區,草湳里,217,1539,2625,4381,69,4450,0,4450,1556,6006,74.0926
第15任總統副總統,在臺中市各村(里),臺中市,　梧棲區,南簡里,177,1096,2361,3634,43,3677,0,3677,1221,4898,75.0715
第15任總統副總統,在臺中市各村(里),臺中市,　梧棲區,福德里,138,1070,2068,3276,38,3314,0,3314,1205,4519,73.3348
第15任總統副總統,在臺中市各村(里),臺中市,　梧棲區,大庄里,299,1820,3131,5250,56,5306,0,5306,1772,7078,74.9647
第15任總統副總統,在臺中市各村(里),臺中市,　梧棲區,大村里,233,1350,2409,3992,58,4050,0,4050,1352,5402,74.9722
第15任總統副總統,在臺中市各村(里),臺中市,　梧棲區,興農里,91,569,1026,1686,26,1712,0,1712,543,2255,75.9202
第15任總統副總統,在臺中市各村(里),臺中市,　梧棲區,永寧里,71,515,1014,1600,27,1627,0,1627,530,2157,75.4288
第15任總統副總統,在臺中市各村(里),臺中市,　梧棲區,永安里,80,609,1136,1825,19,1844,0,1844,572,2416,76.3245
第15任總統副總統,在臺中市各村(里),臺中市,　后里區,廣福里,71,751,641,1463,33,1496,0,1496,499,1995,74.9875
第15任總統副總統,在臺中市各村(里),臺中市,　后里區,仁里里,42,298,416,756,11,767,0,767,269,1036,74.0347
第15任總統副總統,在臺中市各村(里),臺中市,　后里區,義里里,115,1047,1164,2326,26,2352,0,2352,683,3035,77.4959
第15任總統副總統,在臺中市各村(里),臺中市,　后里區,義德里,104,891,958,1953,30,1983,0,1983,582,2565,77.3099
第15任總統副總統,在臺中市各村(里),臺中市,　后里區,后里里,152,1108,1568,2828,40,2868,0,2868,720,3588,79.9331
第15任總統副總統,在臺中市各村(里),臺中市,　后里區,厚里里,84,641,904,1629,27,1656,0,1656,392,2048,80.8594
第15任總統副總統,在臺中市各村(里),臺中市,　后里區,墩東里,194,1379,2004,3577,43,3620,0,3620,995,4615,78.4399
第15任總統副總統,在臺中市各村(里),臺中市,　后里區,墩西里,75,475,849,1399,15,1414,0,1414,484,1898,74.4995
第15任總統副總統,在臺中市各村(里),臺中市,　后里區,墩南里,123,903,1540,2566,33,2599,0,2599,680,3279,79.2620
第15任總統副總統,在臺中市各村(里),臺中市,　后里區,墩北里,127,954,1528,2609,39,2648,0,2648,732,3380,78.3432
第15任總統副總統,在臺中市各村(里),臺中市,　后里區,中和里,83,633,1125,1841,22,1863,0,1863,498,2361,78.9072
第15任總統副總統,在臺中市各村(里),臺中市,　后里區,舊社里,88,517,989,1594,22,1616,0,1616,458,2074,77.9171
第15任總統副總統,在臺中市各村(里),臺中市,　后里區,聯合里,56,432,681,1169,17,1186,0,1186,338,1524,77.8215
第15任總統副總統,在臺中市各村(里),臺中市,　后里區,太平里,93,574,871,1538,30,1568,0,1568,499,2067,75.8587
第15任總統副總統,在臺中市各村(里),臺中市,　后里區,眉山里,127,920,1293,2340,27,2367,0,2367,658,3025,78.2479
第15任總統副總統,在臺中市各村(里),臺中市,　后里區,月眉里,66,479,887,1432,16,1448,0,1448,414,1862,77.7658
第15任總統副總統,在臺中市各村(里),臺中市,　后里區,公館里,73,558,940,1571,24,1595,0,1595,495,2090,76.3158
第15任總統副總統,在臺中市各村(里),臺中市,　后里區,泰安里,43,322,646,1011,18,1029,0,1029,320,1349,76.2787
第15任總統副總統,在臺中市各村(里),臺中市,　神岡區,神岡里,99,861,1398,2358,27,2385,0,2385,710,3095,77.0598
第15任總統副總統,在臺中市各村(里),臺中市,　神岡區,庄前里,92,588,1045,1725,15,1740,0,1740,457,2197,79.1989
第15任總統副總統,在臺中市各村(里),臺中市,　神岡區,北庄里,92,678,1191,1961,22,1983,0,1983,525,2508,79.0670
第15任總統副總統,在臺中市各村(里),臺中市,　神岡區,庄後里,80,498,1136,1714,27,1741,0,1741,415,2156,80.7514
第15任總統副總統,在臺中市各村(里),臺中市,　神岡區,圳前里,86,690,985,1761,30,1791,0,1791,495,2286,78.3465
第15任總統副總統,在臺中市各村(里),臺中市,　神岡區,圳堵里,71,610,880,1561,20,1581,0,1581,464,2045,77.3105
第15任總統副總統,在臺中市各村(里),臺中市,　神岡區,新庄里,118,984,1848,2950,56,3006,0,3006,998,4004,75.0749
第15任總統副總統,在臺中市各村(里),臺中市,　神岡區,山皮里,41,222,522,785,9,794,0,794,209,1003,79.1625
第15任總統副總統,在臺中市各村(里),臺中市,　神岡區,社口里,267,1691,3488,5446,59,5505,0,5505,1619,7124,77.2740
第15任總統副總統,在臺中市各村(里),臺中市,　神岡區,社南里,183,1157,2662,4002,39,4041,0,4041,1079,5120,78.9258
第15任總統副總統,在臺中市各村(里),臺中市,　神岡區,三角里,93,599,1268,1960,17,1977,0,1977,513,2490,79.3976
第15任總統副總統,在臺中市各村(里),臺中市,　神岡區,大社里,143,1152,1930,3225,36,3261,0,3261,994,4255,76.6392
第15任總統副總統,在臺中市各村(里),臺中市,　神岡區,岸裡里,82,674,1434,2190,22,2212,0,2212,587,2799,79.0282
第15任總統副總統,在臺中市各村(里),臺中市,　神岡區,豐洲里,281,1703,3366,5350,64,5414,0,5414,1593,7007,77.2656
第15任總統副總統,在臺中市各村(里),臺中市,　神岡區,神洲里,92,527,1307,1926,24,1950,0,1950,519,2469,78.9793
第15任總統副總統,在臺中市各村(里),臺中市,　神岡區,溪洲里,110,656,1383,2149,33,2182,0,2182,523,2705,80.6654
第15任總統副總統,在臺中市各村(里),臺中市,　潭子區,潭秀里,43,288,647,978,14,992,0,992,267,1259,78.7927
第15任總統副總統,在臺中市各村(里),臺中市,　潭子區,潭北里,78,736,913,1727,35,1762,0,1762,501,2263,77.8612
第15任總統副總統,在臺中市各村(里),臺中市,　潭子區,潭陽里,444,2964,4707,8115,87,8202,0,8202,2455,10657,76.9635
第15任總統副總統,在臺中市各村(里),臺中市,　潭子區,福仁里,407,3042,4199,7648,86,7734,0,7734,2324,10058,76.8940
第15任總統副總統,在臺中市各村(里),臺中市,　潭子區,頭家里,213,1518,2230,3961,57,4018,0,4018,1111,5129,78.3389
第15任總統副總統,在臺中市各村(里),臺中市,　潭子區,頭家東里,159,1304,1721,3184,44,3228,0,3228,1009,4237,76.1860
第15任總統副總統,在臺中市各村(里),臺中市,　潭子區,家興里,290,1990,2721,5001,58,5059,0,5059,1556,6615,76.4777
第15任總統副總統,在臺中市各村(里),臺中市,　潭子區,家福里,196,1303,1979,3478,34,3512,0,3512,885,4397,79.8726
第15任總統副總統,在臺中市各村(里),臺中市,　潭子區,甘蔗里,346,2719,3962,7027,60,7087,0,7087,1994,9081,78.0421
第15任總統副總統,在臺中市各村(里),臺中市,　潭子區,東寶里,436,3228,5388,9052,98,9150,1,9151,2516,11667,78.4263
第15任總統副總統,在臺中市各村(里),臺中市,　潭子區,大富里,106,681,1330,2117,41,2158,0,2158,547,2705,79.7782
第15任總統副總統,在臺中市各村(里),臺中市,　潭子區,大豐里,242,1512,2762,4516,52,4568,0,4568,1133,5701,80.1263
第15任總統副總統,在臺中市各村(里),臺中市,　潭子區,栗林里,156,1159,2181,3496,35,3531,0,3531,949,4480,78.8170
第15任總統副總統,在臺中市各村(里),臺中市,　潭子區,嘉仁里,119,1047,1847,3013,34,3047,0,3047,802,3849,79.1634
第15任總統副總統,在臺中市各村(里),臺中市,　潭子區,新田里,53,358,726,1137,15,1152,0,1152,334,1486,77.5236
第15任總統副總統,在臺中市各村(里),臺中市,　潭子區,聚興里,136,1098,1640,2874,42,2916,0,2916,1152,4068,71.6814
第15任總統副總統,在臺中市各村(里),臺中市,　大雅區,上雅里,247,1582,2530,4359,54,4413,0,4413,1437,5850,75.4359
第15任總統副總統,在臺中市各村(里),臺中市,　大雅區,大雅里,168,1260,1914,3342,50,3392,0,3392,867,4259,79.6431
第15任總統副總統,在臺中市各村(里),臺中市,　大雅區,文雅里,186,1761,2444,4391,45,4436,0,4436,1320,5756,77.0674
第15任總統副總統,在臺中市各村(里),臺中市,　大雅區,三和里,185,1394,2340,3919,45,3964,0,3964,1041,5005,79.2008
第15任總統副總統,在臺中市各村(里),臺中市,　大雅區,二和里,215,1649,2519,4383,60,4443,0,4443,1297,5740,77.4042
第15任總統副總統,在臺中市各村(里),臺中市,　大雅區,四德里,189,1289,1953,3431,39,3470,0,3470,928,4398,78.8995
第15任總統副總統,在臺中市各村(里),臺中市,　大雅區,西寶里,154,1174,2107,3435,38,3473,0,3473,1097,4570,75.9956
第15任總統副總統,在臺中市各村(里),臺中市,　大雅區,上楓里,228,1551,2705,4484,56,4540,0,4540,1300,5840,77.7397
第15任總統副總統,在臺中市各村(里),臺中市,　大雅區,大楓里,184,1269,2117,3570,42,3612,0,3612,1128,4740,76.2025
第15任總統副總統,在臺中市各村(里),臺中市,　大雅區,雅楓里,150,1041,1398,2589,54,2643,0,2643,843,3486,75.8176
第15任總統副總統,在臺中市各村(里),臺中市,　大雅區,員林里,350,2414,4151,6915,89,7004,0,7004,1817,8821,79.4014
第15任總統副總統,在臺中市各村(里),臺中市,　大雅區,六寶里,224,1931,2305,4460,57,4517,0,4517,1411,5928,76.1977
第15任總統副總統,在臺中市各村(里),臺中市,　大雅區,秀山里,131,876,1557,2564,30,2594,0,2594,584,3178,81.6237
第15任總統副總統,在臺中市各村(里),臺中市,　大雅區,橫山里,157,1113,1960,3230,33,3263,5,3268,882,4150,78.6265
第15任總統副總統,在臺中市各村(里),臺中市,　大雅區,忠義里,113,1630,792,2535,41,2576,0,2576,929,3505,73.4950
第15任總統副總統,在臺中市各村(里),臺中市,　新社區,新社里,118,1050,1265,2433,21,2454,0,2454,709,3163,77.5846
第15任總統副總統,在臺中市各村(里),臺中市,　新社區,復盛里,77,561,664,1302,15,1317,0,1317,480,1797,73.2888
第15任總統副總統,在臺中市各村(里),臺中市,　新社區,中正里,52,399,566,1017,17,1034,0,1034,284,1318,78.4522
第15任總統副總統,在臺中市各村(里),臺中市,　新社區,月湖里,30,270,438,738,12,750,0,750,225,975,76.9231
第15任總統副總統,在臺中市各村(里),臺中市,　新社區,崑山里,35,239,589,863,14,877,0,877,253,1130,77.6106
第15任總統副總統,在臺中市各村(里),臺中市,　新社區,大南里,62,585,678,1325,26,1351,0,1351,460,1811,74.5997
第15任總統副總統,在臺中市各村(里),臺中市,　新社區,永源里,81,744,1376,2201,29,2230,0,2230,633,2863,77.8903
第15任總統副總統,在臺中市各村(里),臺中市,　新社區,中興里,12,307,141,460,2,462,0,462,102,564,81.9149
第15任總統副總統,在臺中市各村(里),臺中市,　新社區,協成里,96,784,1244,2124,34,2158,0,2158,646,2804,76.9615
第15任總統副總統,在臺中市各村(里),臺中市,　新社區,東興里,24,427,427,878,16,894,0,894,294,1188,75.2525
第15任總統副總統,在臺中市各村(里),臺中市,　新社區,慶西里,25,245,347,617,13,630,0,630,236,866,72.7483
第15任總統副總統,在臺中市各村(里),臺中市,　新社區,中和里,24,287,123,434,8,442,0,442,131,573,77.1379
第15任總統副總統,在臺中市各村(里),臺中市,　新社區,福興里,32,392,373,797,11,808,0,808,322,1130,71.5044
第15任總統副總統,在臺中市各村(里),臺中市,　石岡區,石岡里,37,379,499,915,12,927,0,927,268,1195,77.5732
第15任總統副總統,在臺中市各村(里),臺中市,　石岡區,萬安里,67,474,641,1182,19,1201,0,1201,290,1491,80.5500
第15任總統副總統,在臺中市各村(里),臺中市,　石岡區,九房里,33,370,467,870,10,880,0,880,275,1155,76.1905
第15任總統副總統,在臺中市各村(里),臺中市,　石岡區,金星里,47,353,489,889,14,903,0,903,324,1227,73.5941
第15任總統副總統,在臺中市各村(里),臺中市,　石岡區,龍興里,25,203,264,492,6,498,0,498,140,638,78.0564
第15任總統副總統,在臺中市各村(里),臺中市,　石岡區,萬興里,51,430,590,1071,29,1100,0,1100,311,1411,77.9589
第15任總統副總統,在臺中市各村(里),臺中市,　石岡區,梅子里,66,566,706,1338,26,1364,0,1364,392,1756,77.6765
第15任總統副總統,在臺中市各村(里),臺中市,　石岡區,土牛里,33,347,352,732,11,743,0,743,241,984,75.5081
第15任總統副總統,在臺中市各村(里),臺中市,　石岡區,德興里,48,497,486,1031,10,1041,0,1041,341,1382,75.3256
第15任總統副總統,在臺中市各村(里),臺中市,　石岡區,和盛里,37,433,444,914,9,923,0,923,279,1202,76.7887
第15任總統副總統,在臺中市各村(里),臺中市,　外埔區,永豐里,43,319,386,748,9,757,0,757,282,1039,72.8585
第15任總統副總統,在臺中市各村(里),臺中市,　外埔區,六分里,83,721,792,1596,16,1612,1,1613,500,2113,76.2896
第15任總統副總統,在臺中市各村(里),臺中市,　外埔區,大同里,170,1425,1799,3394,46,3440,0,3440,1092,4532,75.9047
第15任總統副總統,在臺中市各村(里),臺中市,　外埔區,大東里,229,1858,2425,4512,65,4577,0,4577,1627,6204,73.7750
第15任總統副總統,在臺中市各村(里),臺中市,　外埔區,三崁里,71,515,725,1311,18,1329,0,1329,493,1822,72.9418
第15任總統副總統,在臺中市各村(里),臺中市,　外埔區,水美里,102,1041,1373,2516,23,2539,0,2539,810,3349,75.8137
第15任總統副總統,在臺中市各村(里),臺中市,　外埔區,鐵山里,92,588,812,1492,18,1510,0,1510,566,2076,72.7360
第15任總統副總統,在臺中市各村(里),臺中市,　外埔區,中山里,45,382,459,886,16,902,0,902,267,1169,77.1600
第15任總統副總統,在臺中市各村(里),臺中市,　外埔區,馬鳴里,57,379,523,959,14,973,0,973,373,1346,72.2883
第15任總統副總統,在臺中市各村(里),臺中市,　外埔區,土城里,31,437,748,1216,9,1225,0,1225,362,1587,77.1897
第15任總統副總統,在臺中市各村(里),臺中市,　外埔區,廍子里,38,290,488,816,10,826,0,826,322,1148,71.9512
第15任總統副總統,在臺中市各村(里),臺中市,　大安區,南埔里,21,228,497,746,10,756,0,756,255,1011,74.7774
第15任總統副總統,在臺中市各村(里),臺中市,　大安區,南庄里,22,257,470,749,11,760,0,760,249,1009,75.3221
第15任總統副總統,在臺中市各村(里),臺中市,　大安區,中庄里,94,663,1085,1842,17,1859,0,1859,728,2587,71.8593
第15任總統副總統,在臺中市各村(里),臺中市,　大安區,東安里,33,346,522,901,10,911,0,911,286,1197,76.1069
第15任總統副總統,在臺中市各村(里),臺中市,　大安區,福興里,41,266,521,828,8,836,0,836,287,1123,74.4435
第15任總統副總統,在臺中市各村(里),臺中市,　大安區,龜壳里,40,414,635,1089,13,1102,0,1102,404,1506,73.1740
第15任總統副總統,在臺中市各村(里),臺中市,　大安區,頂安里,28,216,381,625,9,634,0,634,239,873,72.6231
第15任總統副總統,在臺中市各村(里),臺中市,　大安區,永安里,70,466,691,1227,15,1242,0,1242,453,1695,73.2743
第15任總統副總統,在臺中市各村(里),臺中市,　大安區,福住里,33,268,410,711,8,719,0,719,291,1010,71.1881
第15任總統副總統,在臺中市各村(里),臺中市,　大安區,海墘里,36,441,512,989,12,1001,0,1001,393,1394,71.8077
第15任總統副總統,在臺中市各村(里),臺中市,　大安區,西安里,47,450,713,1210,27,1237,0,1237,457,1694,73.0224
第15任總統副總統,在臺中市各村(里),臺中市,　大安區,松雅里,33,222,448,703,6,709,0,709,196,905,78.3425
第15任總統副總統,在臺中市各村(里),臺中市,　烏日區,烏日里,303,2308,3820,6431,91,6522,0,6522,1822,8344,78.1640
第15任總統副總統,在臺中市各村(里),臺中市,　烏日區,湖日里,92,646,1108,1846,18,1864,0,1864,608,2472,75.4045
第15任總統副總統,在臺中市各村(里),臺中市,　烏日區,三和里,166,1473,1910,3549,47,3596,0,3596,1209,4805,74.8387
第15任總統副總統,在臺中市各村(里),臺中市,　烏日區,榮泉里,223,1558,2054,3835,38,3873,0,3873,1189,5062,76.5113
第15任總統副總統,在臺中市各村(里),臺中市,　烏日區,學田里,101,773,1050,1924,19,1943,0,1943,627,2570,75.6031
第15任總統副總統,在臺中市各村(里),臺中市,　烏日區,九德里,478,3460,5642,9580,127,9707,0,9707,2753,12460,77.9053
第15任總統副總統,在臺中市各村(里),臺中市,　烏日區,仁德里,243,2129,3189,5561,56,5617,0,5617,1664,7281,77.1460
第15任總統副總統,在臺中市各村(里),臺中市,　烏日區,前竹里,60,407,840,1307,12,1319,0,1319,299,1618,81.5204
第15任總統副總統,在臺中市各村(里),臺中市,　烏日區,五光里,60,434,740,1234,22,1256,1,1257,375,1632,76.9608
第15任總統副總統,在臺中市各村(里),臺中市,　烏日區,光明里,96,504,963,1563,22,1585,0,1585,489,2074,76.4224
第15任總統副總統,在臺中市各村(里),臺中市,　烏日區,東園里,92,550,980,1622,23,1645,0,1645,420,2065,79.6610
第15任總統副總統,在臺中市各村(里),臺中市,　烏日區,溪埧里,196,1226,1941,3363,35,3398,0,3398,838,4236,80.2172
第15任總統副總統,在臺中市各村(里),臺中市,　烏日區,螺潭里,100,551,986,1637,26,1663,0,1663,382,2045,81.3203
第15任總統副總統,在臺中市各村(里),臺中市,　烏日區,北里里,60,417,766,1243,13,1256,0,1256,346,1602,78.4020
第15任總統副總統,在臺中市各村(里),臺中市,　烏日區,南里里,64,405,546,1015,11,1026,0,1026,293,1319,77.7862
第15任總統副總統,在臺中市各村(里),臺中市,　烏日區,溪尾里,44,260,303,607,11,618,0,618,195,813,76.0148
第15任總統副總統,在臺中市各村(里),臺中市,　大肚區,王田里,165,1100,1877,3142,48,3190,0,3190,984,4174,76.4255
第15任總統副總統,在臺中市各村(里),臺中市,　大肚區,中和里,46,227,395,668,7,675,0,675,163,838,80.5489
第15任總統副總統,在臺中市各村(里),臺中市,　大肚區,福山里,129,1014,1493,2636,24,2660,0,2660,777,3437,77.3931
第15任總統副總統,在臺中市各村(里),臺中市,　大肚區,營埔里,48,393,641,1082,23,1105,0,1105,325,1430,77.2727
第15任總統副總統,在臺中市各村(里),臺中市,　大肚區,社腳里,93,773,1003,1869,30,1899,0,1899,474,2373,80.0253
第15任總統副總統,在臺中市各村(里),臺中市,　大肚區,新興里,99,822,987,1908,14,1922,0,1922,605,2527,76.0586
第15任總統副總統,在臺中市各村(里),臺中市,　大肚區,大東里,129,885,1267,2281,27,2308,0,2308,646,2954,78.1313
第15任總統副總統,在臺中市各村(里),臺中市,　大肚區,大肚里,101,688,897,1686,23,1709,0,1709,371,2080,82.1635
第15任總統副總統,在臺中市各村(里),臺中市,　大肚區,永和里,29,246,353,628,15,643,0,643,173,816,78.7990
第15任總統副總統,在臺中市各村(里),臺中市,　大肚區,磺溪里,72,468,668,1208,22,1230,0,1230,377,1607,76.5401
第15任總統副總統,在臺中市各村(里),臺中市,　大肚區,永順里,57,460,784,1301,9,1310,0,1310,354,1664,78.7260
第15任總統副總統,在臺中市各村(里),臺中市,　大肚區,成功里,49,295,371,715,16,731,0,731,198,929,78.6868
第15任總統副總統,在臺中市各村(里),臺中市,　大肚區,山陽里,41,353,590,984,19,1003,0,1003,290,1293,77.5715
第15任總統副總統,在臺中市各村(里),臺中市,　大肚區,頂街里,311,2060,2965,5336,65,5401,0,5401,1706,7107,75.9955
第15任總統副總統,在臺中市各村(里),臺中市,　大肚區,瑞井里,172,1329,2196,3697,46,3743,1,3744,1197,4941,75.7539
第15任總統副總統,在臺中市各村(里),臺中市,　大肚區,蔗廍里,161,1161,2095,3417,44,3461,0,3461,1170,4631,74.7355
第15任總統副總統,在臺中市各村(里),臺中市,　大肚區,自強里,140,1071,1350,2561,34,2595,0,2595,806,3401,76.3011
第15任總統副總統,在臺中市各村(里),臺中市,　龍井區,竹坑里,154,748,1272,2174,37,2211,0,2211,722,2933,75.3836
第15任總統副總統,在臺中市各村(里),臺中市,　龍井區,龍東里,119,751,1131,2001,35,2036,0,2036,682,2718,74.9080
第15任總統副總統,在臺中市各村(里),臺中市,　龍井區,龍西里,75,530,776,1381,16,1397,0,1397,411,1808,77.2677
第15任總統副總統,在臺中市各村(里),臺中市,　龍井區,田中里,108,896,1594,2598,44,2642,0,2642,722,3364,78.5375
第15任總統副總統,在臺中市各村(里),臺中市,　龍井區,福田里,40,309,384,733,7,740,0,740,285,1025,72.1951
第15任總統副總統,在臺中市各村(里),臺中市,　龍井區,麗水里,89,618,912,1619,33,1652,0,1652,529,2181,75.7451
第15任總統副總統,在臺中市各村(里),臺中市,　龍井區,龍津里,177,1137,2278,3592,65,3657,0,3657,1190,4847,75.4487
第15任總統副總統,在臺中市各村(里),臺中市,　龍井區,三德里,104,672,1301,2077,42,2119,0,2119,700,2819,75.1685
第15任總統副總統,在臺中市各村(里),臺中市,　龍井區,忠和里,217,1087,2328,3632,48,3680,0,3680,1124,4804,76.6028
第15任總統副總統,在臺中市各村(里),臺中市,　龍井區,山腳里,252,1383,2460,4095,58,4153,0,4153,1334,5487,75.6880
第15任總統副總統,在臺中市各村(里),臺中市,　龍井區,龍泉里,329,1921,3076,5326,97,5423,0,5423,1729,7152,75.8249
第15任總統副總統,在臺中市各村(里),臺中市,　龍井區,龍崗里,96,658,1076,1830,39,1869,0,1869,588,2457,76.0684
第15任總統副總統,在臺中市各村(里),臺中市,　龍井區,新庄里,202,1595,2651,4448,57,4505,0,4505,1463,5968,75.4859
第15任總統副總統,在臺中市各村(里),臺中市,　龍井區,南寮里,62,402,721,1185,16,1201,0,1201,323,1524,78.8058
第15任總統副總統,在臺中市各村(里),臺中市,　龍井區,新東里,160,1434,1925,3519,48,3567,0,3567,1115,4682,76.1854
第15任總統副總統,在臺中市各村(里),臺中市,　龍井區,東海里,303,2686,3296,6285,77,6362,0,6362,1969,8331,76.3654
第15任總統副總統,在臺中市各村(里),臺中市,　霧峰區,桐林里,52,370,500,922,9,931,0,931,253,1184,78.6318
第15任總統副總統,在臺中市各村(里),臺中市,　霧峰區,吉峰里,369,2571,3648,6588,57,6645,0,6645,2404,9049,73.4335
第15任總統副總統,在臺中市各村(里),臺中市,　霧峰區,甲寅里,169,1377,1891,3437,35,3472,0,3472,1135,4607,75.3636
第15任總統副總統,在臺中市各村(里),臺中市,　霧峰區,本鄉里,91,646,965,1702,20,1722,0,1722,537,2259,76.2284
第15任總統副總統,在臺中市各村(里),臺中市,　霧峰區,中正里,81,639,838,1558,13,1571,1,1572,409,1981,79.3034
第15任總統副總統,在臺中市各村(里),臺中市,　霧峰區,錦榮里,52,389,488,929,14,943,0,943,256,1199,78.6489
第15任總統副總統,在臺中市各村(里),臺中市,　霧峰區,萊園里,51,292,447,790,11,801,0,801,251,1052,76.1407
第15任總統副總統,在臺中市各村(里),臺中市,　霧峰區,本堂里,242,1885,2275,4402,29,4431,0,4431,1262,5693,77.8324
第15任總統副總統,在臺中市各村(里),臺中市,　霧峰區,北柳里,125,1052,1784,2961,39,3000,0,3000,824,3824,78.4519
第15任總統副總統,在臺中市各村(里),臺中市,　霧峰區,南柳里,62,505,834,1401,20,1421,0,1421,355,1776,80.0113
第15任總統副總統,在臺中市各村(里),臺中市,　霧峰區,四德里,82,643,1108,1833,21,1854,0,1854,542,2396,77.3790
第15任總統副總統,在臺中市各村(里),臺中市,　霧峰區,五福里,107,697,1110,1914,35,1949,0,1949,546,2495,78.1162
第15任總統副總統,在臺中市各村(里),臺中市,　霧峰區,丁台里,93,511,1137,1741,23,1764,0,1764,447,2211,79.7829
第15任總統副總統,在臺中市各村(里),臺中市,　霧峰區,北勢里,100,680,803,1583,25,1608,0,1608,390,1998,80.4805
第15任總統副總統,在臺中市各村(里),臺中市,　霧峰區,南勢里,47,371,547,965,7,972,0,972,273,1245,78.0723
第15任總統副總統,在臺中市各村(里),臺中市,　霧峰區,萬豐里,90,644,1155,1889,20,1909,0,1909,668,2577,74.0784
第15任總統副總統,在臺中市各村(里),臺中市,　霧峰區,舊正里,74,575,867,1516,13,1529,0,1529,490,2019,75.7306
第15任總統副總統,在臺中市各村(里),臺中市,　霧峰區,坑口里,103,918,1133,2154,25,2179,0,2179,705,2884,75.5548
第15任總統副總統,在臺中市各村(里),臺中市,　霧峰區,峰谷里,47,278,476,801,10,811,0,811,257,1068,75.9363
第15任總統副總統,在臺中市各村(里),臺中市,　霧峰區,六股里,95,544,1174,1813,24,1837,0,1837,464,2301,79.8349
第15任總統副總統,在臺中市各村(里),臺中市,　太平區,太平里,198,1325,2436,3959,56,4015,0,4015,1289,5304,75.6976
第15任總統副總統,在臺中市各村(里),臺中市,　太平區,長億里,193,1622,2472,4287,45,4332,0,4332,1336,5668,76.4291
第15任總統副總統,在臺中市各村(里),臺中市,　太平區,永成里,228,1674,2936,4838,50,4888,0,4888,1572,6460,75.6656
第15任總統副總統,在臺中市各村(里),臺中市,　太平區,中平里,155,1028,1748,2931,38,2969,0,2969,988,3957,75.0316
第15任總統副總統,在臺中市各村(里),臺中市,　太平區,中政里,125,907,1514,2546,23,2569,0,2569,1008,3577,71.8200
第15任總統副總統,在臺中市各村(里),臺中市,　太平區,平安里,95,563,1011,1669,20,1689,0,1689,496,2185,77.2998
第15任總統副總統,在臺中市各村(里),臺中市,　太平區,中興里,126,771,1501,2398,39,2437,0,2437,772,3209,75.9427
第15任總統副總統,在臺中市各村(里),臺中市,　太平區,永平里,146,1055,1741,2942,34,2976,0,2976,973,3949,75.3609
第15任總統副總統,在臺中市各村(里),臺中市,　太平區,東平里,165,1074,1722,2961,31,2992,0,2992,1033,4025,74.3354
第15任總統副總統,在臺中市各村(里),臺中市,　太平區,成功里,130,895,1709,2734,31,2765,0,2765,1018,3783,73.0901
第15任總統副總統,在臺中市各村(里),臺中市,　太平區,東和里,94,711,1181,1986,27,2013,0,2013,747,2760,72.9348
第15任總統副總統,在臺中市各村(里),臺中市,　太平區,建國里,93,838,1123,2054,31,2085,0,2085,768,2853,73.0810
第15任總統副總統,在臺中市各村(里),臺中市,　太平區,建興里,93,811,1131,2035,22,2057,0,2057,809,2866,71.7725
第15任總統副總統,在臺中市各村(里),臺中市,　太平區,坪林里,116,1107,1162,2385,23,2408,0,2408,782,3190,75.4859
第15任總統副總統,在臺中市各村(里),臺中市,　太平區,大興里,79,676,1019,1774,20,1794,0,1794,667,2461,72.8972
第15任總統副總統,在臺中市各村(里),臺中市,　太平區,勤益里,70,761,760,1591,10,1601,0,1601,528,2129,75.1996
第15任總統副總統,在臺中市各村(里),臺中市,　太平區,光華里,185,1575,2037,3797,37,3834,0,3834,1244,5078,75.5022
第15任總統副總統,在臺中市各村(里),臺中市,　太平區,光明里,147,1213,1361,2721,31,2752,0,2752,961,3713,74.1180
第15任總統副總統,在臺中市各村(里),臺中市,　太平區,中山里,97,1020,1105,2222,32,2254,0,2254,1290,3544,63.6005
第15任總統副總統,在臺中市各村(里),臺中市,　太平區,豐年里,157,1421,1736,3314,26,3340,0,3340,905,4245,78.6808
第15任總統副總統,在臺中市各村(里),臺中市,　太平區,宜欣里,221,1556,2559,4336,43,4379,0,4379,1549,5928,73.8698
第15任總統副總統,在臺中市各村(里),臺中市,　太平區,宜佳里,224,1697,2357,4278,44,4322,0,4322,1613,5935,72.8222
第15任總統副總統,在臺中市各村(里),臺中市,　太平區,宜昌里,125,977,1577,2679,27,2706,0,2706,995,3701,73.1154
第15任總統副總統,在臺中市各村(里),臺中市,　太平區,新坪里,281,2149,2893,5323,54,5377,0,5377,1948,7325,73.4061
第15任總統副總統,在臺中市各村(里),臺中市,　太平區,新吉里,190,1620,2279,4089,41,4130,0,4130,1393,5523,74.7782
第15任總統副總統,在臺中市各村(里),臺中市,　太平區,新城里,170,1478,2020,3668,46,3714,0,3714,1539,5253,70.7025
第15任總統副總統,在臺中市各村(里),臺中市,　太平區,新光里,285,1924,3222,5431,61,5492,0,5492,1642,7134,76.9835
第15任總統副總統,在臺中市各村(里),臺中市,　太平區,新興里,212,1355,2329,3896,37,3933,0,3933,1074,5007,78.5500
第15任總統副總統,在臺中市各村(里),臺中市,　太平區,新高里,302,1977,3111,5390,43,5433,0,5433,1591,7024,77.3491
第15任總統副總統,在臺中市各村(里),臺中市,　太平區,新福里,241,1832,2692,4765,62,4827,0,4827,1532,6359,75.9082
第15任總統副總統,在臺中市各村(里),臺中市,　太平區,頭汴里,61,494,718,1273,11,1284,0,1284,492,1776,72.2973
第15任總統副總統,在臺中市各村(里),臺中市,　太平區,聖和里,50,403,614,1067,10,1077,0,1077,431,1508,71.4191
第15任總統副總統,在臺中市各村(里),臺中市,　太平區,東汴里,39,284,528,851,13,864,0,864,332,1196,72.2408
第15任總統副總統,在臺中市各村(里),臺中市,　太平區,興隆里,101,910,1245,2256,30,2286,0,2286,861,3147,72.6406
第15任總統副總統,在臺中市各村(里),臺中市,　太平區,福隆里,117,972,1449,2538,34,2572,0,2572,884,3456,74.4213
第15任總統副總統,在臺中市各村(里),臺中市,　太平區,黃竹里,32,192,268,492,8,500,0,500,158,658,75.9878
第15任總統副總統,在臺中市各村(里),臺中市,　太平區,光隆里,119,680,1376,2175,33,2208,0,2208,774,2982,74.0443
第15任總統副總統,在臺中市各村(里),臺中市,　太平區,永隆里,88,614,1061,1763,25,1788,0,1788,619,2407,74.2833
第15任總統副總統,在臺中市各村(里),臺中市,　太平區,德隆里,158,1152,2040,3350,39,3389,0,3389,1257,4646,72.9445
第15任總統副總統,在臺中市各村(里),臺中市,　大里區,東湖里,366,2734,4253,7353,71,7424,0,7424,2538,9962,74.5232
第15任總統副總統,在臺中市各村(里),臺中市,　大里區,西湖里,109,678,1258,2045,27,2072,0,2072,683,2755,75.2087
第15任總統副總統,在臺中市各村(里),臺中市,　大里區,大里里,130,886,1606,2622,39,2661,0,2661,831,3492,76.2027
第15任總統副總統,在臺中市各村(里),臺中市,　大里區,新里里,314,2549,4233,7096,64,7160,1,7161,2663,9824,72.8827
第15任總統副總統,在臺中市各村(里),臺中市,　大里區,國光里,225,1590,2435,4250,64,4314,0,4314,1259,5573,77.4089
第15任總統副總統,在臺中市各村(里),臺中市,　大里區,樹王里,120,794,1748,2662,28,2690,0,2690,728,3418,78.7010
第15任總統副總統,在臺中市各村(里),臺中市,　大里區,祥興里,279,1712,3102,5093,52,5145,0,5145,1713,6858,75.0219
第15任總統副總統,在臺中市各村(里),臺中市,　大里區,內新里,297,2332,3468,6097,71,6168,0,6168,1974,8142,75.7553
第15任總統副總統,在臺中市各村(里),臺中市,　大里區,中新里,225,1423,2197,3845,47,3892,0,3892,1225,5117,76.0602
第15任總統副總統,在臺中市各村(里),臺中市,　大里區,東昇里,125,869,1432,2426,25,2451,0,2451,820,3271,74.9312
第15任總統副總統,在臺中市各村(里),臺中市,　大里區,大元里,170,1038,2009,3217,34,3251,0,3251,836,4087,79.5449
第15任總統副總統,在臺中市各村(里),臺中市,　大里區,夏田里,40,208,498,746,14,760,0,760,219,979,77.6302
第15任總統副總統,在臺中市各村(里),臺中市,　大里區,仁化里,301,1966,3695,5962,67,6029,0,6029,2139,8168,73.8124
第15任總統副總統,在臺中市各村(里),臺中市,　大里區,仁德里,239,1450,2628,4317,42,4359,0,4359,1379,5738,75.9672
第15任總統副總統,在臺中市各村(里),臺中市,　大里區,健民里,155,1138,1910,3203,37,3240,0,3240,1130,4370,74.1419
第15任總統副總統,在臺中市各村(里),臺中市,　大里區,塗城里,336,2062,3687,6085,65,6150,0,6150,2039,8189,75.1007
第15任總統副總統,在臺中市各村(里),臺中市,　大里區,東興里,257,1866,3109,5232,51,5283,0,5283,1561,6844,77.1917
第15任總統副總統,在臺中市各村(里),臺中市,　大里區,大明里,162,1081,1708,2951,36,2987,0,2987,990,3977,75.1069
第15任總統副總統,在臺中市各村(里),臺中市,　大里區,永隆里,423,2711,4156,7290,64,7354,0,7354,1674,9028,81.4577
第15任總統副總統,在臺中市各村(里),臺中市,　大里區,日新里,161,1140,1691,2992,50,3042,0,3042,828,3870,78.6047
第15任總統副總統,在臺中市各村(里),臺中市,　大里區,西榮里,199,1466,2383,4048,48,4096,0,4096,1340,5436,75.3495
第15任總統副總統,在臺中市各村(里),臺中市,　大里區,長榮里,360,2442,3686,6488,61,6549,0,6549,1766,8315,78.7613
第15任總統副總統,在臺中市各村(里),臺中市,　大里區,金城里,370,2439,4010,6819,74,6893,1,6894,2390,9284,74.2460
第15任總統副總統,在臺中市各村(里),臺中市,　大里區,立仁里,182,1262,2274,3718,50,3768,0,3768,1391,5159,73.0374
第15任總統副總統,在臺中市各村(里),臺中市,　大里區,立德里,259,1961,3389,5609,65,5674,0,5674,1746,7420,76.4690
第15任總統副總統,在臺中市各村(里),臺中市,　大里區,新仁里,281,1941,3488,5710,64,5774,0,5774,1740,7514,76.8432
第15任總統副總統,在臺中市各村(里),臺中市,　大里區,瑞城里,456,3044,4882,8382,84,8466,0,8466,2756,11222,75.4411
第15任總統副總統,在臺中市各村(里),臺中市,　和平區,南勢里,42,748,557,1347,19,1366,0,1366,483,1849,73.8778
第15任總統副總統,在臺中市各村(里),臺中市,　和平區,天輪里,11,147,144,302,3,305,0,305,129,434,70.2765
第15任總統副總統,在臺中市各村(里),臺中市,　和平區,博愛里,47,760,353,1160,9,1169,0,1169,437,1606,72.7895
第15任總統副總統,在臺中市各村(里),臺中市,　和平區,自由里,29,589,169,787,7,794,0,794,253,1047,75.8357
第15任總統副總統,在臺中市各村(里),臺中市,　和平區,達觀里,30,520,265,815,11,826,0,826,252,1078,76.6234
第15任總統副總統,在臺中市各村(里),臺中市,　和平區,中坑里,20,195,143,358,6,364,0,364,91,455,80.0000
第15任總統副總統,在臺中市各村(里),臺中市,　和平區,梨山里,31,722,360,1113,9,1122,0,1122,770,1892,59.3023
第15任總統副總統,在臺中市各村(里),臺中市,　和平區,平等里,24,416,126,566,4,570,0,570,269,839,67.9380
第15任總統副總統,在澎湖縣各村(里),澎湖縣,　馬公市,復興里,13,109,179,301,2,303,0,303,204,507,59.7633
第15任總統副總統,在澎湖縣各村(里),澎湖縣,　馬公市,長安里,11,175,171,357,6,363,0,363,178,541,67.0980
第15任總統副總統,在澎湖縣各村(里),澎湖縣,　馬公市,中央里,14,133,178,325,2,327,0,327,196,523,62.5239
第15任總統副總統,在澎湖縣各村(里),澎湖縣,　馬公市,啟明里,32,210,342,584,5,589,0,589,285,874,67.3913
第15任總統副總統,在澎湖縣各村(里),澎湖縣,　馬公市,重慶里,21,249,383,653,14,667,0,667,311,978,68.2004
第15任總統副總統,在澎湖縣各村(里),澎湖縣,　馬公市,中興里,21,222,236,479,5,484,0,484,265,749,64.6195
第15任總統副總統,在澎湖縣各村(里),澎湖縣,　馬公市,光復里,46,500,605,1151,14,1165,0,1165,713,1878,62.0341
第15任總統副總統,在澎湖縣各村(里),澎湖縣,　馬公市,光明里,46,396,334,776,8,784,0,784,514,1298,60.4006
第15任總統副總統,在澎湖縣各村(里),澎湖縣,　馬公市,光榮里,107,1440,1035,2582,28,2610,0,2610,1393,4003,65.2011
第15任總統副總統,在澎湖縣各村(里),澎湖縣,　馬公市,朝陽里,161,1455,1587,3203,40,3243,0,3243,1773,5016,64.6531
第15任總統副總統,在澎湖縣各村(里),澎湖縣,　馬公市,陽明里,62,597,770,1429,24,1453,0,1453,900,2353,61.7510
第15任總統副總統,在澎湖縣各村(里),澎湖縣,　馬公市,重光里,46,385,483,914,14,928,0,928,506,1434,64.7141
第15任總統副總統,在澎湖縣各村(里),澎湖縣,　馬公市,西衛里,186,1364,1996,3546,40,3586,0,3586,1632,5218,68.7236
第15任總統副總統,在澎湖縣各村(里),澎湖縣,　馬公市,西文里,90,833,956,1879,27,1906,0,1906,1092,2998,63.5757
第15任總統副總統,在澎湖縣各村(里),澎湖縣,　馬公市,東文里,111,872,1006,1989,17,2006,0,2006,1087,3093,64.8561
第15任總統副總統,在澎湖縣各村(里),澎湖縣,　馬公市,案山里,52,445,576,1073,11,1084,0,1084,748,1832,59.1703
第15任總統副總統,在澎湖縣各村(里),澎湖縣,　馬公市,光華里,55,212,328,595,10,605,0,605,450,1055,57.3460
第15任總統副總統,在澎湖縣各村(里),澎湖縣,　馬公市,前寮里,35,225,350,610,3,613,0,613,301,914,67.0678
第15任總統副總統,在澎湖縣各村(里),澎湖縣,　馬公市,石泉里,98,789,765,1652,23,1675,0,1675,835,2510,66.7331
第15任總統副總統,在澎湖縣各村(里),澎湖縣,　馬公市,菜園里,17,104,152,273,3,276,0,276,155,431,64.0371
第15任總統副總統,在澎湖縣各村(里),澎湖縣,　馬公市,東衛里,75,612,611,1298,13,1311,0,1311,730,2041,64.2332
第15任總統副總統,在澎湖縣各村(里),澎湖縣,　馬公市,安宅里,16,157,228,401,2,403,0,403,219,622,64.7910
第15任總統副總統,在澎湖縣各村(里),澎湖縣,　馬公市,興仁里,39,286,355,680,8,688,0,688,407,1095,62.8311
第15任總統副總統,在澎湖縣各村(里),澎湖縣,　馬公市,烏崁里,22,187,410,619,9,628,0,628,362,990,63.4343
第15任總統副總統,在澎湖縣各村(里),澎湖縣,　馬公市,鐵線里,23,132,278,433,4,437,0,437,204,641,68.1747
第15任總統副總統,在澎湖縣各村(里),澎湖縣,　馬公市,鎖港里,64,453,926,1443,18,1461,0,1461,971,2432,60.0740
第15任總統副總統,在澎湖縣各村(里),澎湖縣,　馬公市,山水里,71,283,648,1002,13,1015,0,1015,643,1658,61.2183
第15任總統副總統,在澎湖縣各村(里),澎湖縣,　馬公市,五德里,13,78,133,224,5,229,0,229,210,439,52.1640
第15任總統副總統,在澎湖縣各村(里),澎湖縣,　馬公市,井垵里,13,81,134,228,4,232,0,232,135,367,63.2153
第15任總統副總統,在澎湖縣各村(里),澎湖縣,　馬公市,嵵裡里,42,339,276,657,10,667,0,667,481,1148,58.1010
第15任總統副總統,在澎湖縣各村(里),澎湖縣,　馬公市,風櫃里,29,187,521,737,5,742,0,742,601,1343,55.2494
第15任總統副總統,在澎湖縣各村(里),澎湖縣,　馬公市,虎井里,17,114,164,295,2,297,0,297,450,747,39.7590
第15任總統副總統,在澎湖縣各村(里),澎湖縣,　馬公市,桶盤里,16,48,87,151,2,153,0,153,138,291,52.5773
第15任總統副總統,在澎湖縣各村(里),澎湖縣,　湖西鄉,湖西村,30,293,396,719,12,731,0,731,453,1184,61.7399
第15任總統副總統,在澎湖縣各村(里),澎湖縣,　湖西鄉,湖東村,11,74,115,200,2,202,0,202,133,335,60.2985
第15任總統副總統,在澎湖縣各村(里),澎湖縣,　湖西鄉,青螺村,5,48,56,109,1,110,0,110,123,233,47.2103
第15任總統副總統,在澎湖縣各村(里),澎湖縣,　湖西鄉,白坑村,5,75,83,163,1,164,0,164,121,285,57.5439
第15任總統副總統,在澎湖縣各村(里),澎湖縣,　湖西鄉,南寮村,10,94,272,376,2,378,0,378,291,669,56.5022
第15任總統副總統,在澎湖縣各村(里),澎湖縣,　湖西鄉,北寮村,12,72,117,201,5,206,0,206,125,331,62.2356
第15任總統副總統,在澎湖縣各村(里),澎湖縣,　湖西鄉,紅羅村,27,108,306,441,10,451,0,451,288,739,61.0284
第15任總統副總統,在澎湖縣各村(里),澎湖縣,　湖西鄉,西溪村,21,150,217,388,3,391,0,391,335,726,53.8567
第15任總統副總統,在澎湖縣各村(里),澎湖縣,　湖西鄉,成功村,31,166,253,450,6,456,0,456,299,755,60.3974
第15任總統副總統,在澎湖縣各村(里),澎湖縣,　湖西鄉,東石村,8,37,56,101,1,102,0,102,20,122,83.6066
第15任總統副總統,在澎湖縣各村(里),澎湖縣,　湖西鄉,沙港村,10,111,336,457,14,471,0,471,312,783,60.1533
第15任總統副總統,在澎湖縣各村(里),澎湖縣,　湖西鄉,中西村,6,47,61,114,1,115,0,115,90,205,56.0976
第15任總統副總統,在澎湖縣各村(里),澎湖縣,　湖西鄉,鼎灣村,11,121,125,257,6,263,0,263,435,698,37.6791
第15任總統副總統,在澎湖縣各村(里),澎湖縣,　湖西鄉,潭邊村,13,82,114,209,6,215,0,215,69,284,75.7042
第15任總統副總統,在澎湖縣各村(里),澎湖縣,　湖西鄉,許家村,7,105,80,192,4,196,0,196,132,328,59.7561
第15任總統副總統,在澎湖縣各村(里),澎湖縣,　湖西鄉,城北村,17,91,84,192,3,195,0,195,100,295,66.1017
第15任總統副總統,在澎湖縣各村(里),澎湖縣,　湖西鄉,太武村,2,25,31,58,2,60,0,60,33,93,64.5161
第15任總統副總統,在澎湖縣各村(里),澎湖縣,　湖西鄉,隘門村,39,186,280,505,6,511,0,511,328,839,60.9058
第15任總統副總統,在澎湖縣各村(里),澎湖縣,　湖西鄉,林投村,27,177,387,591,8,599,0,599,358,957,62.5914
第15任總統副總統,在澎湖縣各村(里),澎湖縣,　湖西鄉,尖山村,14,98,243,355,8,363,0,363,285,648,56.0185
第15任總統副總統,在澎湖縣各村(里),澎湖縣,　湖西鄉,龍門村,68,371,588,1027,14,1041,0,1041,688,1729,60.2082
第15任總統副總統,在澎湖縣各村(里),澎湖縣,　湖西鄉,菓葉村,20,105,301,426,10,436,0,436,300,736,59.2391
第15任總統副總統,在澎湖縣各村(里),澎湖縣,　白沙鄉,中屯村,14,151,173,338,1,339,0,339,169,508,66.7323
第15任總統副總統,在澎湖縣各村(里),澎湖縣,　白沙鄉,講美村,15,173,187,375,4,379,0,379,261,640,59.2188
第15任總統副總統,在澎湖縣各村(里),澎湖縣,　白沙鄉,城前村,2,30,35,67,1,68,0,68,46,114,59.6491
第15任總統副總統,在澎湖縣各村(里),澎湖縣,　白沙鄉,鎮海村,3,56,30,89,1,90,0,90,67,157,57.3248
第15任總統副總統,在澎湖縣各村(里),澎湖縣,　白沙鄉,港子村,6,74,81,161,3,164,0,164,131,295,55.5932
第15任總統副總統,在澎湖縣各村(里),澎湖縣,　白沙鄉,岐頭村,4,57,49,110,1,111,0,111,105,216,51.3889
第15任總統副總統,在澎湖縣各村(里),澎湖縣,　白沙鄉,小赤村,4,54,47,105,0,105,0,105,63,168,62.5000
第15任總統副總統,在澎湖縣各村(里),澎湖縣,　白沙鄉,赤崁村,45,456,462,963,9,972,0,972,687,1659,58.5895
第15任總統副總統,在澎湖縣各村(里),澎湖縣,　白沙鄉,瓦硐村,5,70,71,146,3,149,0,149,146,295,50.5085
第15任總統副總統,在澎湖縣各村(里),澎湖縣,　白沙鄉,後寮村,20,97,226,343,3,346,0,346,366,712,48.5955
第15任總統副總統,在澎湖縣各村(里),澎湖縣,　白沙鄉,通梁村,16,157,209,382,4,386,0,386,369,755,51.1258
第15任總統副總統,在澎湖縣各村(里),澎湖縣,　白沙鄉,吉貝村,20,114,429,563,5,568,0,568,814,1382,41.0999
第15任總統副總統,在澎湖縣各村(里),澎湖縣,　白沙鄉,鳥嶼村,10,289,125,424,3,427,0,427,634,1061,40.2451
第15任總統副總統,在澎湖縣各村(里),澎湖縣,　白沙鄉,員貝村,3,90,24,117,0,117,0,117,123,240,48.7500
第15任總統副總統,在澎湖縣各村(里),澎湖縣,　白沙鄉,大倉村,2,28,93,123,0,123,0,123,127,250,49.2000
第15任總統副總統,在澎湖縣各村(里),澎湖縣,　西嶼鄉,橫礁村,12,65,86,163,2,165,0,165,117,282,58.5106
第15任總統副總統,在澎湖縣各村(里),澎湖縣,　西嶼鄉,合界村,16,63,140,219,4,223,0,223,178,401,55.6110
第15任總統副總統,在澎湖縣各村(里),澎湖縣,　西嶼鄉,竹灣村,15,127,274,416,5,421,0,421,384,805,52.2981
第15任總統副總統,在澎湖縣各村(里),澎湖縣,　西嶼鄉,小門村,7,114,29,150,2,152,0,152,129,281,54.0925
第15任總統副總統,在澎湖縣各村(里),澎湖縣,　西嶼鄉,大池村,17,118,207,342,3,345,0,345,288,633,54.5024
第15任總統副總統,在澎湖縣各村(里),澎湖縣,　西嶼鄉,二崁村,2,23,49,74,2,76,0,76,73,149,51.0067
第15任總統副總統,在澎湖縣各村(里),澎湖縣,　西嶼鄉,池東村,15,148,168,331,7,338,0,338,306,644,52.4845
第15任總統副總統,在澎湖縣各村(里),澎湖縣,　西嶼鄉,池西村,4,32,65,101,5,106,0,106,110,216,49.0741
第15任總統副總統,在澎湖縣各村(里),澎湖縣,　西嶼鄉,赤馬村,13,71,191,275,9,284,0,284,279,563,50.4440
第15任總統副總統,在澎湖縣各村(里),澎湖縣,　西嶼鄉,內垵村,29,165,442,636,8,644,0,644,571,1215,53.0041
第15任總統副總統,在澎湖縣各村(里),澎湖縣,　西嶼鄉,外垵村,47,629,389,1065,8,1073,0,1073,920,1993,53.8384
第15任總統副總統,在澎湖縣各村(里),澎湖縣,　望安鄉,東安村,14,131,166,311,2,313,0,313,379,692,45.2312
第15任總統副總統,在澎湖縣各村(里),澎湖縣,　望安鄉,西安村,10,78,79,167,0,167,0,167,256,423,39.4799
第15任總統副總統,在澎湖縣各村(里),澎湖縣,　望安鄉,中社村,7,41,58,106,1,107,0,107,192,299,35.7860
第15任總統副總統,在澎湖縣各村(里),澎湖縣,　望安鄉,水垵村,4,60,95,159,1,160,0,160,306,466,34.3348
第15任總統副總統,在澎湖縣各村(里),澎湖縣,　望安鄉,將軍村,19,118,324,461,5,466,0,466,938,1404,33.1909
第15任總統副總統,在澎湖縣各村(里),澎湖縣,　望安鄉,東吉村,2,21,33,56,0,56,0,56,218,274,20.4380
第15任總統副總統,在澎湖縣各村(里),澎湖縣,　望安鄉,東坪村,10,26,100,136,0,136,0,136,329,465,29.2473
第15任總統副總統,在澎湖縣各村(里),澎湖縣,　望安鄉,西坪村,4,9,28,41,0,41,0,41,176,217,18.8940
第15任總統副總統,在澎湖縣各村(里),澎湖縣,　望安鄉,花嶼村,19,58,45,122,1,123,0,123,187,310,39.6774
第15任總統副總統,在澎湖縣各村(里),澎湖縣,　七美鄉,東湖村,9,32,39,80,1,81,0,81,166,247,32.7935
第15任總統副總統,在澎湖縣各村(里),澎湖縣,　七美鄉,西湖村,16,120,67,203,8,211,0,211,355,566,37.2792
第15任總統副總統,在澎湖縣各村(里),澎湖縣,　七美鄉,中和村,15,112,98,225,7,232,0,232,388,620,37.4194
第15任總統副總統,在澎湖縣各村(里),澎湖縣,　七美鄉,平和村,12,61,81,154,2,156,0,156,203,359,43.4540
第15任總統副總統,在澎湖縣各村(里),澎湖縣,　七美鄉,海豐村,3,63,50,116,2,118,0,118,231,349,33.8109
第15任總統副總統,在澎湖縣各村(里),澎湖縣,　七美鄉,南港村,35,222,162,419,5,424,0,424,690,1114,38.0610
第15任總統副總統,在雲林縣各村(里),雲林縣,　斗六市,信義里,16,181,289,486,6,492,0,492,134,626,78.5942
第15任總統副總統,在雲林縣各村(里),雲林縣,　斗六市,四維里,12,177,274,463,6,469,0,469,131,600,78.1667
第15任總統副總統,在雲林縣各村(里),雲林縣,　斗六市,太平里,31,225,322,578,6,584,0,584,165,749,77.9706
第15任總統副總統,在雲林縣各村(里),雲林縣,　斗六市,中和里,18,211,376,605,10,615,0,615,157,772,79.6632
第15任總統副總統,在雲林縣各村(里),雲林縣,　斗六市,光興里,25,192,315,532,4,536,0,536,202,738,72.6287
第15任總統副總統,在雲林縣各村(里),雲林縣,　斗六市,鎮西里,134,1080,1402,2616,33,2649,0,2649,943,3592,73.7472
第15任總統副總統,在雲林縣各村(里),雲林縣,　斗六市,鎮東里,86,795,885,1766,14,1780,0,1780,473,2253,79.0058
第15任總統副總統,在雲林縣各村(里),雲林縣,　斗六市,文化里,66,717,896,1679,27,1706,0,1706,511,2217,76.9508
第15任總統副總統,在雲林縣各村(里),雲林縣,　斗六市,三平里,160,1491,1785,3436,44,3480,0,3480,1064,4544,76.5845
第15任總統副總統,在雲林縣各村(里),雲林縣,　斗六市,明德里,127,995,1454,2576,31,2607,0,2607,791,3398,76.7216
第15任總統副總統,在雲林縣各村(里),雲林縣,　斗六市,鎮北里,98,892,1097,2087,25,2112,0,2112,543,2655,79.5480
第15任總統副總統,在雲林縣各村(里),雲林縣,　斗六市,公誠里,97,672,833,1602,19,1621,0,1621,463,2084,77.7831
第15任總統副總統,在雲林縣各村(里),雲林縣,　斗六市,忠孝里,29,418,634,1081,13,1094,0,1094,295,1389,78.7617
第15任總統副總統,在雲林縣各村(里),雲林縣,　斗六市,仁愛里,29,331,493,853,15,868,0,868,208,1076,80.6691
第15任總統副總統,在雲林縣各村(里),雲林縣,　斗六市,八德里,104,858,1302,2264,42,2306,0,2306,753,3059,75.3841
第15任總統副總統,在雲林縣各村(里),雲林縣,　斗六市,公正里,86,893,1111,2090,23,2113,1,2114,606,2720,77.6838
第15任總統副總統,在雲林縣各村(里),雲林縣,　斗六市,重光里,71,572,1000,1643,22,1665,0,1665,610,2275,73.1868
第15任總統副總統,在雲林縣各村(里),雲林縣,　斗六市,林頭里,139,1272,1639,3050,35,3085,0,3085,937,4022,76.7031
第15任總統副總統,在雲林縣各村(里),雲林縣,　斗六市,成功里,76,786,1122,1984,22,2006,0,2006,501,2507,80.0160
第15任總統副總統,在雲林縣各村(里),雲林縣,　斗六市,鎮南里,107,1139,1287,2533,37,2570,1,2571,806,3377,76.1031
第15任總統副總統,在雲林縣各村(里),雲林縣,　斗六市,社口里,78,704,910,1692,18,1710,0,1710,506,2216,77.1661
第15任總統副總統,在雲林縣各村(里),雲林縣,　斗六市,龍潭里,51,497,769,1317,25,1342,0,1342,348,1690,79.4083
第15任總統副總統,在雲林縣各村(里),雲林縣,　斗六市,嘉東里,47,409,598,1054,13,1067,0,1067,329,1396,76.4327
第15任總統副總統,在雲林縣各村(里),雲林縣,　斗六市,崙峯里,60,869,877,1806,17,1823,0,1823,529,2352,77.5085
第15任總統副總統,在雲林縣各村(里),雲林縣,　斗六市,溝垻里,24,204,260,488,6,494,0,494,138,632,78.1646
第15任總統副總統,在雲林縣各村(里),雲林縣,　斗六市,江厝里,60,570,908,1538,21,1559,0,1559,549,2108,73.9564
第15任總統副總統,在雲林縣各村(里),雲林縣,　斗六市,三光里,8,148,265,421,2,423,0,423,122,545,77.6147
第15任總統副總統,在雲林縣各村(里),雲林縣,　斗六市,久安里,74,725,977,1776,13,1789,0,1789,527,2316,77.2453
第15任總統副總統,在雲林縣各村(里),雲林縣,　斗六市,虎溪里,166,1557,2207,3930,42,3972,0,3972,1294,5266,75.4273
第15任總統副總統,在雲林縣各村(里),雲林縣,　斗六市,保庄里,157,1571,2342,4070,50,4120,0,4120,1066,5186,79.4447
第15任總統副總統,在雲林縣各村(里),雲林縣,　斗六市,長平里,53,466,812,1331,20,1351,0,1351,381,1732,78.0023
第15任總統副總統,在雲林縣各村(里),雲林縣,　斗六市,榴中里,149,1053,1963,3165,42,3207,0,3207,1077,4284,74.8599
第15任總統副總統,在雲林縣各村(里),雲林縣,　斗六市,榴北里,32,233,502,767,9,776,0,776,277,1053,73.6942
第15任總統副總統,在雲林縣各村(里),雲林縣,　斗六市,榴南里,64,510,875,1449,14,1463,0,1463,458,1921,76.1583
第15任總統副總統,在雲林縣各村(里),雲林縣,　斗六市,梅林里,58,490,790,1338,22,1360,0,1360,426,1786,76.1478
第15任總統副總統,在雲林縣各村(里),雲林縣,　斗六市,湖山里,35,286,498,819,12,831,0,831,262,1093,76.0293
第15任總統副總統,在雲林縣各村(里),雲林縣,　斗六市,長安里,114,715,1360,2189,17,2206,0,2206,659,2865,76.9983
第15任總統副總統,在雲林縣各村(里),雲林縣,　斗六市,溪洲里,118,814,1299,2231,31,2262,0,2262,800,3062,73.8733
第15任總統副總統,在雲林縣各村(里),雲林縣,　斗六市,十三里,31,253,533,817,7,824,0,824,262,1086,75.8748
第15任總統副總統,在雲林縣各村(里),雲林縣,　斗南鎮,東仁里,37,316,518,871,8,879,0,879,252,1131,77.7188
第15任總統副總統,在雲林縣各村(里),雲林縣,　斗南鎮,西岐里,52,639,876,1567,17,1584,0,1584,469,2053,77.1554
第15任總統副總統,在雲林縣各村(里),雲林縣,　斗南鎮,大同里,91,789,1153,2033,26,2059,0,2059,667,2726,75.5319
第15任總統副總統,在雲林縣各村(里),雲林縣,　斗南鎮,南昌里,62,575,954,1591,20,1611,0,1611,541,2152,74.8606
第15任總統副總統,在雲林縣各村(里),雲林縣,　斗南鎮,北銘里,58,437,610,1105,9,1114,0,1114,328,1442,77.2538
第15任總統副總統,在雲林縣各村(里),雲林縣,　斗南鎮,中天里,36,343,575,954,14,968,0,968,255,1223,79.1496
第15任總統副總統,在雲林縣各村(里),雲林縣,　斗南鎮,林子里,37,297,612,946,9,955,0,955,322,1277,74.7847
第15任總統副總統,在雲林縣各村(里),雲林縣,　斗南鎮,石龜里,29,184,361,574,7,581,0,581,166,747,77.7778
第15任總統副總統,在雲林縣各村(里),雲林縣,　斗南鎮,石溪里,9,202,417,628,5,633,0,633,215,848,74.6462
第15任總統副總統,在雲林縣各村(里),雲林縣,　斗南鎮,靖興里,15,223,384,622,8,630,0,630,248,878,71.7540
第15任總統副總統,在雲林縣各村(里),雲林縣,　斗南鎮,新南里,21,158,294,473,8,481,0,481,186,667,72.1139
第15任總統副總統,在雲林縣各村(里),雲林縣,　斗南鎮,阿丹里,21,256,521,798,10,808,0,808,275,1083,74.6076
第15任總統副總統,在雲林縣各村(里),雲林縣,　斗南鎮,將軍里,50,407,752,1209,17,1226,0,1226,437,1663,73.7222
第15任總統副總統,在雲林縣各村(里),雲林縣,　斗南鎮,舊社里,97,650,1171,1918,14,1932,0,1932,649,2581,74.8547
第15任總統副總統,在雲林縣各村(里),雲林縣,　斗南鎮,明昌里,93,862,1416,2371,29,2400,0,2400,794,3194,75.1409
第15任總統副總統,在雲林縣各村(里),雲林縣,　斗南鎮,僑真里,72,547,966,1585,18,1603,0,1603,535,2138,74.9766
第15任總統副總統,在雲林縣各村(里),雲林縣,　斗南鎮,大東里,19,208,417,644,6,650,0,650,213,863,75.3187
第15任總統副總統,在雲林縣各村(里),雲林縣,　斗南鎮,埤麻里,25,250,304,579,8,587,0,587,204,791,74.2099
第15任總統副總統,在雲林縣各村(里),雲林縣,　斗南鎮,西伯里,16,240,326,582,10,592,0,592,239,831,71.2395
第15任總統副總統,在雲林縣各村(里),雲林縣,　斗南鎮,新崙里,36,365,664,1065,22,1087,0,1087,377,1464,74.2486
第15任總統副總統,在雲林縣各村(里),雲林縣,　斗南鎮,東明里,27,235,448,710,7,717,0,717,226,943,76.0339
第15任總統副總統,在雲林縣各村(里),雲林縣,　斗南鎮,新光里,74,619,1267,1960,23,1983,0,1983,625,2608,76.0353
第15任總統副總統,在雲林縣各村(里),雲林縣,　斗南鎮,田頭里,36,532,1020,1588,26,1614,0,1614,527,2141,75.3853
第15任總統副總統,在雲林縣各村(里),雲林縣,　斗南鎮,小東里,35,261,776,1072,12,1084,0,1084,376,1460,74.2466
第15任總統副總統,在雲林縣各村(里),雲林縣,　虎尾鎮,東仁里,68,823,1012,1903,18,1921,0,1921,578,2499,76.8707
第15任總統副總統,在雲林縣各村(里),雲林縣,　虎尾鎮,新興里,62,450,610,1122,12,1134,0,1134,503,1637,69.2731
第15任總統副總統,在雲林縣各村(里),雲林縣,　虎尾鎮,公安里,117,867,1117,2101,17,2118,0,2118,614,2732,77.5256
第15任總統副總統,在雲林縣各村(里),雲林縣,　虎尾鎮,德興里,95,755,925,1775,18,1793,0,1793,633,2426,73.9077
第15任總統副總統,在雲林縣各村(里),雲林縣,　虎尾鎮,中山里,32,284,363,679,4,683,0,683,212,895,76.3128
第15任總統副總統,在雲林縣各村(里),雲林縣,　虎尾鎮,西安里,102,987,1222,2311,21,2332,0,2332,808,3140,74.2675
第15任總統副總統,在雲林縣各村(里),雲林縣,　虎尾鎮,立仁里,113,1171,1355,2639,28,2667,0,2667,913,3580,74.4972
第15任總統副總統,在雲林縣各村(里),雲林縣,　虎尾鎮,安慶里,53,471,521,1045,4,1049,0,1049,323,1372,76.4577
第15任總統副總統,在雲林縣各村(里),雲林縣,　虎尾鎮,平和里,162,1307,1762,3231,36,3267,0,3267,943,4210,77.6010
第15任總統副總統,在雲林縣各村(里),雲林縣,　虎尾鎮,興南里,79,660,897,1636,22,1658,0,1658,528,2186,75.8463
第15任總統副總統,在雲林縣各村(里),雲林縣,　虎尾鎮,新吉里,121,1004,1578,2703,37,2740,0,2740,880,3620,75.6906
第15任總統副總統,在雲林縣各村(里),雲林縣,　虎尾鎮,穎川里,58,550,839,1447,17,1464,0,1464,465,1929,75.8942
第15任總統副總統,在雲林縣各村(里),雲林縣,　虎尾鎮,延平里,31,301,491,823,8,831,0,831,255,1086,76.5193
第15任總統副總統,在雲林縣各村(里),雲林縣,　虎尾鎮,建國里,22,144,161,327,6,333,0,333,170,503,66.2028
第15任總統副總統,在雲林縣各村(里),雲林縣,　虎尾鎮,埒內里,79,560,1292,1931,22,1953,0,1953,606,2559,76.3189
第15任總統副總統,在雲林縣各村(里),雲林縣,　虎尾鎮,堀頭里,27,205,355,587,11,598,0,598,196,794,75.3149
第15任總統副總統,在雲林縣各村(里),雲林縣,　虎尾鎮,安溪里,60,406,805,1271,21,1292,0,1292,428,1720,75.1163
第15任總統副總統,在雲林縣各村(里),雲林縣,　虎尾鎮,興中里,44,450,642,1136,12,1148,0,1148,446,1594,72.0201
第15任總統副總統,在雲林縣各村(里),雲林縣,　虎尾鎮,廉使里,78,705,1520,2303,31,2334,0,2334,835,3169,73.6510
第15任總統副總統,在雲林縣各村(里),雲林縣,　虎尾鎮,惠來里,75,565,994,1634,22,1656,0,1656,617,2273,72.8553
第15任總統副總統,在雲林縣各村(里),雲林縣,　虎尾鎮,頂溪里,74,573,1211,1858,24,1882,0,1882,632,2514,74.8608
第15任總統副總統,在雲林縣各村(里),雲林縣,　虎尾鎮,中溪里,38,339,571,948,13,961,0,961,344,1305,73.6398
第15任總統副總統,在雲林縣各村(里),雲林縣,　虎尾鎮,下溪里,55,426,614,1095,16,1111,0,1111,361,1472,75.4755
第15任總統副總統,在雲林縣各村(里),雲林縣,　虎尾鎮,東屯里,32,296,501,829,18,847,0,847,339,1186,71.4165
第15任總統副總統,在雲林縣各村(里),雲林縣,　虎尾鎮,西屯里,32,353,589,974,12,986,0,986,436,1422,69.3390
第15任總統副總統,在雲林縣各村(里),雲林縣,　虎尾鎮,芳草里,29,133,412,574,8,582,0,582,259,841,69.2033
第15任總統副總統,在雲林縣各村(里),雲林縣,　虎尾鎮,墾地里,62,340,713,1115,19,1134,0,1134,539,1673,67.7824
第15任總統副總統,在雲林縣各村(里),雲林縣,　虎尾鎮,北溪里,27,227,362,616,8,624,0,624,205,829,75.2714
第15任總統副總統,在雲林縣各村(里),雲林縣,　虎尾鎮,三合里,50,355,502,907,12,919,0,919,328,1247,73.6969
第15任總統副總統,在雲林縣各村(里),雲林縣,　西螺鎮,振興里,40,277,770,1087,8,1095,0,1095,427,1522,71.9448
第15任總統副總統,在雲林縣各村(里),雲林縣,　西螺鎮,大園里,25,396,834,1255,11,1266,1,1267,399,1666,75.9904
第15任總統副總統,在雲林縣各村(里),雲林縣,　西螺鎮,廣福里,42,572,922,1536,15,1551,0,1551,466,2017,76.8964
第15任總統副總統,在雲林縣各村(里),雲林縣,　西螺鎮,正興里,64,738,1301,2103,17,2120,0,2120,754,2874,73.7648
第15任總統副總統,在雲林縣各村(里),雲林縣,　西螺鎮,永安里,7,85,166,258,2,260,0,260,67,327,79.5107
第15任總統副總統,在雲林縣各村(里),雲林縣,　西螺鎮,中和里,11,138,260,409,5,414,0,414,157,571,72.5044
第15任總統副總統,在雲林縣各村(里),雲林縣,　西螺鎮,福興里,16,156,257,429,5,434,0,434,113,547,79.3419
第15任總統副總統,在雲林縣各村(里),雲林縣,　西螺鎮,光華里,21,269,449,739,8,747,0,747,252,999,74.7748
第15任總統副總統,在雲林縣各村(里),雲林縣,　西螺鎮,中興里,75,666,1248,1989,17,2006,0,2006,695,2701,74.2688
第15任總統副總統,在雲林縣各村(里),雲林縣,　西螺鎮,漢光里,100,978,2016,3094,39,3133,0,3133,1126,4259,73.5619
第15任總統副總統,在雲林縣各村(里),雲林縣,　西螺鎮,新安里,33,198,708,939,7,946,0,946,303,1249,75.7406
第15任總統副總統,在雲林縣各村(里),雲林縣,　西螺鎮,新豐里,31,249,769,1049,12,1061,0,1061,386,1447,73.3241
第15任總統副總統,在雲林縣各村(里),雲林縣,　西螺鎮,大新里,46,322,758,1126,12,1138,0,1138,401,1539,73.9441
第15任總統副總統,在雲林縣各村(里),雲林縣,　西螺鎮,埤頭里,20,127,456,603,8,611,0,611,221,832,73.4375
第15任總統副總統,在雲林縣各村(里),雲林縣,　西螺鎮,東興里,20,131,549,700,6,706,0,706,240,946,74.6300
第15任總統副總統,在雲林縣各村(里),雲林縣,　西螺鎮,鹿場里,19,299,752,1070,7,1077,0,1077,389,1466,73.4652
第15任總統副總統,在雲林縣各村(里),雲林縣,　西螺鎮,廣興里,14,248,340,602,10,612,0,612,226,838,73.0310
第15任總統副總統,在雲林縣各村(里),雲林縣,　西螺鎮,頂湳里,13,187,518,718,9,727,0,727,223,950,76.5263
第15任總統副總統,在雲林縣各村(里),雲林縣,　西螺鎮,吳厝里,19,258,584,861,13,874,0,874,382,1256,69.5860
第15任總統副總統,在雲林縣各村(里),雲林縣,　西螺鎮,九隆里,19,130,359,508,5,513,0,513,178,691,74.2402
第15任總統副總統,在雲林縣各村(里),雲林縣,　西螺鎮,下湳里,21,259,271,551,8,559,0,559,223,782,71.4834
第15任總統副總統,在雲林縣各村(里),雲林縣,　西螺鎮,七座里,20,161,423,604,8,612,0,612,253,865,70.7514
第15任總統副總統,在雲林縣各村(里),雲林縣,　西螺鎮,公舘里,26,229,695,950,13,963,0,963,349,1312,73.3994
第15任總統副總統,在雲林縣各村(里),雲林縣,　西螺鎮,詔安里,24,261,424,709,15,724,0,724,243,967,74.8707
第15任總統副總統,在雲林縣各村(里),雲林縣,　西螺鎮,河南里,28,263,469,760,7,767,0,767,228,995,77.0854
第15任總統副總統,在雲林縣各村(里),雲林縣,　西螺鎮,安定里,27,371,823,1221,15,1236,0,1236,499,1735,71.2392
第15任總統副總統,在雲林縣各村(里),雲林縣,　西螺鎮,福田里,25,285,785,1095,17,1112,0,1112,344,1456,76.3736
第15任總統副總統,在雲林縣各村(里),雲林縣,　土庫鎮,忠正里,22,220,337,579,7,586,0,586,162,748,78.3422
第15任總統副總統,在雲林縣各村(里),雲林縣,　土庫鎮,順天里,29,243,371,643,9,652,0,652,209,861,75.7259
第15任總統副總統,在雲林縣各村(里),雲林縣,　土庫鎮,宮北里,44,364,608,1016,28,1044,0,1044,294,1338,78.0269
第15任總統副總統,在雲林縣各村(里),雲林縣,　土庫鎮,越港里,22,349,426,797,10,807,0,807,211,1018,79.2731
第15任總統副總統,在雲林縣各村(里),雲林縣,　土庫鎮,溪邊里,32,281,485,798,14,812,0,812,260,1072,75.7463
第15任總統副總統,在雲林縣各村(里),雲林縣,　土庫鎮,石廟里,98,667,1192,1957,28,1985,0,1985,700,2685,73.9292
第15任總統副總統,在雲林縣各村(里),雲林縣,　土庫鎮,興新里,47,328,614,989,10,999,0,999,371,1370,72.9197
第15任總統副總統,在雲林縣各村(里),雲林縣,　土庫鎮,奮起里,31,306,529,866,11,877,0,877,386,1263,69.4378
第15任總統副總統,在雲林縣各村(里),雲林縣,　土庫鎮,埤腳里,27,293,517,837,7,844,0,844,382,1226,68.8418
第15任總統副總統,在雲林縣各村(里),雲林縣,　土庫鎮,後埔里,74,484,942,1500,22,1522,0,1522,676,2198,69.2448
第15任總統副總統,在雲林縣各村(里),雲林縣,　土庫鎮,崙內里,34,305,700,1039,13,1052,0,1052,426,1478,71.1773
第15任總統副總統,在雲林縣各村(里),雲林縣,　土庫鎮,大荖里,26,182,388,596,9,605,0,605,215,820,73.7805
第15任總統副總統,在雲林縣各村(里),雲林縣,　土庫鎮,東平里,52,330,912,1294,21,1315,0,1315,473,1788,73.5459
第15任總統副總統,在雲林縣各村(里),雲林縣,　土庫鎮,南平里,42,387,833,1262,18,1280,0,1280,461,1741,73.5210
第15任總統副總統,在雲林縣各村(里),雲林縣,　土庫鎮,西平里,32,371,834,1237,19,1256,0,1256,505,1761,71.3231
第15任總統副總統,在雲林縣各村(里),雲林縣,　土庫鎮,北平里,28,158,409,595,8,603,0,603,247,850,70.9412
第15任總統副總統,在雲林縣各村(里),雲林縣,　土庫鎮,新庄里,33,304,647,984,10,994,0,994,402,1396,71.2034
第15任總統副總統,在雲林縣各村(里),雲林縣,　北港鎮,東陽里,18,155,345,518,8,526,0,526,169,695,75.6835
第15任總統副總統,在雲林縣各村(里),雲林縣,　北港鎮,光民里,16,131,360,507,9,516,0,516,138,654,78.8991
第15任總統副總統,在雲林縣各村(里),雲林縣,　北港鎮,東華里,8,118,207,333,1,334,0,334,111,445,75.0562
第15任總統副總統,在雲林縣各村(里),雲林縣,　北港鎮,南安里,16,184,427,627,13,640,0,640,187,827,77.3881
第15任總統副總統,在雲林縣各村(里),雲林縣,　北港鎮,中和里,6,62,164,232,3,235,0,235,95,330,71.2121
第15任總統副總統,在雲林縣各村(里),雲林縣,　北港鎮,義民里,8,93,173,274,5,279,0,279,96,375,74.4000
第15任總統副總統,在雲林縣各村(里),雲林縣,　北港鎮,共榮里,13,72,192,277,1,278,0,278,80,358,77.6536
第15任總統副總統,在雲林縣各村(里),雲林縣,　北港鎮,西勢里,25,218,425,668,8,676,0,676,229,905,74.6961
第15任總統副總統,在雲林縣各村(里),雲林縣,　北港鎮,仁和里,14,117,231,362,3,365,0,365,111,476,76.6807
第15任總統副總統,在雲林縣各村(里),雲林縣,　北港鎮,賜福里,13,77,146,236,5,241,0,241,68,309,77.9935
第15任總統副總統,在雲林縣各村(里),雲林縣,　北港鎮,公舘里,14,120,262,396,2,398,0,398,124,522,76.2452
第15任總統副總統,在雲林縣各村(里),雲林縣,　北港鎮,大同里,28,292,516,836,10,846,0,846,298,1144,73.9510
第15任總統副總統,在雲林縣各村(里),雲林縣,　北港鎮,仁安里,16,140,163,319,5,324,0,324,103,427,75.8782
第15任總統副總統,在雲林縣各村(里),雲林縣,　北港鎮,華勝里,125,1196,2228,3549,45,3594,0,3594,1106,4700,76.4681
第15任總統副總統,在雲林縣各村(里),雲林縣,　北港鎮,光復里,52,498,685,1235,12,1247,0,1247,393,1640,76.0366
第15任總統副總統,在雲林縣各村(里),雲林縣,　北港鎮,扶朝里,20,103,549,672,10,682,0,682,245,927,73.5707
第15任總統副總統,在雲林縣各村(里),雲林縣,　北港鎮,水埔里,13,81,243,337,3,340,0,340,139,479,70.9812
第15任總統副總統,在雲林縣各村(里),雲林縣,　北港鎮,新街里,172,1545,2773,4490,49,4539,0,4539,1479,6018,75.4237
第15任總統副總統,在雲林縣各村(里),雲林縣,　北港鎮,劉厝里,37,195,585,817,5,822,0,822,290,1112,73.9209
第15任總統副總統,在雲林縣各村(里),雲林縣,　北港鎮,後溝里,26,150,475,651,10,661,0,661,272,933,70.8467
第15任總統副總統,在雲林縣各村(里),雲林縣,　北港鎮,新厝里,7,64,188,259,2,261,0,261,106,367,71.1172
第15任總統副總統,在雲林縣各村(里),雲林縣,　北港鎮,府番里,9,187,327,523,8,531,0,531,249,780,68.0769
第15任總統副總統,在雲林縣各村(里),雲林縣,　北港鎮,草湖里,36,185,665,886,12,898,0,898,435,1333,67.3668
第15任總統副總統,在雲林縣各村(里),雲林縣,　北港鎮,溝皂里,25,192,533,750,15,765,0,765,343,1108,69.0433
第15任總統副總統,在雲林縣各村(里),雲林縣,　北港鎮,番溝里,11,146,311,468,8,476,0,476,303,779,61.1040
第15任總統副總統,在雲林縣各村(里),雲林縣,　北港鎮,大北里,11,84,259,354,4,358,0,358,179,537,66.6667
第15任總統副總統,在雲林縣各村(里),雲林縣,　北港鎮,好收里,45,285,772,1102,14,1116,0,1116,460,1576,70.8122
第15任總統副總統,在雲林縣各村(里),雲林縣,　北港鎮,樹腳里,71,597,1452,2120,30,2150,0,2150,734,2884,74.5492
第15任總統副總統,在雲林縣各村(里),雲林縣,　古坑鄉,棋盤村,51,403,1008,1462,20,1482,0,1482,565,2047,72.3986
第15任總統副總統,在雲林縣各村(里),雲林縣,　古坑鄉,新庄村,33,324,730,1087,18,1105,0,1105,362,1467,75.3238
第15任總統副總統,在雲林縣各村(里),雲林縣,　古坑鄉,東和村,92,776,1338,2206,18,2224,0,2224,793,3017,73.7156
第15任總統副總統,在雲林縣各村(里),雲林縣,　古坑鄉,荷苞村,40,402,573,1015,9,1024,0,1024,361,1385,73.9350
第15任總統副總統,在雲林縣各村(里),雲林縣,　古坑鄉,高林村,22,262,543,827,14,841,0,841,281,1122,74.9554
第15任總統副總統,在雲林縣各村(里),雲林縣,　古坑鄉,水碓村,21,314,523,858,15,873,0,873,318,1191,73.2997
第15任總統副總統,在雲林縣各村(里),雲林縣,　古坑鄉,田心村,37,290,467,794,12,806,0,806,258,1064,75.7519
第15任總統副總統,在雲林縣各村(里),雲林縣,　古坑鄉,古坑村,57,591,875,1523,27,1550,0,1550,636,2186,70.9058
第15任總統副總統,在雲林縣各村(里),雲林縣,　古坑鄉,朝陽村,56,634,835,1525,18,1543,0,1543,514,2057,75.0122
第15任總統副總統,在雲林縣各村(里),雲林縣,　古坑鄉,西平村,25,406,664,1095,14,1109,0,1109,332,1441,76.9604
第15任總統副總統,在雲林縣各村(里),雲林縣,　古坑鄉,湳仔村,19,198,274,491,5,496,0,496,154,650,76.3077
第15任總統副總統,在雲林縣各村(里),雲林縣,　古坑鄉,永光村,40,569,900,1509,17,1526,0,1526,550,2076,73.5067
第15任總統副總統,在雲林縣各村(里),雲林縣,　古坑鄉,永昌村,51,536,843,1430,24,1454,0,1454,563,2017,72.0873
第15任總統副總統,在雲林縣各村(里),雲林縣,　古坑鄉,麻園村,11,161,379,551,4,555,0,555,170,725,76.5517
第15任總統副總統,在雲林縣各村(里),雲林縣,　古坑鄉,崁腳村,31,322,464,817,10,827,0,827,334,1161,71.2317
第15任總統副總統,在雲林縣各村(里),雲林縣,　古坑鄉,華南村,14,54,125,193,2,195,0,195,93,288,67.7083
第15任總統副總統,在雲林縣各村(里),雲林縣,　古坑鄉,華山村,18,197,295,510,4,514,0,514,200,714,71.9888
第15任總統副總統,在雲林縣各村(里),雲林縣,　古坑鄉,桂林村,22,216,529,767,4,771,0,771,330,1101,70.0272
第15任總統副總統,在雲林縣各村(里),雲林縣,　古坑鄉,樟湖村,7,121,159,287,4,291,0,291,140,431,67.5174
第15任總統副總統,在雲林縣各村(里),雲林縣,　古坑鄉,草嶺村,13,139,209,361,8,369,0,369,185,554,66.6065
第15任總統副總統,在雲林縣各村(里),雲林縣,　大埤鄉,北和村,19,179,307,505,6,511,0,511,218,729,70.0960
第15任總統副總統,在雲林縣各村(里),雲林縣,　大埤鄉,吉田村,22,128,366,516,3,519,0,519,177,696,74.5690
第15任總統副總統,在雲林縣各村(里),雲林縣,　大埤鄉,豐岡村,9,163,264,436,4,440,0,440,134,574,76.6551
第15任總統副總統,在雲林縣各村(里),雲林縣,　大埤鄉,聯美村,19,210,471,700,4,704,0,704,335,1039,67.7575
第15任總統副總統,在雲林縣各村(里),雲林縣,　大埤鄉,南和村,49,504,988,1541,17,1558,0,1558,485,2043,76.2604
第15任總統副總統,在雲林縣各村(里),雲林縣,　大埤鄉,大德村,26,234,413,673,6,679,0,679,274,953,71.2487
第15任總統副總統,在雲林縣各村(里),雲林縣,　大埤鄉,松竹村,24,178,454,656,8,664,0,664,248,912,72.8070
第15任總統副總統,在雲林縣各村(里),雲林縣,　大埤鄉,豐田村,38,371,688,1097,16,1113,0,1113,389,1502,74.1012
第15任總統副總統,在雲林縣各村(里),雲林縣,　大埤鄉,尚義村,51,424,849,1324,14,1338,0,1338,508,1846,72.4810
第15任總統副總統,在雲林縣各村(里),雲林縣,　大埤鄉,嘉興村,43,404,797,1244,16,1260,0,1260,467,1727,72.9589
第15任總統副總統,在雲林縣各村(里),雲林縣,　大埤鄉,三結村,43,251,536,830,11,841,0,841,344,1185,70.9705
第15任總統副總統,在雲林縣各村(里),雲林縣,　大埤鄉,怡然村,22,173,315,510,5,515,0,515,194,709,72.6375
第15任總統副總統,在雲林縣各村(里),雲林縣,　大埤鄉,北鎮村,19,126,308,453,1,454,0,454,189,643,70.6065
第15任總統副總統,在雲林縣各村(里),雲林縣,　大埤鄉,興安村,16,132,320,468,5,473,0,473,215,688,68.7500
第15任總統副總統,在雲林縣各村(里),雲林縣,　大埤鄉,西鎮村,24,149,300,473,3,476,0,476,228,704,67.6136
第15任總統副總統,在雲林縣各村(里),雲林縣,　莿桐鄉,莿桐村,96,976,1926,2998,36,3034,0,3034,953,3987,76.0973
第15任總統副總統,在雲林縣各村(里),雲林縣,　莿桐鄉,甘厝村,15,129,484,628,8,636,0,636,190,826,76.9976
第15任總統副總統,在雲林縣各村(里),雲林縣,　莿桐鄉,甘西村,36,268,826,1130,7,1137,0,1137,390,1527,74.4597
第15任總統副總統,在雲林縣各村(里),雲林縣,　莿桐鄉,興桐村,28,251,620,899,13,912,0,912,269,1181,77.2227
第15任總統副總統,在雲林縣各村(里),雲林縣,　莿桐鄉,義和村,22,183,566,771,12,783,0,783,280,1063,73.6595
第15任總統副總統,在雲林縣各村(里),雲林縣,　莿桐鄉,埔子村,62,373,1029,1464,15,1479,0,1479,455,1934,76.4736
第15任總統副總統,在雲林縣各村(里),雲林縣,　莿桐鄉,大美村,91,730,1413,2234,25,2259,0,2259,666,2925,77.2308
第15任總統副總統,在雲林縣各村(里),雲林縣,　莿桐鄉,埔尾村,40,319,623,982,14,996,0,996,262,1258,79.1733
第15任總統副總統,在雲林縣各村(里),雲林縣,　莿桐鄉,興貴村,50,417,882,1349,18,1367,0,1367,485,1852,73.8121
第15任總統副總統,在雲林縣各村(里),雲林縣,　莿桐鄉,饒平村,34,248,509,791,9,800,0,800,323,1123,71.2378
第15任總統副總統,在雲林縣各村(里),雲林縣,　莿桐鄉,四合村,48,418,826,1292,11,1303,0,1303,376,1679,77.6057
第15任總統副總統,在雲林縣各村(里),雲林縣,　莿桐鄉,麻園村,56,315,688,1059,9,1068,0,1068,385,1453,73.5031
第15任總統副總統,在雲林縣各村(里),雲林縣,　莿桐鄉,五華村,28,252,664,944,7,951,0,951,340,1291,73.6638
第15任總統副總統,在雲林縣各村(里),雲林縣,　莿桐鄉,六合村,51,371,873,1295,17,1312,0,1312,426,1738,75.4891
第15任總統副總統,在雲林縣各村(里),雲林縣,　林內鄉,林南村,44,297,399,740,9,749,0,749,241,990,75.6566
第15任總統副總統,在雲林縣各村(里),雲林縣,　林內鄉,林中村,73,964,1536,2573,41,2614,0,2614,903,3517,74.3247
第15任總統副總統,在雲林縣各村(里),雲林縣,　林內鄉,林北村,69,493,990,1552,22,1574,0,1574,544,2118,74.3154
第15任總統副總統,在雲林縣各村(里),雲林縣,　林內鄉,坪頂村,9,150,208,367,5,372,0,372,141,513,72.5146
第15任總統副總統,在雲林縣各村(里),雲林縣,　林內鄉,林茂村,20,220,312,552,12,564,0,564,225,789,71.4829
第15任總統副總統,在雲林縣各村(里),雲林縣,　林內鄉,九芎村,67,643,1083,1793,29,1822,0,1822,699,2521,72.2729
第15任總統副總統,在雲林縣各村(里),雲林縣,　林內鄉,湖本村,15,157,297,469,6,475,0,475,150,625,76.0000
第15任總統副總統,在雲林縣各村(里),雲林縣,　林內鄉,烏塗村,38,295,476,809,6,815,0,815,310,1125,72.4444
第15任總統副總統,在雲林縣各村(里),雲林縣,　林內鄉,烏麻村,42,286,415,743,10,753,0,753,266,1019,73.8960
第15任總統副總統,在雲林縣各村(里),雲林縣,　林內鄉,重興村,56,378,879,1313,21,1334,0,1334,426,1760,75.7955
第15任總統副總統,在雲林縣各村(里),雲林縣,　二崙鄉,崙東村,34,325,652,1011,15,1026,0,1026,394,1420,72.2535
第15任總統副總統,在雲林縣各村(里),雲林縣,　二崙鄉,崙西村,37,431,769,1237,9,1246,0,1246,415,1661,75.0151
第15任總統副總統,在雲林縣各村(里),雲林縣,　二崙鄉,來惠村,24,286,797,1107,16,1123,0,1123,443,1566,71.7114
第15任總統副總統,在雲林縣各村(里),雲林縣,　二崙鄉,三和村,25,224,714,963,13,976,0,976,475,1451,67.2640
第15任總統副總統,在雲林縣各村(里),雲林縣,　二崙鄉,湳仔村,17,282,462,761,14,775,0,775,344,1119,69.2583
第15任總統副總統,在雲林縣各村(里),雲林縣,　二崙鄉,田尾村,30,428,835,1293,10,1303,1,1304,453,1757,74.1605
第15任總統副總統,在雲林縣各村(里),雲林縣,　二崙鄉,定安村,16,154,433,603,5,608,0,608,244,852,71.3615
第15任總統副總統,在雲林縣各村(里),雲林縣,　二崙鄉,永定村,26,247,752,1025,10,1035,0,1035,340,1375,75.2727
第15任總統副總統,在雲林縣各村(里),雲林縣,　二崙鄉,大華村,18,139,444,601,8,609,0,609,238,847,71.9008
第15任總統副總統,在雲林縣各村(里),雲林縣,　二崙鄉,義庄村,6,106,397,509,5,514,0,514,212,726,70.7989
第15任總統副總統,在雲林縣各村(里),雲林縣,　二崙鄉,楊賢村,31,208,766,1005,21,1026,0,1026,416,1442,71.1512
第15任總統副總統,在雲林縣各村(里),雲林縣,　二崙鄉,港後村,28,287,889,1204,15,1219,0,1219,558,1777,68.5988
第15任總統副總統,在雲林縣各村(里),雲林縣,　二崙鄉,大義村,10,162,366,538,4,542,0,542,274,816,66.4216
第15任總統副總統,在雲林縣各村(里),雲林縣,　二崙鄉,油車村,38,353,797,1188,24,1212,0,1212,497,1709,70.9187
第15任總統副總統,在雲林縣各村(里),雲林縣,　二崙鄉,大庄村,24,219,564,807,10,817,0,817,398,1215,67.2428
第15任總統副總統,在雲林縣各村(里),雲林縣,　二崙鄉,庄西村,12,181,367,560,1,561,0,561,330,891,62.9630
第15任總統副總統,在雲林縣各村(里),雲林縣,　二崙鄉,大同村,22,157,392,571,10,581,0,581,237,818,71.0269
第15任總統副總統,在雲林縣各村(里),雲林縣,　二崙鄉,復興村,13,209,460,682,5,687,0,687,305,992,69.2540
第15任總統副總統,在雲林縣各村(里),雲林縣,　崙背鄉,東明村,33,284,528,845,16,861,0,861,266,1127,76.3975
第15任總統副總統,在雲林縣各村(里),雲林縣,　崙背鄉,西榮村,43,311,631,985,9,994,0,994,388,1382,71.9247
第15任總統副總統,在雲林縣各村(里),雲林縣,　崙背鄉,南陽村,59,621,992,1672,22,1694,0,1694,550,2244,75.4902
第15任總統副總統,在雲林縣各村(里),雲林縣,　崙背鄉,崙前村,48,363,954,1365,21,1386,0,1386,605,1991,69.6133
第15任總統副總統,在雲林縣各村(里),雲林縣,　崙背鄉,羅厝村,45,435,943,1423,11,1434,0,1434,516,1950,73.5385
第15任總統副總統,在雲林縣各村(里),雲林縣,　崙背鄉,港尾村,23,218,588,829,10,839,0,839,408,1247,67.2815
第15任總統副總統,在雲林縣各村(里),雲林縣,　崙背鄉,阿勸村,52,450,790,1292,25,1317,0,1317,625,1942,67.8167
第15任總統副總統,在雲林縣各村(里),雲林縣,　崙背鄉,五魁村,12,310,218,540,7,547,0,547,240,787,69.5044
第15任總統副總統,在雲林縣各村(里),雲林縣,　崙背鄉,大有村,24,352,575,951,19,970,0,970,477,1447,67.0352
第15任總統副總統,在雲林縣各村(里),雲林縣,　崙背鄉,豐榮村,40,337,668,1045,12,1057,0,1057,632,1689,62.5814
第15任總統副總統,在雲林縣各村(里),雲林縣,　崙背鄉,草湖村,40,354,574,968,13,981,1,982,417,1399,70.1215
第15任總統副總統,在雲林縣各村(里),雲林縣,　崙背鄉,舊庄村,21,262,436,719,10,729,0,729,390,1119,65.1475
第15任總統副總統,在雲林縣各村(里),雲林縣,　崙背鄉,水尾村,11,194,640,845,13,858,0,858,323,1181,72.6503
第15任總統副總統,在雲林縣各村(里),雲林縣,　崙背鄉,枋南村,22,185,357,564,6,570,0,570,210,780,73.0769
第15任總統副總統,在雲林縣各村(里),雲林縣,　麥寮鄉,麥豐村,221,1866,2536,4623,66,4689,0,4689,2228,6917,67.7895
第15任總統副總統,在雲林縣各村(里),雲林縣,　麥寮鄉,麥津村,137,1123,1389,2649,32,2681,0,2681,1310,3991,67.1761
第15任總統副總統,在雲林縣各村(里),雲林縣,　麥寮鄉,瓦磘村,39,348,834,1221,13,1234,0,1234,671,1905,64.7769
第15任總統副總統,在雲林縣各村(里),雲林縣,　麥寮鄉,興華村,79,576,1039,1694,27,1721,0,1721,870,2591,66.4222
第15任總統副總統,在雲林縣各村(里),雲林縣,　麥寮鄉,海豐村,73,570,723,1366,20,1386,0,1386,771,2157,64.2559
第15任總統副總統,在雲林縣各村(里),雲林縣,　麥寮鄉,後安村,84,836,874,1794,28,1822,0,1822,1098,2920,62.3973
第15任總統副總統,在雲林縣各村(里),雲林縣,　麥寮鄉,中興村,50,362,528,940,13,953,0,953,511,1464,65.0956
第15任總統副總統,在雲林縣各村(里),雲林縣,　麥寮鄉,三盛村,57,378,812,1247,12,1259,0,1259,727,1986,63.3938
第15任總統副總統,在雲林縣各村(里),雲林縣,　麥寮鄉,崙後村,83,675,839,1597,18,1615,0,1615,937,2552,63.2837
第15任總統副總統,在雲林縣各村(里),雲林縣,　麥寮鄉,橋頭村,130,914,1430,2474,40,2514,0,2514,1275,3789,66.3500
第15任總統副總統,在雲林縣各村(里),雲林縣,　麥寮鄉,新吉村,30,246,420,696,11,707,0,707,373,1080,65.4630
第15任總統副總統,在雲林縣各村(里),雲林縣,　麥寮鄉,施厝村,103,737,1351,2191,36,2227,0,2227,1161,3388,65.7320
第15任總統副總統,在雲林縣各村(里),雲林縣,　麥寮鄉,雷厝村,48,479,817,1344,17,1361,0,1361,712,2073,65.6536
第15任總統副總統,在雲林縣各村(里),雲林縣,　東勢鄉,月眉村,34,207,482,723,9,732,0,732,421,1153,63.4866
第15任總統副總統,在雲林縣各村(里),雲林縣,　東勢鄉,復興村,14,128,232,374,4,378,0,378,139,517,73.1141
第15任總統副總統,在雲林縣各村(里),雲林縣,　東勢鄉,嘉隆村,29,360,673,1062,13,1075,0,1075,503,1578,68.1242
第15任總統副總統,在雲林縣各村(里),雲林縣,　東勢鄉,東南村,40,443,562,1045,13,1058,0,1058,371,1429,74.0378
第15任總統副總統,在雲林縣各村(里),雲林縣,　東勢鄉,東北村,31,320,459,810,14,824,0,824,339,1163,70.8512
第15任總統副總統,在雲林縣各村(里),雲林縣,　東勢鄉,龍潭村,22,161,326,509,5,514,0,514,288,802,64.0898
第15任總統副總統,在雲林縣各村(里),雲林縣,　東勢鄉,程海村,12,106,220,338,6,344,0,344,163,507,67.8501
第15任總統副總統,在雲林縣各村(里),雲林縣,　東勢鄉,昌南村,20,205,345,570,8,578,0,578,256,834,69.3046
第15任總統副總統,在雲林縣各村(里),雲林縣,　東勢鄉,安南村,21,167,307,495,1,496,0,496,307,803,61.7684
第15任總統副總統,在雲林縣各村(里),雲林縣,　東勢鄉,同安村,49,475,644,1168,21,1189,0,1189,684,1873,63.4810
第15任總統副總統,在雲林縣各村(里),雲林縣,　東勢鄉,四美村,24,254,319,597,7,604,0,604,392,996,60.6426
第15任總統副總統,在雲林縣各村(里),雲林縣,　東勢鄉,新坤村,19,271,374,664,6,670,0,670,360,1030,65.0485
第15任總統副總統,在雲林縣各村(里),雲林縣,　褒忠鄉,中民村,52,480,797,1329,17,1346,0,1346,476,1822,73.8749
第15任總統副總統,在雲林縣各村(里),雲林縣,　褒忠鄉,埔姜村,35,361,575,971,13,984,0,984,396,1380,71.3043
第15任總統副總統,在雲林縣各村(里),雲林縣,　褒忠鄉,中勝村,35,359,653,1047,20,1067,0,1067,400,1467,72.7335
第15任總統副總統,在雲林縣各村(里),雲林縣,　褒忠鄉,馬鳴村,44,312,687,1043,9,1052,0,1052,399,1451,72.5017
第15任總統副總統,在雲林縣各村(里),雲林縣,　褒忠鄉,新湖村,32,225,564,821,20,841,0,841,335,1176,71.5136
第15任總統副總統,在雲林縣各村(里),雲林縣,　褒忠鄉,有才村,26,169,353,548,7,555,0,555,263,818,67.8484
第15任總統副總統,在雲林縣各村(里),雲林縣,　褒忠鄉,田洋村,25,174,342,541,9,550,0,550,201,751,73.2357
第15任總統副總統,在雲林縣各村(里),雲林縣,　褒忠鄉,龍岩村,28,323,459,810,14,824,0,824,352,1176,70.0680
第15任總統副總統,在雲林縣各村(里),雲林縣,　褒忠鄉,潮厝村,18,150,385,553,8,561,0,561,302,863,65.0058
第15任總統副總統,在雲林縣各村(里),雲林縣,　臺西鄉,台西村,36,419,355,810,13,823,0,823,363,1186,69.3929
第15任總統副總統,在雲林縣各村(里),雲林縣,　臺西鄉,海南村,36,321,321,678,6,684,0,684,388,1072,63.8060
第15任總統副總統,在雲林縣各村(里),雲林縣,　臺西鄉,海北村,33,292,326,651,9,660,0,660,380,1040,63.4615
第15任總統副總統,在雲林縣各村(里),雲林縣,　臺西鄉,海口村,42,543,631,1216,18,1234,0,1234,746,1980,62.3232
第15任總統副總統,在雲林縣各村(里),雲林縣,　臺西鄉,山寮村,23,190,254,467,11,478,0,478,345,823,58.0802
第15任總統副總統,在雲林縣各村(里),雲林縣,　臺西鄉,溪頂村,29,292,515,836,14,850,0,850,574,1424,59.6910
第15任總統副總統,在雲林縣各村(里),雲林縣,　臺西鄉,牛厝村,32,378,690,1100,24,1124,0,1124,691,1815,61.9284
第15任總統副總統,在雲林縣各村(里),雲林縣,　臺西鄉,泉州村,9,133,202,344,3,347,0,347,236,583,59.5197
第15任總統副總統,在雲林縣各村(里),雲林縣,　臺西鄉,五榔村,6,68,219,293,8,301,0,301,151,452,66.5929
第15任總統副總統,在雲林縣各村(里),雲林縣,　臺西鄉,光華村,17,172,247,436,9,445,0,445,215,660,67.4242
第15任總統副總統,在雲林縣各村(里),雲林縣,　臺西鄉,五港村,41,444,605,1090,16,1106,0,1106,665,1771,62.4506
第15任總統副總統,在雲林縣各村(里),雲林縣,　臺西鄉,富琦村,45,410,514,969,15,984,0,984,471,1455,67.6289
第15任總統副總統,在雲林縣各村(里),雲林縣,　臺西鄉,永豐村,33,394,433,860,13,873,0,873,455,1328,65.7380
第15任總統副總統,在雲林縣各村(里),雲林縣,　臺西鄉,和豐村,76,759,925,1760,40,1800,0,1800,1128,2928,61.4754
第15任總統副總統,在雲林縣各村(里),雲林縣,　臺西鄉,蚊港村,44,525,574,1143,27,1170,0,1170,595,1765,66.2890
第15任總統副總統,在雲林縣各村(里),雲林縣,　元長鄉,長南村,90,758,1306,2154,27,2181,0,2181,985,3166,68.8882
第15任總統副總統,在雲林縣各村(里),雲林縣,　元長鄉,長北村,35,315,610,960,13,973,0,973,499,1472,66.1005
第15任總統副總統,在雲林縣各村(里),雲林縣,　元長鄉,子茂村,27,294,530,851,14,865,0,865,435,1300,66.5385
第15任總統副總統,在雲林縣各村(里),雲林縣,　元長鄉,後湖村,13,130,364,507,8,515,0,515,200,715,72.0280
第15任總統副總統,在雲林縣各村(里),雲林縣,　元長鄉,山內村,11,241,354,606,8,614,0,614,307,921,66.6667
第15任總統副總統,在雲林縣各村(里),雲林縣,　元長鄉,合和村,22,186,466,674,7,681,0,681,349,1030,66.1165
第15任總統副總統,在雲林縣各村(里),雲林縣,　元長鄉,五塊村,27,238,346,611,8,619,0,619,282,901,68.7014
第15任總統副總統,在雲林縣各村(里),雲林縣,　元長鄉,潭西村,10,87,355,452,12,464,0,464,271,735,63.1293
第15任總統副總統,在雲林縣各村(里),雲林縣,　元長鄉,潭東村,17,165,194,376,10,386,0,386,177,563,68.5613
第15任總統副總統,在雲林縣各村(里),雲林縣,　元長鄉,客厝村,22,201,341,564,9,573,0,573,268,841,68.1332
第15任總統副總統,在雲林縣各村(里),雲林縣,　元長鄉,卓運村,7,50,180,237,2,239,0,239,120,359,66.5738
第15任總統副總統,在雲林縣各村(里),雲林縣,　元長鄉,頂寮村,30,219,465,714,8,722,0,722,383,1105,65.3394
第15任總統副總統,在雲林縣各村(里),雲林縣,　元長鄉,下寮村,36,339,586,961,16,977,0,977,462,1439,67.8944
第15任總統副總統,在雲林縣各村(里),雲林縣,　元長鄉,龍岩村,18,154,493,665,8,673,0,673,293,966,69.6687
第15任總統副總統,在雲林縣各村(里),雲林縣,　元長鄉,西莊村,21,153,380,554,10,564,0,564,250,814,69.2875
第15任總統副總統,在雲林縣各村(里),雲林縣,　元長鄉,鹿北村,30,246,497,773,7,780,0,780,343,1123,69.4568
第15任總統副總統,在雲林縣各村(里),雲林縣,　元長鄉,鹿南村,23,144,354,521,4,525,0,525,299,824,63.7136
第15任總統副總統,在雲林縣各村(里),雲林縣,　元長鄉,瓦磘村,29,300,618,947,10,957,0,957,533,1490,64.2282
第15任總統副總統,在雲林縣各村(里),雲林縣,　元長鄉,內寮村,12,100,274,386,8,394,0,394,200,594,66.3300
第15任總統副總統,在雲林縣各村(里),雲林縣,　元長鄉,崙仔村,15,163,338,516,7,523,0,523,286,809,64.6477
第15任總統副總統,在雲林縣各村(里),雲林縣,　元長鄉,新吉村,12,160,294,466,8,474,0,474,195,669,70.8520
第15任總統副總統,在雲林縣各村(里),雲林縣,　四湖鄉,四湖村,44,446,617,1107,17,1124,0,1124,541,1665,67.5075
第15任總統副總統,在雲林縣各村(里),雲林縣,　四湖鄉,湖西村,59,598,853,1510,29,1539,0,1539,669,2208,69.7011
第15任總統副總統,在雲林縣各村(里),雲林縣,　四湖鄉,新庄村,10,119,285,414,5,419,0,419,213,632,66.2975
第15任總統副總統,在雲林縣各村(里),雲林縣,　四湖鄉,溪底村,15,194,379,588,2,590,0,590,322,912,64.6930
第15任總統副總統,在雲林縣各村(里),雲林縣,　四湖鄉,鹿場村,23,186,335,544,7,551,0,551,347,898,61.3586
第15任總統副總統,在雲林縣各村(里),雲林縣,　四湖鄉,蔡厝村,10,184,319,513,9,522,0,522,313,835,62.5150
第15任總統副總統,在雲林縣各村(里),雲林縣,　四湖鄉,湖寮村,7,127,257,391,4,395,0,395,319,714,55.3221
第15任總統副總統,在雲林縣各村(里),雲林縣,　四湖鄉,施湖村,26,282,375,683,29,712,0,712,459,1171,60.8027
第15任總統副總統,在雲林縣各村(里),雲林縣,　四湖鄉,羊調村,15,218,290,523,9,532,0,532,361,893,59.5745
第15任總統副總統,在雲林縣各村(里),雲林縣,　四湖鄉,內湖村,9,134,254,397,9,406,0,406,332,738,55.0136
第15任總統副總統,在雲林縣各村(里),雲林縣,　四湖鄉,飛東村,14,102,178,294,3,297,0,297,238,535,55.5140
第15任總統副總統,在雲林縣各村(里),雲林縣,　四湖鄉,飛沙村,17,181,256,454,6,460,0,460,382,842,54.6318
第15任總統副總統,在雲林縣各村(里),雲林縣,　四湖鄉,三姓村,6,76,139,221,7,228,0,228,130,358,63.6872
第15任總統副總統,在雲林縣各村(里),雲林縣,　四湖鄉,崙北村,25,375,513,913,11,924,0,924,734,1658,55.7298
第15任總統副總統,在雲林縣各村(里),雲林縣,　四湖鄉,崙南村,16,178,242,436,7,443,0,443,338,781,56.7222
第15任總統副總統,在雲林縣各村(里),雲林縣,　四湖鄉,廣溝村,23,155,194,372,6,378,0,378,307,685,55.1825
第15任總統副總統,在雲林縣各村(里),雲林縣,　四湖鄉,萡子村,14,132,345,491,6,497,0,497,403,900,55.2222
第15任總統副總統,在雲林縣各村(里),雲林縣,　四湖鄉,萡東村,18,94,450,562,10,572,0,572,451,1023,55.9140
第15任總統副總統,在雲林縣各村(里),雲林縣,　四湖鄉,林厝村,13,209,354,576,9,585,0,585,448,1033,56.6312
第15任總統副總統,在雲林縣各村(里),雲林縣,　四湖鄉,林東村,11,210,305,526,3,529,0,529,439,968,54.6488
第15任總統副總統,在雲林縣各村(里),雲林縣,　四湖鄉,溪尾村,12,182,209,403,8,411,0,411,298,709,57.9690
第15任總統副總統,在雲林縣各村(里),雲林縣,　口湖鄉,口湖村,39,272,418,729,13,742,0,742,339,1081,68.6401
第15任總統副總統,在雲林縣各村(里),雲林縣,　口湖鄉,湖東村,23,327,446,796,10,806,0,806,390,1196,67.3913
第15任總統副總統,在雲林縣各村(里),雲林縣,　口湖鄉,頂湖村,7,147,208,362,4,366,0,366,248,614,59.6091
第15任總統副總統,在雲林縣各村(里),雲林縣,　口湖鄉,埔南村,21,138,329,488,8,496,0,496,201,697,71.1621
第15任總統副總統,在雲林縣各村(里),雲林縣,　口湖鄉,埔北村,21,135,332,488,8,496,0,496,352,848,58.4906
第15任總統副總統,在雲林縣各村(里),雲林縣,　口湖鄉,謝厝村,13,168,485,666,13,679,0,679,290,969,70.0722
第15任總統副總統,在雲林縣各村(里),雲林縣,　口湖鄉,蚵寮村,36,247,598,881,9,890,0,890,499,1389,64.0749
第15任總統副總統,在雲林縣各村(里),雲林縣,　口湖鄉,下崙村,43,325,829,1197,11,1208,0,1208,762,1970,61.3198
第15任總統副總統,在雲林縣各村(里),雲林縣,　口湖鄉,崙中村,42,249,587,878,14,892,0,892,607,1499,59.5063
第15任總統副總統,在雲林縣各村(里),雲林縣,　口湖鄉,崙東村,36,270,562,868,17,885,0,885,526,1411,62.7215
第15任總統副總統,在雲林縣各村(里),雲林縣,　口湖鄉,青蚶村,10,86,230,326,10,336,0,336,195,531,63.2768
第15任總統副總統,在雲林縣各村(里),雲林縣,　口湖鄉,港東村,38,328,515,881,7,888,1,889,592,1481,59.9595
第15任總統副總統,在雲林縣各村(里),雲林縣,　口湖鄉,港西村,20,187,300,507,5,512,0,512,307,819,62.5153
第15任總統副總統,在雲林縣各村(里),雲林縣,　口湖鄉,台子村,30,236,973,1239,19,1258,0,1258,557,1815,69.3113
第15任總統副總統,在雲林縣各村(里),雲林縣,　口湖鄉,成龍村,24,184,350,558,6,564,0,564,340,904,62.3894
第15任總統副總統,在雲林縣各村(里),雲林縣,　口湖鄉,梧南村,44,376,785,1205,15,1220,0,1220,519,1739,70.1553
第15任總統副總統,在雲林縣各村(里),雲林縣,　口湖鄉,梧北村,11,153,599,763,16,779,0,779,379,1158,67.2712
第15任總統副總統,在雲林縣各村(里),雲林縣,　口湖鄉,水井村,17,240,367,624,7,631,0,631,288,919,68.6616
第15任總統副總統,在雲林縣各村(里),雲林縣,　口湖鄉,後厝村,17,125,305,447,3,450,0,450,243,693,64.9351
第15任總統副總統,在雲林縣各村(里),雲林縣,　口湖鄉,湖口村,20,171,417,608,14,622,0,622,359,981,63.4047
第15任總統副總統,在雲林縣各村(里),雲林縣,　口湖鄉,過港村,9,114,227,350,4,354,0,354,226,580,61.0345
第15任總統副總統,在雲林縣各村(里),雲林縣,　水林鄉,水北村,57,429,945,1431,20,1451,0,1451,694,2145,67.6457
第15任總統副總統,在雲林縣各村(里),雲林縣,　水林鄉,水南村,49,395,938,1382,19,1401,0,1401,518,1919,73.0068
第15任總統副總統,在雲林縣各村(里),雲林縣,　水林鄉,萬興村,12,95,342,449,6,455,0,455,243,698,65.1862
第15任總統副總統,在雲林縣各村(里),雲林縣,　水林鄉,尖山村,12,116,289,417,5,422,0,422,202,624,67.6282
第15任總統副總統,在雲林縣各村(里),雲林縣,　水林鄉,大溝村,19,159,462,640,8,648,0,648,315,963,67.2897
第15任總統副總統,在雲林縣各村(里),雲林縣,　水林鄉,順興村,12,105,372,489,9,498,0,498,304,802,62.0948
第15任總統副總統,在雲林縣各村(里),雲林縣,　水林鄉,大山村,30,159,532,721,4,725,0,725,297,1022,70.9393
第15任總統副總統,在雲林縣各村(里),雲林縣,　水林鄉,後寮村,19,93,318,430,6,436,0,436,216,652,66.8712
第15任總統副總統,在雲林縣各村(里),雲林縣,　水林鄉,春埔村,16,157,437,610,9,619,0,619,323,942,65.7113
第15任總統副總統,在雲林縣各村(里),雲林縣,　水林鄉,西井村,13,124,242,379,15,394,0,394,219,613,64.2741
第15任總統副總統,在雲林縣各村(里),雲林縣,　水林鄉,車港村,8,98,253,359,3,362,0,362,229,591,61.2521
第15任總統副總統,在雲林縣各村(里),雲林縣,　水林鄉,蘇秦村,21,129,439,589,10,599,0,599,380,979,61.1849
第15任總統副總統,在雲林縣各村(里),雲林縣,　水林鄉,灣東村,16,142,208,366,4,370,0,370,245,615,60.1626
第15任總統副總統,在雲林縣各村(里),雲林縣,　水林鄉,灣西村,22,186,343,551,9,560,0,560,363,923,60.6717
第15任總統副總統,在雲林縣各村(里),雲林縣,　水林鄉,蕃薯村,20,157,425,602,1,603,0,603,321,924,65.2597
第15任總統副總統,在雲林縣各村(里),雲林縣,　水林鄉,山腳村,10,109,389,508,4,512,0,512,269,781,65.5570
第15任總統副總統,在雲林縣各村(里),雲林縣,　水林鄉,松北村,35,203,421,659,16,675,0,675,329,1004,67.2311
第15任總統副總統,在雲林縣各村(里),雲林縣,　水林鄉,松中村,6,79,238,323,6,329,0,329,160,489,67.2802
第15任總統副總統,在雲林縣各村(里),雲林縣,　水林鄉,松西村,13,81,308,402,10,412,0,412,236,648,63.5802
第15任總統副總統,在雲林縣各村(里),雲林縣,　水林鄉,瓊埔村,14,69,321,404,8,412,0,412,250,662,62.2356
第15任總統副總統,在雲林縣各村(里),雲林縣,　水林鄉,塭底村,10,95,284,389,3,392,0,392,270,662,59.2145
第15任總統副總統,在雲林縣各村(里),雲林縣,　水林鄉,海埔村,14,131,468,613,9,622,0,622,348,970,64.1237
第15任總統副總統,在雲林縣各村(里),雲林縣,　水林鄉,土厝村,18,152,587,757,10,767,0,767,355,1122,68.3601
第15任總統副總統,在雲林縣各村(里),雲林縣,　水林鄉,溪墘村,17,142,350,509,8,517,0,517,232,749,69.0254
第15任總統副總統,在彰化縣各村(里),彰化縣,　彰化市,桃源里,91,761,964,1816,17,1833,0,1833,603,2436,75.2463
第15任總統副總統,在彰化縣各村(里),彰化縣,　彰化市,東興里,50,464,630,1144,14,1158,0,1158,362,1520,76.1842
第15任總統副總統,在彰化縣各村(里),彰化縣,　彰化市,華北里,54,419,602,1075,13,1088,0,1088,328,1416,76.8362
第15任總統副總統,在彰化縣各村(里),彰化縣,　彰化市,華陽里,44,636,621,1301,15,1316,0,1316,450,1766,74.5187
第15任總統副總統,在彰化縣各村(里),彰化縣,　彰化市,大同里,30,313,417,760,9,769,0,769,237,1006,76.4414
第15任總統副總統,在彰化縣各村(里),彰化縣,　彰化市,永生里,57,377,520,954,11,965,0,965,257,1222,78.9689
第15任總統副總統,在彰化縣各村(里),彰化縣,　彰化市,建寶里,69,827,796,1692,26,1718,0,1718,506,2224,77.2482
第15任總統副總統,在彰化縣各村(里),彰化縣,　彰化市,光南里,55,412,618,1085,11,1096,0,1096,285,1381,79.3628
第15任總統副總統,在彰化縣各村(里),彰化縣,　彰化市,介壽里,75,799,731,1605,30,1635,0,1635,907,2542,64.3194
第15任總統副總統,在彰化縣各村(里),彰化縣,　彰化市,延平里,335,2594,3598,6527,85,6612,1,6613,1839,8452,78.2300
第15任總統副總統,在彰化縣各村(里),彰化縣,　彰化市,延和里,181,1430,2042,3653,52,3705,0,3705,1083,4788,77.3810
第15任總統副總統,在彰化縣各村(里),彰化縣,　彰化市,南興里,277,2072,3228,5577,72,5649,0,5649,1534,7183,78.6440
第15任總統副總統,在彰化縣各村(里),彰化縣,　彰化市,南瑶里,258,2226,3197,5681,69,5750,0,5750,1567,7317,78.5841
第15任總統副總統,在彰化縣各村(里),彰化縣,　彰化市,成功里,59,426,634,1119,15,1134,0,1134,311,1445,78.4775
第15任總統副總統,在彰化縣各村(里),彰化縣,　彰化市,福安里,39,305,409,753,15,768,0,768,213,981,78.2875
第15任總統副總統,在彰化縣各村(里),彰化縣,　彰化市,西安里,112,771,1179,2062,26,2088,0,2088,719,2807,74.3855
第15任總統副總統,在彰化縣各村(里),彰化縣,　彰化市,彰安里,101,808,1245,2154,20,2174,0,2174,662,2836,76.6573
第15任總統副總統,在彰化縣各村(里),彰化縣,　彰化市,中央里,15,217,361,593,6,599,0,599,160,759,78.9196
第15任總統副總統,在彰化縣各村(里),彰化縣,　彰化市,富貴里,28,258,391,677,6,683,0,683,168,851,80.2585
第15任總統副總統,在彰化縣各村(里),彰化縣,　彰化市,民權里,29,309,475,813,7,820,0,820,257,1077,76.1374
第15任總統副總統,在彰化縣各村(里),彰化縣,　彰化市,萬壽里,16,193,445,654,5,659,0,659,205,864,76.2731
第15任總統副總統,在彰化縣各村(里),彰化縣,　彰化市,長樂里,25,254,475,754,6,760,0,760,183,943,80.5938
第15任總統副總統,在彰化縣各村(里),彰化縣,　彰化市,西興里,176,952,1410,2538,32,2570,0,2570,685,3255,78.9555
第15任總統副總統,在彰化縣各村(里),彰化縣,　彰化市,西勢里,134,1161,1467,2762,35,2797,0,2797,714,3511,79.6639
第15任總統副總統,在彰化縣各村(里),彰化縣,　彰化市,忠權里,117,959,1246,2322,25,2347,0,2347,702,3049,76.9761
第15任總統副總統,在彰化縣各村(里),彰化縣,　彰化市,忠孝里,55,367,479,901,16,917,0,917,233,1150,79.7391
第15任總統副總統,在彰化縣各村(里),彰化縣,　彰化市,五權里,153,1175,1611,2939,35,2974,0,2974,1039,4013,74.1091
第15任總統副總統,在彰化縣各村(里),彰化縣,　彰化市,平和里,149,1222,1772,3143,30,3173,0,3173,896,4069,77.9798
第15任總統副總統,在彰化縣各村(里),彰化縣,　彰化市,崙平里,177,1600,2156,3933,54,3987,0,3987,1202,5189,76.8356
第15任總統副總統,在彰化縣各村(里),彰化縣,　彰化市,向陽里,194,1632,2097,3923,45,3968,0,3968,1027,4995,79.4394
第15任總統副總統,在彰化縣各村(里),彰化縣,　彰化市,莿桐里,108,910,1307,2325,32,2357,1,2358,665,3023,77.9689
第15任總統副總統,在彰化縣各村(里),彰化縣,　彰化市,南美里,72,520,787,1379,22,1401,0,1401,389,1790,78.2682
第15任總統副總統,在彰化縣各村(里),彰化縣,　彰化市,南安里,91,608,873,1572,16,1588,0,1588,483,2071,76.6779
第15任總統副總統,在彰化縣各村(里),彰化縣,　彰化市,東芳里,143,937,1533,2613,31,2644,0,2644,747,3391,77.9711
第15任總統副總統,在彰化縣各村(里),彰化縣,　彰化市,磚磘里,118,932,1410,2460,25,2485,1,2486,725,3211,77.3902
第15任總統副總統,在彰化縣各村(里),彰化縣,　彰化市,卦山里,108,803,933,1844,28,1872,0,1872,566,2438,76.7842
第15任總統副總統,在彰化縣各村(里),彰化縣,　彰化市,光復里,22,143,347,512,7,519,0,519,129,648,80.0926
第15任總統副總統,在彰化縣各村(里),彰化縣,　彰化市,永福里,38,230,395,663,7,670,0,670,195,865,77.4566
第15任總統副總統,在彰化縣各村(里),彰化縣,　彰化市,光華里,19,212,324,555,5,560,0,560,142,702,79.7721
第15任總統副總統,在彰化縣各村(里),彰化縣,　彰化市,中正里,50,418,609,1077,10,1087,1,1088,307,1395,77.9211
第15任總統副總統,在彰化縣各村(里),彰化縣,　彰化市,中山里,24,274,274,572,11,583,0,583,160,743,78.4657
第15任總統副總統,在彰化縣各村(里),彰化縣,　彰化市,龍山里,70,577,767,1414,15,1429,0,1429,414,1843,77.5366
第15任總統副總統,在彰化縣各村(里),彰化縣,　彰化市,新興里,208,1504,2256,3968,54,4022,0,4022,1045,5067,79.3764
第15任總統副總統,在彰化縣各村(里),彰化縣,　彰化市,新華里,67,500,702,1269,10,1279,0,1279,366,1645,77.7508
第15任總統副總統,在彰化縣各村(里),彰化縣,　彰化市,興北里,58,463,683,1204,10,1214,1,1215,364,1579,76.8841
第15任總統副總統,在彰化縣各村(里),彰化縣,　彰化市,信義里,19,235,355,609,6,615,0,615,162,777,79.1506
第15任總統副總統,在彰化縣各村(里),彰化縣,　彰化市,民生里,41,406,586,1033,16,1049,0,1049,294,1343,78.1087
第15任總統副總統,在彰化縣各村(里),彰化縣,　彰化市,文化里,46,408,506,960,8,968,0,968,282,1250,77.4400
第15任總統副總統,在彰化縣各村(里),彰化縣,　彰化市,陽明里,66,513,710,1289,17,1306,0,1306,395,1701,76.7784
第15任總統副總統,在彰化縣各村(里),彰化縣,　彰化市,萬安里,156,1165,1647,2968,34,3002,0,3002,811,3813,78.7307
第15任總統副總統,在彰化縣各村(里),彰化縣,　彰化市,下廍里,173,1567,2020,3760,43,3803,0,3803,1017,4820,78.9004
第15任總統副總統,在彰化縣各村(里),彰化縣,　彰化市,茄苳里,37,269,395,701,10,711,0,711,185,896,79.3527
第15任總統副總統,在彰化縣各村(里),彰化縣,　彰化市,茄南里,107,906,1193,2206,32,2238,0,2238,568,2806,79.7577
第15任總統副總統,在彰化縣各村(里),彰化縣,　彰化市,寶廍里,66,361,498,925,15,940,0,940,242,1182,79.5262
第15任總統副總統,在彰化縣各村(里),彰化縣,　彰化市,古夷里,101,644,1035,1780,23,1803,0,1803,522,2325,77.5484
第15任總統副總統,在彰化縣各村(里),彰化縣,　彰化市,阿夷里,338,2503,3423,6264,76,6340,0,6340,1764,8104,78.2330
第15任總統副總統,在彰化縣各村(里),彰化縣,　彰化市,和調里,123,819,1056,1998,20,2018,0,2018,537,2555,78.9824
第15任總統副總統,在彰化縣各村(里),彰化縣,　彰化市,復興里,141,1238,1712,3091,37,3128,0,3128,875,4003,78.1414
第15任總統副總統,在彰化縣各村(里),彰化縣,　彰化市,中庄里,101,645,1067,1813,16,1829,1,1830,546,2376,76.9781
第15任總統副總統,在彰化縣各村(里),彰化縣,　彰化市,竹中里,61,526,673,1260,16,1276,0,1276,359,1635,78.0428
第15任總統副總統,在彰化縣各村(里),彰化縣,　彰化市,香山里,117,932,1449,2498,50,2548,0,2548,675,3223,79.0568
第15任總統副總統,在彰化縣各村(里),彰化縣,　彰化市,牛埔里,114,773,1369,2256,34,2290,0,2290,592,2882,79.4587
第15任總統副總統,在彰化縣各村(里),彰化縣,　彰化市,台鳳里,210,1428,1598,3236,49,3285,0,3285,978,4263,77.0584
第15任總統副總統,在彰化縣各村(里),彰化縣,　彰化市,國聖里,91,711,1084,1886,21,1907,0,1907,481,2388,79.8576
第15任總統副總統,在彰化縣各村(里),彰化縣,　彰化市,福山里,248,1920,2899,5067,54,5121,0,5121,1494,6615,77.4150
第15任總統副總統,在彰化縣各村(里),彰化縣,　彰化市,安溪里,80,592,767,1439,24,1463,0,1463,381,1844,79.3384
第15任總統副總統,在彰化縣各村(里),彰化縣,　彰化市,三村里,49,305,519,873,17,890,0,890,264,1154,77.1231
第15任總統副總統,在彰化縣各村(里),彰化縣,　彰化市,大竹里,134,967,1380,2481,23,2504,0,2504,683,3187,78.5692
第15任總統副總統,在彰化縣各村(里),彰化縣,　彰化市,田中里,38,245,410,693,10,703,0,703,183,886,79.3454
第15任總統副總統,在彰化縣各村(里),彰化縣,　彰化市,快官里,39,310,444,793,14,807,0,807,244,1051,76.7840
第15任總統副總統,在彰化縣各村(里),彰化縣,　彰化市,竹巷里,29,226,345,600,8,608,0,608,193,801,75.9051
第15任總統副總統,在彰化縣各村(里),彰化縣,　彰化市,福田里,44,344,574,962,17,979,0,979,246,1225,79.9184
第15任總統副總統,在彰化縣各村(里),彰化縣,　彰化市,石牌里,39,363,439,841,12,853,0,853,256,1109,76.9161
第15任總統副總統,在彰化縣各村(里),彰化縣,　鹿港鎮,大有里,40,230,543,813,10,823,0,823,269,1092,75.3663
第15任總統副總統,在彰化縣各村(里),彰化縣,　鹿港鎮,中興里,18,97,260,375,5,380,0,380,118,498,76.3052
第15任總統副總統,在彰化縣各村(里),彰化縣,　鹿港鎮,洛津里,38,178,409,625,9,634,0,634,198,832,76.2019
第15任總統副總統,在彰化縣各村(里),彰化縣,　鹿港鎮,順興里,27,240,394,661,7,668,0,668,234,902,74.0576
第15任總統副總統,在彰化縣各村(里),彰化縣,　鹿港鎮,埔崙里,146,1004,2451,3601,46,3647,0,3647,1187,4834,75.4448
第15任總統副總統,在彰化縣各村(里),彰化縣,　鹿港鎮,新宮里,21,173,456,650,9,659,0,659,189,848,77.7123
第15任總統副總統,在彰化縣各村(里),彰化縣,　鹿港鎮,玉順里,28,229,578,835,16,851,0,851,299,1150,74.0000
第15任總統副總統,在彰化縣各村(里),彰化縣,　鹿港鎮,東石里,138,874,2121,3133,47,3180,2,3182,1041,4223,75.3019
第15任總統副總統,在彰化縣各村(里),彰化縣,　鹿港鎮,郭厝里,11,120,248,379,4,383,0,383,138,521,73.5125
第15任總統副總統,在彰化縣各村(里),彰化縣,　鹿港鎮,永安里,134,1030,2002,3166,46,3212,0,3212,1084,4296,74.7672
第15任總統副總統,在彰化縣各村(里),彰化縣,　鹿港鎮,景福里,48,313,461,822,13,835,0,835,258,1093,76.3952
第15任總統副總統,在彰化縣各村(里),彰化縣,　鹿港鎮,泰興里,35,300,565,900,9,909,0,909,233,1142,79.5972
第15任總統副總統,在彰化縣各村(里),彰化縣,　鹿港鎮,長興里,1,69,126,196,4,200,0,200,75,275,72.7273
第15任總統副總統,在彰化縣各村(里),彰化縣,　鹿港鎮,興化里,16,134,251,401,5,406,0,406,156,562,72.2420
第15任總統副總統,在彰化縣各村(里),彰化縣,　鹿港鎮,龍山里,17,156,300,473,5,478,0,478,147,625,76.4800
第15任總統副總統,在彰化縣各村(里),彰化縣,　鹿港鎮,菜園里,31,154,515,700,12,712,0,712,180,892,79.8206
第15任總統副總統,在彰化縣各村(里),彰化縣,　鹿港鎮,街尾里,57,531,1044,1632,22,1654,0,1654,508,2162,76.5032
第15任總統副總統,在彰化縣各村(里),彰化縣,　鹿港鎮,詔安里,67,489,874,1430,30,1460,0,1460,518,1978,73.8119
第15任總統副總統,在彰化縣各村(里),彰化縣,　鹿港鎮,海埔里,119,750,1504,2373,46,2419,0,2419,1061,3480,69.5115
第15任總統副總統,在彰化縣各村(里),彰化縣,　鹿港鎮,洋厝里,71,542,1100,1713,26,1739,0,1739,621,2360,73.6864
第15任總統副總統,在彰化縣各村(里),彰化縣,　鹿港鎮,草中里,101,900,1229,2230,26,2256,0,2256,823,3079,73.2705
第15任總統副總統,在彰化縣各村(里),彰化縣,　鹿港鎮,頭南里,87,662,781,1530,32,1562,0,1562,542,2104,74.2395
第15任總統副總統,在彰化縣各村(里),彰化縣,　鹿港鎮,山崙里,95,734,1345,2174,31,2205,0,2205,756,2961,74.4681
第15任總統副總統,在彰化縣各村(里),彰化縣,　鹿港鎮,頂番里,153,1148,1414,2715,37,2752,0,2752,954,3706,74.2580
第15任總統副總統,在彰化縣各村(里),彰化縣,　鹿港鎮,頭崙里,82,719,987,1788,31,1819,0,1819,654,2473,73.5544
第15任總統副總統,在彰化縣各村(里),彰化縣,　鹿港鎮,溝墘里,147,1277,1586,3010,53,3063,0,3063,965,4028,76.0427
第15任總統副總統,在彰化縣各村(里),彰化縣,　鹿港鎮,廖厝里,154,1153,1629,2936,36,2972,0,2972,1006,3978,74.7109
第15任總統副總統,在彰化縣各村(里),彰化縣,　鹿港鎮,東崎里,182,1177,2269,3628,48,3676,0,3676,1339,5015,73.3001
第15任總統副總統,在彰化縣各村(里),彰化縣,　鹿港鎮,頂厝里,261,1789,3519,5569,66,5635,0,5635,1842,7477,75.3645
第15任總統副總統,在彰化縣各村(里),彰化縣,　和美鎮,竹營里,204,1659,2469,4332,68,4400,0,4400,1497,5897,74.6142
第15任總統副總統,在彰化縣各村(里),彰化縣,　和美鎮,和東里,152,1227,1817,3196,47,3243,0,3243,960,4203,77.1592
第15任總統副總統,在彰化縣各村(里),彰化縣,　和美鎮,和南里,13,131,165,309,5,314,0,314,86,400,78.5000
第15任總統副總統,在彰化縣各村(里),彰化縣,　和美鎮,和北里,73,487,724,1284,23,1307,0,1307,444,1751,74.6431
第15任總統副總統,在彰化縣各村(里),彰化縣,　和美鎮,和西里,114,934,1265,2313,26,2339,0,2339,775,3114,75.1124
第15任總統副總統,在彰化縣各村(里),彰化縣,　和美鎮,四張里,99,721,1153,1973,19,1992,0,1992,687,2679,74.3561
第15任總統副總統,在彰化縣各村(里),彰化縣,　和美鎮,頭前里,54,458,626,1138,15,1153,0,1153,461,1614,71.4374
第15任總統副總統,在彰化縣各村(里),彰化縣,　和美鎮,面前里,88,535,915,1538,18,1556,0,1556,532,2088,74.5211
第15任總統副總統,在彰化縣各村(里),彰化縣,　和美鎮,鎮平里,133,782,1203,2118,20,2138,0,2138,647,2785,76.7684
第15任總統副總統,在彰化縣各村(里),彰化縣,　和美鎮,大霞里,58,444,493,995,9,1004,0,1004,411,1415,70.9541
第15任總統副總統,在彰化縣各村(里),彰化縣,　和美鎮,源埤里,66,501,729,1296,16,1312,0,1312,486,1798,72.9700
第15任總統副總統,在彰化縣各村(里),彰化縣,　和美鎮,南佃里,76,592,948,1616,23,1639,0,1639,515,2154,76.0910
第15任總統副總統,在彰化縣各村(里),彰化縣,　和美鎮,雅溝里,52,308,557,917,14,931,0,931,369,1300,71.6154
第15任總統副總統,在彰化縣各村(里),彰化縣,　和美鎮,山犁里,174,1472,2134,3780,52,3832,0,3832,1184,5016,76.3955
第15任總統副總統,在彰化縣各村(里),彰化縣,　和美鎮,仁愛里,109,723,1073,1905,19,1924,0,1924,723,2647,72.6861
第15任總統副總統,在彰化縣各村(里),彰化縣,　和美鎮,嘉犁里,86,611,667,1364,8,1372,0,1372,485,1857,73.8826
第15任總統副總統,在彰化縣各村(里),彰化縣,　和美鎮,詔安里,55,558,795,1408,19,1427,0,1427,550,1977,72.1801
第15任總統副總統,在彰化縣各村(里),彰化縣,　和美鎮,鐵山里,110,746,1114,1970,24,1994,0,1994,588,2582,77.2270
第15任總統副總統,在彰化縣各村(里),彰化縣,　和美鎮,柑井里,138,890,1442,2470,39,2509,0,2509,857,3366,74.5395
第15任總統副總統,在彰化縣各村(里),彰化縣,　和美鎮,竹園里,31,209,437,677,12,689,0,689,174,863,79.8378
第15任總統副總統,在彰化縣各村(里),彰化縣,　和美鎮,新庄里,77,732,954,1763,31,1794,0,1794,558,2352,76.2755
第15任總統副總統,在彰化縣各村(里),彰化縣,　和美鎮,犁盛里,73,605,1020,1698,28,1726,0,1726,507,2233,77.2951
第15任總統副總統,在彰化縣各村(里),彰化縣,　和美鎮,中寮里,45,273,439,757,11,768,0,768,319,1087,70.6532
第15任總統副總統,在彰化縣各村(里),彰化縣,　和美鎮,中圍里,73,742,1219,2034,38,2072,1,2073,696,2769,74.8285
第15任總統副總統,在彰化縣各村(里),彰化縣,　和美鎮,糖友里,159,1293,1730,3182,34,3216,0,3216,924,4140,77.6812
第15任總統副總統,在彰化縣各村(里),彰化縣,　和美鎮,還社里,25,240,340,605,9,614,0,614,213,827,74.2443
第15任總統副總統,在彰化縣各村(里),彰化縣,　和美鎮,塗厝里,56,501,652,1209,22,1231,0,1231,447,1678,73.3611
第15任總統副總統,在彰化縣各村(里),彰化縣,　和美鎮,地潭里,28,267,296,591,11,602,0,602,238,840,71.6667
第15任總統副總統,在彰化縣各村(里),彰化縣,　和美鎮,湖內里,35,249,608,892,5,897,0,897,294,1191,75.3149
第15任總統副總統,在彰化縣各村(里),彰化縣,　和美鎮,嘉寶里,70,500,820,1390,19,1409,0,1409,557,1966,71.6684
第15任總統副總統,在彰化縣各村(里),彰化縣,　和美鎮,月眉里,113,751,1303,2167,28,2195,0,2195,765,2960,74.1554
第15任總統副總統,在彰化縣各村(里),彰化縣,　和美鎮,好修里,43,394,693,1130,13,1143,0,1143,429,1572,72.7099
第15任總統副總統,在彰化縣各村(里),彰化縣,　線西鄉,線西村,82,697,810,1589,25,1614,0,1614,538,2152,75.0000
第15任總統副總統,在彰化縣各村(里),彰化縣,　線西鄉,頂庄村,59,426,388,873,14,887,0,887,332,1219,72.7646
第15任總統副總統,在彰化縣各村(里),彰化縣,　線西鄉,寓埔村,87,672,843,1602,23,1625,0,1625,596,2221,73.1652
第15任總統副總統,在彰化縣各村(里),彰化縣,　線西鄉,塭仔村,63,349,510,922,11,933,0,933,301,1234,75.6078
第15任總統副總統,在彰化縣各村(里),彰化縣,　線西鄉,溝內村,51,327,426,804,11,815,0,815,327,1142,71.3660
第15任總統副總統,在彰化縣各村(里),彰化縣,　線西鄉,下犁村,66,524,801,1391,13,1404,0,1404,471,1875,74.8800
第15任總統副總統,在彰化縣各村(里),彰化縣,　線西鄉,頂犁村,105,742,907,1754,33,1787,0,1787,693,2480,72.0565
第15任總統副總統,在彰化縣各村(里),彰化縣,　線西鄉,德興村,64,422,503,989,19,1008,0,1008,304,1312,76.8293
第15任總統副總統,在彰化縣各村(里),彰化縣,　伸港鄉,大同村,114,621,1020,1755,31,1786,0,1786,589,2375,75.2000
第15任總統副總統,在彰化縣各村(里),彰化縣,　伸港鄉,海尾村,55,510,759,1324,21,1345,0,1345,445,1790,75.1397
第15任總統副總統,在彰化縣各村(里),彰化縣,　伸港鄉,全興村,45,595,490,1130,21,1151,0,1151,480,1631,70.5702
第15任總統副總統,在彰化縣各村(里),彰化縣,　伸港鄉,溪底村,63,481,863,1407,21,1428,0,1428,486,1914,74.6082
第15任總統副總統,在彰化縣各村(里),彰化縣,　伸港鄉,定興村,92,731,1017,1840,40,1880,0,1880,694,2574,73.0381
第15任總統副總統,在彰化縣各村(里),彰化縣,　伸港鄉,什股村,81,670,740,1491,30,1521,0,1521,658,2179,69.8027
第15任總統副總統,在彰化縣各村(里),彰化縣,　伸港鄉,泉州村,84,607,739,1430,28,1458,0,1458,476,1934,75.3878
第15任總統副總統,在彰化縣各村(里),彰化縣,　伸港鄉,泉厝村,43,346,537,926,14,940,0,940,284,1224,76.7974
第15任總統副總統,在彰化縣各村(里),彰化縣,　伸港鄉,曾家村,48,422,700,1170,15,1185,0,1185,488,1673,70.8308
第15任總統副總統,在彰化縣各村(里),彰化縣,　伸港鄉,蚵寮村,18,213,579,810,8,818,0,818,282,1100,74.3636
第15任總統副總統,在彰化縣各村(里),彰化縣,　伸港鄉,新港村,167,1439,2078,3684,35,3719,0,3719,1287,5006,74.2909
第15任總統副總統,在彰化縣各村(里),彰化縣,　伸港鄉,埤墘村,45,364,622,1031,15,1046,0,1046,319,1365,76.6300
第15任總統副總統,在彰化縣各村(里),彰化縣,　伸港鄉,七嘉村,110,845,1177,2132,25,2157,0,2157,745,2902,74.3280
第15任總統副總統,在彰化縣各村(里),彰化縣,　伸港鄉,汴頭村,74,647,886,1607,21,1628,1,1629,532,2161,75.3355
第15任總統副總統,在彰化縣各村(里),彰化縣,　福興鄉,三汴村,46,302,674,1022,11,1033,0,1033,288,1321,78.1983
第15任總統副總統,在彰化縣各村(里),彰化縣,　福興鄉,萬豐村,27,204,378,609,10,619,0,619,184,803,77.0859
第15任總統副總統,在彰化縣各村(里),彰化縣,　福興鄉,元中村,37,312,536,885,14,899,0,899,323,1222,73.5679
第15任總統副總統,在彰化縣各村(里),彰化縣,　福興鄉,外中村,40,243,569,852,12,864,0,864,260,1124,76.8683
第15任總統副總統,在彰化縣各村(里),彰化縣,　福興鄉,外埔村,56,307,686,1049,14,1063,0,1063,405,1468,72.4114
第15任總統副總統,在彰化縣各村(里),彰化縣,　福興鄉,大崙村,41,281,557,879,15,894,0,894,314,1208,74.0066
第15任總統副總統,在彰化縣各村(里),彰化縣,　福興鄉,番婆村,81,596,971,1648,24,1672,0,1672,701,2373,70.4593
第15任總統副總統,在彰化縣各村(里),彰化縣,　福興鄉,橋頭村,77,640,1160,1877,32,1909,0,1909,698,2607,73.2259
第15任總統副總統,在彰化縣各村(里),彰化縣,　福興鄉,社尾村,46,337,660,1043,14,1057,0,1057,359,1416,74.6469
第15任總統副總統,在彰化縣各村(里),彰化縣,　福興鄉,番社村,29,249,788,1066,13,1079,0,1079,355,1434,75.2441
第15任總統副總統,在彰化縣各村(里),彰化縣,　福興鄉,西勢村,60,489,835,1384,22,1406,0,1406,491,1897,74.1170
第15任總統副總統,在彰化縣各村(里),彰化縣,　福興鄉,同安村,72,547,1032,1651,16,1667,0,1667,647,2314,72.0398
第15任總統副總統,在彰化縣各村(里),彰化縣,　福興鄉,秀厝村,79,592,1149,1820,18,1838,0,1838,600,2438,75.3897
第15任總統副總統,在彰化縣各村(里),彰化縣,　福興鄉,福興村,129,838,1626,2593,32,2625,0,2625,949,3574,73.4471
第15任總統副總統,在彰化縣各村(里),彰化縣,　福興鄉,福南村,78,598,1013,1689,20,1709,0,1709,774,2483,68.8280
第15任總統副總統,在彰化縣各村(里),彰化縣,　福興鄉,鎮平村,37,320,437,794,8,802,0,802,338,1140,70.3509
第15任總統副總統,在彰化縣各村(里),彰化縣,　福興鄉,三和村,23,188,568,779,10,789,0,789,238,1027,76.8257
第15任總統副總統,在彰化縣各村(里),彰化縣,　福興鄉,二港村,32,367,509,908,10,918,0,918,339,1257,73.0310
第15任總統副總統,在彰化縣各村(里),彰化縣,　福興鄉,福寶村,35,336,454,825,17,842,0,842,407,1249,67.4139
第15任總統副總統,在彰化縣各村(里),彰化縣,　福興鄉,頂粘村,70,657,874,1601,23,1624,0,1624,614,2238,72.5648
第15任總統副總統,在彰化縣各村(里),彰化縣,　福興鄉,廈粘村,69,509,738,1316,9,1325,0,1325,535,1860,71.2366
第15任總統副總統,在彰化縣各村(里),彰化縣,　福興鄉,麥厝村,52,456,967,1475,23,1498,0,1498,650,2148,69.7393
第15任總統副總統,在彰化縣各村(里),彰化縣,　秀水鄉,秀水村,48,403,766,1217,12,1229,0,1229,400,1629,75.4451
第15任總統副總統,在彰化縣各村(里),彰化縣,　秀水鄉,安溪村,55,518,944,1517,17,1534,0,1534,468,2002,76.6234
第15任總統副總統,在彰化縣各村(里),彰化縣,　秀水鄉,莊雅村,77,774,1131,1982,24,2006,0,2006,553,2559,78.3900
第15任總統副總統,在彰化縣各村(里),彰化縣,　秀水鄉,陝西村,47,399,577,1023,11,1034,0,1034,342,1376,75.1453
第15任總統副總統,在彰化縣各村(里),彰化縣,　秀水鄉,金興村,51,556,780,1387,15,1402,0,1402,413,1815,77.2452
第15任總統副總統,在彰化縣各村(里),彰化縣,　秀水鄉,安東村,108,1071,1648,2827,30,2857,0,2857,901,3758,76.0245
第15任總統副總統,在彰化縣各村(里),彰化縣,　秀水鄉,鶴鳴村,124,801,1414,2339,29,2368,0,2368,737,3105,76.2641
第15任總統副總統,在彰化縣各村(里),彰化縣,　秀水鄉,馬興村,82,585,1013,1680,24,1704,0,1704,532,2236,76.2075
第15任總統副總統,在彰化縣各村(里),彰化縣,　秀水鄉,義興村,46,374,557,977,15,992,0,992,392,1384,71.6763
第15任總統副總統,在彰化縣各村(里),彰化縣,　秀水鄉,福安村,163,1209,1874,3246,55,3301,0,3301,1036,4337,76.1125
第15任總統副總統,在彰化縣各村(里),彰化縣,　秀水鄉,埔崙村,79,522,866,1467,21,1488,0,1488,387,1875,79.3600
第15任總統副總統,在彰化縣各村(里),彰化縣,　秀水鄉,曾厝村,53,459,744,1256,8,1264,0,1264,374,1638,77.1673
第15任總統副總統,在彰化縣各村(里),彰化縣,　秀水鄉,金陵村,55,393,806,1254,16,1270,0,1270,384,1654,76.7836
第15任總統副總統,在彰化縣各村(里),彰化縣,　秀水鄉,下崙村,68,495,969,1532,27,1559,0,1559,480,2039,76.4590
第15任總統副總統,在彰化縣各村(里),彰化縣,　花壇鄉,花壇村,109,909,1370,2388,35,2423,0,2423,698,3121,77.6354
第15任總統副總統,在彰化縣各村(里),彰化縣,　花壇鄉,金墩村,54,519,764,1337,17,1354,0,1354,401,1755,77.1510
第15任總統副總統,在彰化縣各村(里),彰化縣,　花壇鄉,中庄村,77,775,895,1747,17,1764,0,1764,535,2299,76.7290
第15任總統副總統,在彰化縣各村(里),彰化縣,　花壇鄉,崙雅村,52,350,627,1029,19,1048,0,1048,336,1384,75.7225
第15任總統副總統,在彰化縣各村(里),彰化縣,　花壇鄉,劉厝村,37,269,537,843,16,859,0,859,197,1056,81.3447
第15任總統副總統,在彰化縣各村(里),彰化縣,　花壇鄉,南口村,51,594,785,1430,24,1454,0,1454,409,1863,78.0462
第15任總統副總統,在彰化縣各村(里),彰化縣,　花壇鄉,北口村,57,483,775,1315,20,1335,0,1335,430,1765,75.6374
第15任總統副總統,在彰化縣各村(里),彰化縣,　花壇鄉,中口村,19,207,320,546,8,554,0,554,194,748,74.0642
第15任總統副總統,在彰化縣各村(里),彰化縣,　花壇鄉,文德村,124,850,1248,2222,30,2252,0,2252,728,2980,75.5705
第15任總統副總統,在彰化縣各村(里),彰化縣,　花壇鄉,白沙村,161,1431,1771,3363,40,3403,0,3403,1071,4474,76.0617
第15任總統副總統,在彰化縣各村(里),彰化縣,　花壇鄉,岩竹村,44,372,541,957,15,972,0,972,319,1291,75.2905
第15任總統副總統,在彰化縣各村(里),彰化縣,　花壇鄉,長沙村,156,1482,1945,3583,48,3631,1,3632,1091,4723,76.8791
第15任總統副總統,在彰化縣各村(里),彰化縣,　花壇鄉,橋頭村,142,974,1247,2363,27,2390,0,2390,812,3202,74.6408
第15任總統副總統,在彰化縣各村(里),彰化縣,　花壇鄉,灣雅村,41,306,327,674,6,680,0,680,203,883,77.0102
第15任總統副總統,在彰化縣各村(里),彰化縣,　花壇鄉,灣東村,36,279,366,681,4,685,0,685,234,919,74.5375
第15任總統副總統,在彰化縣各村(里),彰化縣,　花壇鄉,三春村,59,559,754,1372,12,1384,0,1384,475,1859,74.4486
第15任總統副總統,在彰化縣各村(里),彰化縣,　花壇鄉,永春村,77,595,653,1325,12,1337,0,1337,533,1870,71.4973
第15任總統副總統,在彰化縣各村(里),彰化縣,　花壇鄉,長春村,56,474,599,1129,16,1145,0,1145,423,1568,73.0230
第15任總統副總統,在彰化縣各村(里),彰化縣,　芬園鄉,舊社村,58,457,716,1231,19,1250,0,1250,458,1708,73.1850
第15任總統副總統,在彰化縣各村(里),彰化縣,　芬園鄉,大埔村,61,411,579,1051,19,1070,0,1070,302,1372,77.9883
第15任總統副總統,在彰化縣各村(里),彰化縣,　芬園鄉,竹林村,70,493,755,1318,16,1334,0,1334,373,1707,78.1488
第15任總統副總統,在彰化縣各村(里),彰化縣,　芬園鄉,楓坑村,25,157,239,421,5,426,0,426,134,560,76.0714
第15任總統副總統,在彰化縣各村(里),彰化縣,　芬園鄉,社口村,79,703,996,1778,26,1804,0,1804,597,2401,75.1354
第15任總統副總統,在彰化縣各村(里),彰化縣,　芬園鄉,茄荖村,75,614,1025,1714,18,1732,0,1732,557,2289,75.6662
第15任總統副總統,在彰化縣各村(里),彰化縣,　芬園鄉,嘉興村,63,474,676,1213,20,1233,0,1233,363,1596,77.2556
第15任總統副總統,在彰化縣各村(里),彰化縣,　芬園鄉,芬園村,30,230,389,649,5,654,0,654,193,847,77.2137
第15任總統副總統,在彰化縣各村(里),彰化縣,　芬園鄉,縣庄村,44,255,536,835,10,845,0,845,258,1103,76.6092
第15任總統副總統,在彰化縣各村(里),彰化縣,　芬園鄉,圳墘村,17,162,296,475,10,485,0,485,163,648,74.8457
第15任總統副總統,在彰化縣各村(里),彰化縣,　芬園鄉,溪頭村,45,402,788,1235,22,1257,0,1257,372,1629,77.1639
第15任總統副總統,在彰化縣各村(里),彰化縣,　芬園鄉,進芬村,32,279,379,690,10,700,0,700,244,944,74.1525
第15任總統副總統,在彰化縣各村(里),彰化縣,　芬園鄉,同安村,20,271,547,838,13,851,0,851,291,1142,74.5184
第15任總統副總統,在彰化縣各村(里),彰化縣,　芬園鄉,中崙村,27,202,360,589,7,596,0,596,242,838,71.1217
第15任總統副總統,在彰化縣各村(里),彰化縣,　芬園鄉,大竹村,36,194,482,712,8,720,0,720,234,954,75.4717
第15任總統副總統,在彰化縣各村(里),彰化縣,　員林市,崙雅里,68,780,876,1724,19,1743,0,1743,589,2332,74.7427
第15任總統副總統,在彰化縣各村(里),彰化縣,　員林市,振興里,93,792,1028,1913,25,1938,0,1938,667,2605,74.3954
第15任總統副總統,在彰化縣各村(里),彰化縣,　員林市,林厝里,103,695,1147,1945,21,1966,0,1966,710,2676,73.4679
第15任總統副總統,在彰化縣各村(里),彰化縣,　員林市,出水里,49,382,722,1153,8,1161,0,1161,436,1597,72.6988
第15任總統副總統,在彰化縣各村(里),彰化縣,　員林市,湖水里,36,259,525,820,19,839,0,839,302,1141,73.5320
第15任總統副總統,在彰化縣各村(里),彰化縣,　員林市,大峯里,15,266,235,516,5,521,0,521,163,684,76.1696
第15任總統副總統,在彰化縣各村(里),彰化縣,　員林市,鎮興里,47,521,837,1405,26,1431,0,1431,512,1943,73.6490
第15任總統副總統,在彰化縣各村(里),彰化縣,　員林市,浮圳里,74,609,893,1576,27,1603,0,1603,526,2129,75.2936
第15任總統副總統,在彰化縣各村(里),彰化縣,　員林市,西東里,64,430,859,1353,23,1376,0,1376,531,1907,72.1552
第15任總統副總統,在彰化縣各村(里),彰化縣,　員林市,南東里,49,470,733,1252,22,1274,0,1274,443,1717,74.1992
第15任總統副總統,在彰化縣各村(里),彰化縣,　員林市,中東里,63,497,673,1233,17,1250,0,1250,464,1714,72.9288
第15任總統副總統,在彰化縣各村(里),彰化縣,　員林市,東北里,62,609,941,1612,20,1632,0,1632,607,2239,72.8897
第15任總統副總統,在彰化縣各村(里),彰化縣,　員林市,東和里,32,342,410,784,10,794,0,794,245,1039,76.4196
第15任總統副總統,在彰化縣各村(里),彰化縣,　員林市,民生里,91,809,1074,1974,24,1998,0,1998,690,2688,74.3304
第15任總統副總統,在彰化縣各村(里),彰化縣,　員林市,黎明里,63,492,751,1306,15,1321,0,1321,487,1808,73.0642
第15任總統副總統,在彰化縣各村(里),彰化縣,　員林市,惠來里,176,1586,2403,4165,51,4216,0,4216,1294,5510,76.5154
第15任總統副總統,在彰化縣各村(里),彰化縣,　員林市,中央里,56,536,822,1414,13,1427,0,1427,448,1875,76.1067
第15任總統副總統,在彰化縣各村(里),彰化縣,　員林市,溝皂里,98,698,1018,1814,14,1828,0,1828,493,2321,78.7592
第15任總統副總統,在彰化縣各村(里),彰化縣,　員林市,大饒里,103,973,1269,2345,25,2370,0,2370,782,3152,75.1904
第15任總統副總統,在彰化縣各村(里),彰化縣,　員林市,大明里,71,622,1058,1751,14,1765,0,1765,591,2356,74.9151
第15任總統副總統,在彰化縣各村(里),彰化縣,　員林市,萬年里,116,1130,1436,2682,34,2716,0,2716,818,3534,76.8534
第15任總統副總統,在彰化縣各村(里),彰化縣,　員林市,中正里,114,969,1206,2289,29,2318,0,2318,756,3074,75.4066
第15任總統副總統,在彰化縣各村(里),彰化縣,　員林市,仁美里,68,793,1026,1887,21,1908,0,1908,585,2493,76.5343
第15任總統副總統,在彰化縣各村(里),彰化縣,　員林市,新興里,20,205,313,538,8,546,0,546,155,701,77.8887
第15任總統副總統,在彰化縣各村(里),彰化縣,　員林市,和平里,87,862,1102,2051,21,2072,0,2072,667,2739,75.6480
第15任總統副總統,在彰化縣各村(里),彰化縣,　員林市,光明里,28,252,355,635,3,638,0,638,144,782,81.5857
第15任總統副總統,在彰化縣各村(里),彰化縣,　員林市,中山里,18,197,242,457,5,462,0,462,110,572,80.7692
第15任總統副總統,在彰化縣各村(里),彰化縣,　員林市,三條里,94,756,1116,1966,28,1994,0,1994,624,2618,76.1650
第15任總統副總統,在彰化縣各村(里),彰化縣,　員林市,忠孝里,76,639,880,1595,18,1613,0,1613,514,2127,75.8345
第15任總統副總統,在彰化縣各村(里),彰化縣,　員林市,仁愛里,55,402,583,1040,13,1053,0,1053,264,1317,79.9544
第15任總統副總統,在彰化縣各村(里),彰化縣,　員林市,三和里,190,1736,2394,4320,58,4378,0,4378,1625,6003,72.9302
第15任總統副總統,在彰化縣各村(里),彰化縣,　員林市,三橋里,123,821,1174,2118,27,2145,0,2145,650,2795,76.7442
第15任總統副總統,在彰化縣各村(里),彰化縣,　員林市,三愛里,86,872,1207,2165,17,2182,0,2182,624,2806,77.7619
第15任總統副總統,在彰化縣各村(里),彰化縣,　員林市,三信里,66,761,902,1729,22,1751,0,1751,474,2225,78.6966
第15任總統副總統,在彰化縣各村(里),彰化縣,　員林市,三多里,100,725,1067,1892,20,1912,0,1912,488,2400,79.6667
第15任總統副總統,在彰化縣各村(里),彰化縣,　員林市,三義里,87,730,999,1816,30,1846,0,1846,631,2477,74.5256
第15任總統副總統,在彰化縣各村(里),彰化縣,　員林市,新生里,141,1188,1735,3064,43,3107,0,3107,918,4025,77.1925
第15任總統副總統,在彰化縣各村(里),彰化縣,　員林市,南平里,159,1507,2208,3874,39,3913,0,3913,1123,5036,77.7006
第15任總統副總統,在彰化縣各村(里),彰化縣,　員林市,南興里,153,1384,1770,3307,46,3353,0,3353,1101,4454,75.2806
第15任總統副總統,在彰化縣各村(里),彰化縣,　員林市,源潭里,65,413,749,1227,17,1244,0,1244,407,1651,75.3483
第15任總統副總統,在彰化縣各村(里),彰化縣,　員林市,大埔里,78,579,884,1541,24,1565,0,1565,536,2101,74.4883
第15任總統副總統,在彰化縣各村(里),彰化縣,　溪湖鎮,光平里,41,361,493,895,7,902,0,902,280,1182,76.3113
第15任總統副總統,在彰化縣各村(里),彰化縣,　溪湖鎮,平和里,18,208,274,500,8,508,0,508,97,605,83.9669
第15任總統副總統,在彰化縣各村(里),彰化縣,　溪湖鎮,太平里,63,579,666,1308,13,1321,0,1321,430,1751,75.4426
第15任總統副總統,在彰化縣各村(里),彰化縣,　溪湖鎮,光華里,19,150,154,323,7,330,0,330,83,413,79.9031
第15任總統副總統,在彰化縣各村(里),彰化縣,　溪湖鎮,湖東里,134,1268,1914,3316,49,3365,0,3365,1162,4527,74.3318
第15任總統副總統,在彰化縣各村(里),彰化縣,　溪湖鎮,中山里,74,653,892,1619,14,1633,0,1633,610,2243,72.8043
第15任總統副總統,在彰化縣各村(里),彰化縣,　溪湖鎮,西溪里,69,506,730,1305,11,1316,0,1316,462,1778,74.0157
第15任總統副總統,在彰化縣各村(里),彰化縣,　溪湖鎮,中竹里,25,218,380,623,6,629,0,629,188,817,76.9890
第15任總統副總統,在彰化縣各村(里),彰化縣,　溪湖鎮,東寮里,118,986,1206,2310,26,2336,0,2336,882,3218,72.5917
第15任總統副總統,在彰化縣各村(里),彰化縣,　溪湖鎮,西寮里,65,663,834,1562,26,1588,0,1588,522,2110,75.2607
第15任總統副總統,在彰化縣各村(里),彰化縣,　溪湖鎮,大突里,108,1058,1256,2422,32,2454,0,2454,827,3281,74.7943
第15任總統副總統,在彰化縣各村(里),彰化縣,　溪湖鎮,北勢里,46,363,594,1003,10,1013,0,1013,360,1373,73.7800
第15任總統副總統,在彰化縣各村(里),彰化縣,　溪湖鎮,汴頭里,76,840,1221,2137,30,2167,0,2167,745,2912,74.4162
第15任總統副總統,在彰化縣各村(里),彰化縣,　溪湖鎮,大竹里,78,761,939,1778,22,1800,0,1800,633,2433,73.9827
第15任總統副總統,在彰化縣各村(里),彰化縣,　溪湖鎮,湖西里,66,705,864,1635,14,1649,0,1649,560,2209,74.6492
第15任總統副總統,在彰化縣各村(里),彰化縣,　溪湖鎮,田中里,20,217,358,595,10,605,0,605,198,803,75.3425
第15任總統副總統,在彰化縣各村(里),彰化縣,　溪湖鎮,河東里,60,508,717,1285,18,1303,0,1303,472,1775,73.4085
第15任總統副總統,在彰化縣各村(里),彰化縣,　溪湖鎮,頂庄里,29,185,248,462,5,467,0,467,158,625,74.7200
第15任總統副總統,在彰化縣各村(里),彰化縣,　溪湖鎮,忠覺里,35,379,485,899,17,916,0,916,312,1228,74.5928
第15任總統副總統,在彰化縣各村(里),彰化縣,　溪湖鎮,湳底里,25,200,292,517,5,522,0,522,162,684,76.3158
第15任總統副總統,在彰化縣各村(里),彰化縣,　溪湖鎮,大庭里,36,427,515,978,18,996,0,996,349,1345,74.0520
第15任總統副總統,在彰化縣各村(里),彰化縣,　溪湖鎮,媽厝里,23,283,519,825,15,840,0,840,367,1207,69.5940
第15任總統副總統,在彰化縣各村(里),彰化縣,　溪湖鎮,番婆里,67,469,678,1214,24,1238,0,1238,463,1701,72.7807
第15任總統副總統,在彰化縣各村(里),彰化縣,　溪湖鎮,西勢里,83,524,909,1516,21,1537,0,1537,601,2138,71.8896
第15任總統副總統,在彰化縣各村(里),彰化縣,　溪湖鎮,東溪里,56,284,652,992,11,1003,0,1003,337,1340,74.8507
第15任總統副總統,在彰化縣各村(里),彰化縣,　田中鎮,香山里,11,217,350,578,4,582,0,582,248,830,70.1205
第15任總統副總統,在彰化縣各村(里),彰化縣,　田中鎮,碧峰里,20,337,336,693,21,714,0,714,359,1073,66.5424
第15任總統副總統,在彰化縣各村(里),彰化縣,　田中鎮,東源里,24,222,291,537,4,541,0,541,208,749,72.2296
第15任總統副總統,在彰化縣各村(里),彰化縣,　田中鎮,復興里,44,478,527,1049,17,1066,0,1066,439,1505,70.8306
第15任總統副總統,在彰化縣各村(里),彰化縣,　田中鎮,平和里,49,440,533,1022,16,1038,0,1038,411,1449,71.6356
第15任總統副總統,在彰化縣各村(里),彰化縣,　田中鎮,頂潭里,21,365,535,921,11,932,0,932,310,1242,75.0403
第15任總統副總統,在彰化縣各村(里),彰化縣,　田中鎮,新庄里,57,717,957,1731,10,1741,0,1741,575,2316,75.1727
第15任總統副總統,在彰化縣各村(里),彰化縣,　田中鎮,中潭里,50,488,733,1271,21,1292,0,1292,426,1718,75.2037
第15任總統副總統,在彰化縣各村(里),彰化縣,　田中鎮,龍潭里,17,147,272,436,2,438,0,438,143,581,75.3873
第15任總統副總統,在彰化縣各村(里),彰化縣,　田中鎮,北路里,92,1080,1273,2445,16,2461,0,2461,770,3231,76.1684
第15任總統副總統,在彰化縣各村(里),彰化縣,　田中鎮,西路里,65,680,991,1736,23,1759,0,1759,573,2332,75.4288
第15任總統副總統,在彰化縣各村(里),彰化縣,　田中鎮,東路里,32,290,454,776,10,786,0,786,260,1046,75.1434
第15任總統副總統,在彰化縣各村(里),彰化縣,　田中鎮,南路里,33,334,472,839,7,846,0,846,254,1100,76.9091
第15任總統副總統,在彰化縣各村(里),彰化縣,　田中鎮,中路里,56,630,731,1417,19,1436,0,1436,481,1917,74.9087
第15任總統副總統,在彰化縣各村(里),彰化縣,　田中鎮,梅州里,32,310,566,908,18,926,0,926,311,1237,74.8585
第15任總統副總統,在彰化縣各村(里),彰化縣,　田中鎮,三安里,34,416,678,1128,16,1144,0,1144,414,1558,73.4275
第15任總統副總統,在彰化縣各村(里),彰化縣,　田中鎮,大崙里,38,347,527,912,11,923,0,923,380,1303,70.8365
第15任總統副總統,在彰化縣各村(里),彰化縣,　田中鎮,沙崙里,55,421,734,1210,11,1221,0,1221,512,1733,70.4559
第15任總統副總統,在彰化縣各村(里),彰化縣,　田中鎮,新民里,135,1197,1720,3052,28,3080,0,3080,974,4054,75.9743
第15任總統副總統,在彰化縣各村(里),彰化縣,　田中鎮,三民里,44,466,574,1084,14,1098,0,1098,425,1523,72.0946
第15任總統副總統,在彰化縣各村(里),彰化縣,　田中鎮,三光里,38,248,384,670,6,676,0,676,244,920,73.4783
第15任總統副總統,在彰化縣各村(里),彰化縣,　田中鎮,大社里,35,214,395,644,6,650,0,650,227,877,74.1163
第15任總統副總統,在彰化縣各村(里),彰化縣,　大村鄉,大村村,112,904,1312,2328,30,2358,0,2358,748,3106,75.9176
第15任總統副總統,在彰化縣各村(里),彰化縣,　大村鄉,茄苳村,41,426,664,1131,18,1149,0,1149,340,1489,77.1659
第15任總統副總統,在彰化縣各村(里),彰化縣,　大村鄉,田洋村,29,312,461,802,7,809,0,809,282,1091,74.1522
第15任總統副總統,在彰化縣各村(里),彰化縣,　大村鄉,貢旗村,51,398,663,1112,10,1122,0,1122,350,1472,76.2228
第15任總統副總統,在彰化縣各村(里),彰化縣,　大村鄉,南勢村,38,371,677,1086,6,1092,0,1092,322,1414,77.2277
第15任總統副總統,在彰化縣各村(里),彰化縣,　大村鄉,大橋村,55,629,771,1455,17,1472,0,1472,477,1949,75.5259
第15任總統副總統,在彰化縣各村(里),彰化縣,　大村鄉,加錫村,54,374,649,1077,14,1091,0,1091,337,1428,76.4006
第15任總統副總統,在彰化縣各村(里),彰化縣,　大村鄉,大崙村,45,364,704,1113,13,1126,0,1126,429,1555,72.4116
第15任總統副總統,在彰化縣各村(里),彰化縣,　大村鄉,新興村,45,267,505,817,8,825,0,825,290,1115,73.9910
第15任總統副總統,在彰化縣各村(里),彰化縣,　大村鄉,擺塘村,75,620,1107,1802,14,1816,0,1816,627,2443,74.3348
第15任總統副總統,在彰化縣各村(里),彰化縣,　大村鄉,過溝村,113,911,1120,2144,18,2162,0,2162,629,2791,77.4633
第15任總統副總統,在彰化縣各村(里),彰化縣,　大村鄉,村上村,43,419,569,1031,9,1040,0,1040,335,1375,75.6364
第15任總統副總統,在彰化縣各村(里),彰化縣,　大村鄉,美港村,98,810,1250,2158,26,2184,0,2184,745,2929,74.5647
第15任總統副總統,在彰化縣各村(里),彰化縣,　大村鄉,黃厝村,81,589,931,1601,16,1617,0,1617,637,2254,71.7391
第15任總統副總統,在彰化縣各村(里),彰化縣,　大村鄉,福興村,75,502,882,1459,15,1474,0,1474,558,2032,72.5394
第15任總統副總統,在彰化縣各村(里),彰化縣,　大村鄉,平和村,73,602,1055,1730,28,1758,0,1758,663,2421,72.6146
第15任總統副總統,在彰化縣各村(里),彰化縣,　埔鹽鄉,埔鹽村,66,529,651,1246,14,1260,0,1260,399,1659,75.9494
第15任總統副總統,在彰化縣各村(里),彰化縣,　埔鹽鄉,埔南村,50,491,605,1146,10,1156,0,1156,366,1522,75.9527
第15任總統副總統,在彰化縣各村(里),彰化縣,　埔鹽鄉,廍子村,46,471,423,940,16,956,0,956,284,1240,77.0968
第15任總統副總統,在彰化縣各村(里),彰化縣,　埔鹽鄉,出水村,35,307,326,668,12,680,0,680,201,881,77.1850
第15任總統副總統,在彰化縣各村(里),彰化縣,　埔鹽鄉,南港村,66,519,652,1237,18,1255,0,1255,406,1661,75.5569
第15任總統副總統,在彰化縣各村(里),彰化縣,　埔鹽鄉,打廉村,46,229,387,662,18,680,0,680,242,922,73.7527
第15任總統副總統,在彰化縣各村(里),彰化縣,　埔鹽鄉,豐澤村,51,396,481,928,17,945,0,945,360,1305,72.4138
第15任總統副總統,在彰化縣各村(里),彰化縣,　埔鹽鄉,崑崙村,31,331,428,790,14,804,0,804,269,1073,74.9301
第15任總統副總統,在彰化縣各村(里),彰化縣,　埔鹽鄉,角樹村,25,228,264,517,2,519,0,519,142,661,78.5174
第15任總統副總統,在彰化縣各村(里),彰化縣,　埔鹽鄉,瓦磘村,49,368,461,878,8,886,0,886,306,1192,74.3289
第15任總統副總統,在彰化縣各村(里),彰化縣,　埔鹽鄉,好修村,68,544,585,1197,10,1207,0,1207,493,1700,71.0000
第15任總統副總統,在彰化縣各村(里),彰化縣,　埔鹽鄉,西湖村,59,645,720,1424,25,1449,0,1449,551,2000,72.4500
第15任總統副總統,在彰化縣各村(里),彰化縣,　埔鹽鄉,大有村,49,299,510,858,11,869,0,869,310,1179,73.7065
第15任總統副總統,在彰化縣各村(里),彰化縣,　埔鹽鄉,新興村,13,181,116,310,4,314,0,314,98,412,76.2136
第15任總統副總統,在彰化縣各村(里),彰化縣,　埔鹽鄉,永平村,23,342,394,759,12,771,0,771,300,1071,71.9888
第15任總統副總統,在彰化縣各村(里),彰化縣,　埔鹽鄉,永樂村,30,251,330,611,11,622,0,622,218,840,74.0476
第15任總統副總統,在彰化縣各村(里),彰化縣,　埔鹽鄉,石埤村,41,332,627,1000,16,1016,0,1016,396,1412,71.9547
第15任總統副總統,在彰化縣各村(里),彰化縣,　埔鹽鄉,天盛村,24,301,293,618,5,623,0,623,203,826,75.4237
第15任總統副總統,在彰化縣各村(里),彰化縣,　埔鹽鄉,太平村,45,481,531,1057,9,1066,0,1066,397,1463,72.8640
第15任總統副總統,在彰化縣各村(里),彰化縣,　埔鹽鄉,新水村,46,597,439,1082,12,1094,0,1094,398,1492,73.3244
第15任總統副總統,在彰化縣各村(里),彰化縣,　埔鹽鄉,三省村,40,451,473,964,14,978,0,978,365,1343,72.8220
第15任總統副總統,在彰化縣各村(里),彰化縣,　埔鹽鄉,南新村,45,475,439,959,12,971,0,971,334,1305,74.4061
第15任總統副總統,在彰化縣各村(里),彰化縣,　埔心鄉,東門村,108,1009,1551,2668,37,2705,0,2705,812,3517,76.9121
第15任總統副總統,在彰化縣各村(里),彰化縣,　埔心鄉,埔心村,48,306,541,895,8,903,0,903,300,1203,75.0623
第15任總統副總統,在彰化縣各村(里),彰化縣,　埔心鄉,義民村,50,451,650,1151,11,1162,0,1162,344,1506,77.1580
第15任總統副總統,在彰化縣各村(里),彰化縣,　埔心鄉,油車村,34,377,518,929,8,937,0,937,280,1217,76.9926
第15任總統副總統,在彰化縣各村(里),彰化縣,　埔心鄉,瓦北村,50,418,798,1266,14,1280,0,1280,427,1707,74.9854
第15任總統副總統,在彰化縣各村(里),彰化縣,　埔心鄉,瓦中村,83,453,883,1419,24,1443,0,1443,507,1950,74.0000
第15任總統副總統,在彰化縣各村(里),彰化縣,　埔心鄉,瓦南村,51,345,668,1064,7,1071,0,1071,325,1396,76.7192
第15任總統副總統,在彰化縣各村(里),彰化縣,　埔心鄉,經口村,97,526,1057,1680,23,1703,0,1703,566,2269,75.0551
第15任總統副總統,在彰化縣各村(里),彰化縣,　埔心鄉,太平村,79,501,841,1421,19,1440,0,1440,515,1955,73.6573
第15任總統副總統,在彰化縣各村(里),彰化縣,　埔心鄉,大華村,20,183,284,487,7,494,0,494,145,639,77.3083
第15任總統副總統,在彰化縣各村(里),彰化縣,　埔心鄉,仁里村,46,324,470,840,17,857,0,857,337,1194,71.7755
第15任總統副總統,在彰化縣各村(里),彰化縣,　埔心鄉,舊舘村,66,382,666,1114,10,1124,0,1124,366,1490,75.4362
第15任總統副總統,在彰化縣各村(里),彰化縣,　埔心鄉,南舘村,26,246,490,762,7,769,0,769,264,1033,74.4434
第15任總統副總統,在彰化縣各村(里),彰化縣,　埔心鄉,新舘村,40,226,388,654,9,663,0,663,276,939,70.6070
第15任總統副總統,在彰化縣各村(里),彰化縣,　埔心鄉,芎蕉村,64,417,844,1325,19,1344,0,1344,447,1791,75.0419
第15任總統副總統,在彰化縣各村(里),彰化縣,　埔心鄉,羅厝村,30,299,620,949,8,957,0,957,349,1306,73.2772
第15任總統副總統,在彰化縣各村(里),彰化縣,　埔心鄉,梧鳳村,31,205,411,647,7,654,0,654,233,887,73.7317
第15任總統副總統,在彰化縣各村(里),彰化縣,　埔心鄉,二重村,37,326,662,1025,16,1041,0,1041,336,1377,75.5991
第15任總統副總統,在彰化縣各村(里),彰化縣,　埔心鄉,埤霞村,20,204,307,531,7,538,0,538,194,732,73.4973
第15任總統副總統,在彰化縣各村(里),彰化縣,　埔心鄉,埤脚村,37,270,376,683,4,687,0,687,217,904,75.9956
第15任總統副總統,在彰化縣各村(里),彰化縣,　永靖鄉,浮圳村,40,327,471,838,15,853,0,853,341,1194,71.4405
第15任總統副總統,在彰化縣各村(里),彰化縣,　永靖鄉,東寧村,58,467,829,1354,16,1370,0,1370,503,1873,73.1447
第15任總統副總統,在彰化縣各村(里),彰化縣,　永靖鄉,光雲村,59,370,733,1162,8,1170,0,1170,415,1585,73.8170
第15任總統副總統,在彰化縣各村(里),彰化縣,　永靖鄉,五汴村,44,314,680,1038,12,1050,0,1050,324,1374,76.4192
第15任總統副總統,在彰化縣各村(里),彰化縣,　永靖鄉,永興村,45,459,641,1145,12,1157,0,1157,378,1535,75.3746
第15任總統副總統,在彰化縣各村(里),彰化縣,　永靖鄉,崙子村,38,327,601,966,17,983,0,983,372,1355,72.5461
第15任總統副總統,在彰化縣各村(里),彰化縣,　永靖鄉,永東村,23,250,325,598,4,602,0,602,172,774,77.7778
第15任總統副總統,在彰化縣各村(里),彰化縣,　永靖鄉,永西村,48,401,654,1103,15,1118,0,1118,336,1454,76.8913
第15任總統副總統,在彰化縣各村(里),彰化縣,　永靖鄉,永南村,65,522,778,1365,24,1389,0,1389,435,1824,76.1513
第15任總統副總統,在彰化縣各村(里),彰化縣,　永靖鄉,永北村,70,579,933,1582,19,1601,0,1601,464,2065,77.5303
第15任總統副總統,在彰化縣各村(里),彰化縣,　永靖鄉,港西村,56,436,751,1243,17,1260,0,1260,430,1690,74.5562
第15任總統副總統,在彰化縣各村(里),彰化縣,　永靖鄉,五福村,49,414,604,1067,4,1071,0,1071,337,1408,76.0653
第15任總統副總統,在彰化縣各村(里),彰化縣,　永靖鄉,湳港村,37,202,480,719,15,734,0,734,256,990,74.1414
第15任總統副總統,在彰化縣各村(里),彰化縣,　永靖鄉,新莊村,32,327,399,758,8,766,0,766,242,1008,75.9921
第15任總統副總統,在彰化縣各村(里),彰化縣,　永靖鄉,瑚璉村,92,743,1103,1938,25,1963,0,1963,574,2537,77.3749
第15任總統副總統,在彰化縣各村(里),彰化縣,　永靖鄉,獨鰲村,19,224,377,620,12,632,0,632,200,832,75.9615
第15任總統副總統,在彰化縣各村(里),彰化縣,　永靖鄉,敦厚村,32,228,309,569,13,582,0,582,107,689,84.4702
第15任總統副總統,在彰化縣各村(里),彰化縣,　永靖鄉,崙美村,17,186,359,562,7,569,0,569,168,737,77.2049
第15任總統副總統,在彰化縣各村(里),彰化縣,　永靖鄉,同安村,12,194,283,489,5,494,0,494,146,640,77.1875
第15任總統副總統,在彰化縣各村(里),彰化縣,　永靖鄉,同仁村,29,239,341,609,8,617,0,617,209,826,74.6973
第15任總統副總統,在彰化縣各村(里),彰化縣,　永靖鄉,湳墘村,29,225,342,596,14,610,0,610,201,811,75.2158
第15任總統副總統,在彰化縣各村(里),彰化縣,　永靖鄉,四芳村,19,197,273,489,8,497,0,497,143,640,77.6563
第15任總統副總統,在彰化縣各村(里),彰化縣,　永靖鄉,福興村,32,320,398,750,17,767,0,767,287,1054,72.7704
第15任總統副總統,在彰化縣各村(里),彰化縣,　永靖鄉,竹子村,31,266,642,939,8,947,0,947,343,1290,73.4109
第15任總統副總統,在彰化縣各村(里),彰化縣,　社頭鄉,社頭村,82,656,1267,2005,31,2036,0,2036,647,2683,75.8852
第15任總統副總統,在彰化縣各村(里),彰化縣,　社頭鄉,廣興村,127,1104,1983,3214,41,3255,0,3255,1101,4356,74.7245
第15任總統副總統,在彰化縣各村(里),彰化縣,　社頭鄉,東興村,45,417,591,1053,6,1059,0,1059,363,1422,74.4726
第15任總統副總統,在彰化縣各村(里),彰化縣,　社頭鄉,松竹村,24,261,464,749,6,755,0,755,244,999,75.5756
第15任總統副總統,在彰化縣各村(里),彰化縣,　社頭鄉,舊社村,51,369,760,1180,15,1195,0,1195,362,1557,76.7502
第15任總統副總統,在彰化縣各村(里),彰化縣,　社頭鄉,廣福村,28,252,408,688,14,702,0,702,193,895,78.4358
第15任總統副總統,在彰化縣各村(里),彰化縣,　社頭鄉,橋頭村,55,517,949,1521,18,1539,0,1539,453,1992,77.2590
第15任總統副總統,在彰化縣各村(里),彰化縣,　社頭鄉,新厝村,46,368,609,1023,16,1039,0,1039,329,1368,75.9503
第15任總統副總統,在彰化縣各村(里),彰化縣,　社頭鄉,張厝村,52,319,554,925,7,932,0,932,277,1209,77.0885
第15任總統副總統,在彰化縣各村(里),彰化縣,　社頭鄉,湳底村,53,372,755,1180,15,1195,0,1195,417,1612,74.1315
第15任總統副總統,在彰化縣各村(里),彰化縣,　社頭鄉,仁雅村,89,808,1139,2036,25,2061,0,2061,602,2663,77.3939
第15任總統副總統,在彰化縣各村(里),彰化縣,　社頭鄉,里仁村,33,276,420,729,11,740,0,740,210,950,77.8947
第15任總統副總統,在彰化縣各村(里),彰化縣,　社頭鄉,美雅村,40,368,508,916,16,932,0,932,291,1223,76.2061
第15任總統副總統,在彰化縣各村(里),彰化縣,　社頭鄉,崙雅村,27,265,351,643,18,661,0,661,237,898,73.6080
第15任總統副總統,在彰化縣各村(里),彰化縣,　社頭鄉,清水村,37,395,429,861,11,872,0,872,308,1180,73.8983
第15任總統副總統,在彰化縣各村(里),彰化縣,　社頭鄉,山湖村,25,284,568,877,9,886,0,886,245,1131,78.3378
第15任總統副總統,在彰化縣各村(里),彰化縣,　社頭鄉,埤斗村,41,227,425,693,7,700,0,700,251,951,73.6067
第15任總統副總統,在彰化縣各村(里),彰化縣,　社頭鄉,仁和村,21,209,277,507,15,522,0,522,180,702,74.3590
第15任總統副總統,在彰化縣各村(里),彰化縣,　社頭鄉,平和村,38,275,411,724,8,732,0,732,234,966,75.7764
第15任總統副總統,在彰化縣各村(里),彰化縣,　社頭鄉,協和村,75,541,947,1563,18,1581,0,1581,544,2125,74.4000
第15任總統副總統,在彰化縣各村(里),彰化縣,　社頭鄉,泰安村,32,301,392,725,7,732,0,732,230,962,76.0915
第15任總統副總統,在彰化縣各村(里),彰化縣,　社頭鄉,朝興村,37,331,484,852,9,861,0,861,196,1057,81.4570
第15任總統副總統,在彰化縣各村(里),彰化縣,　社頭鄉,龍井村,32,205,362,599,7,606,0,606,208,814,74.4472
第15任總統副總統,在彰化縣各村(里),彰化縣,　社頭鄉,湳雅村,55,334,657,1046,24,1070,0,1070,382,1452,73.6915
第15任總統副總統,在彰化縣各村(里),彰化縣,　二水鄉,復興村,31,242,464,737,15,752,0,752,228,980,76.7347
第15任總統副總統,在彰化縣各村(里),彰化縣,　二水鄉,十五村,14,185,271,470,10,480,0,480,181,661,72.6172
第15任總統副總統,在彰化縣各村(里),彰化縣,　二水鄉,合和村,30,239,338,607,7,614,0,614,218,832,73.7981
第15任總統副總統,在彰化縣各村(里),彰化縣,　二水鄉,上豊村,25,283,385,693,15,708,0,708,219,927,76.3754
第15任總統副總統,在彰化縣各村(里),彰化縣,　二水鄉,過圳村,16,187,251,454,3,457,0,457,143,600,76.1667
第15任總統副總統,在彰化縣各村(里),彰化縣,　二水鄉,五伯村,14,195,266,475,5,480,0,480,134,614,78.1759
第15任總統副總統,在彰化縣各村(里),彰化縣,　二水鄉,文化村,17,358,345,720,1,721,0,721,221,942,76.5393
第15任總統副總統,在彰化縣各村(里),彰化縣,　二水鄉,光化村,20,287,389,696,8,704,0,704,199,903,77.9623
第15任總統副總統,在彰化縣各村(里),彰化縣,　二水鄉,聖化村,10,162,150,322,5,327,0,327,105,432,75.6944
第15任總統副總統,在彰化縣各村(里),彰化縣,　二水鄉,二水村,24,267,302,593,6,599,0,599,190,789,75.9189
第15任總統副總統,在彰化縣各村(里),彰化縣,　二水鄉,惠民村,24,214,365,603,7,610,0,610,198,808,75.4950
第15任總統副總統,在彰化縣各村(里),彰化縣,　二水鄉,裕民村,44,245,420,709,9,718,0,718,268,986,72.8195
第15任總統副總統,在彰化縣各村(里),彰化縣,　二水鄉,大園村,16,173,363,552,10,562,0,562,200,762,73.7533
第15任總統副總統,在彰化縣各村(里),彰化縣,　二水鄉,修仁村,16,246,295,557,10,567,0,567,193,760,74.6053
第15任總統副總統,在彰化縣各村(里),彰化縣,　二水鄉,合興村,13,186,284,483,5,488,0,488,169,657,74.2770
第15任總統副總統,在彰化縣各村(里),彰化縣,　二水鄉,源泉村,16,214,248,478,6,484,0,484,125,609,79.4745
第15任總統副總統,在彰化縣各村(里),彰化縣,　二水鄉,倡和村,14,161,221,396,6,402,0,402,149,551,72.9583
第15任總統副總統,在彰化縣各村(里),彰化縣,　北斗鎮,中寮里,84,621,1186,1891,29,1920,0,1920,672,2592,74.0741
第15任總統副總統,在彰化縣各村(里),彰化縣,　北斗鎮,大道里,63,441,924,1428,19,1447,0,1447,393,1840,78.6413
第15任總統副總統,在彰化縣各村(里),彰化縣,　北斗鎮,西德里,143,1321,1886,3350,43,3393,0,3393,1068,4461,76.0592
第15任總統副總統,在彰化縣各村(里),彰化縣,　北斗鎮,西安里,61,450,628,1139,17,1156,0,1156,432,1588,72.7960
第15任總統副總統,在彰化縣各村(里),彰化縣,　北斗鎮,光復里,50,529,761,1340,16,1356,0,1356,369,1725,78.6087
第15任總統副總統,在彰化縣各村(里),彰化縣,　北斗鎮,新政里,30,222,305,557,10,567,0,567,192,759,74.7036
第15任總統副總統,在彰化縣各村(里),彰化縣,　北斗鎮,重慶里,18,140,259,417,3,420,0,420,117,537,78.2123
第15任總統副總統,在彰化縣各村(里),彰化縣,　北斗鎮,五權里,20,175,290,485,6,491,0,491,137,628,78.1847
第15任總統副總統,在彰化縣各村(里),彰化縣,　北斗鎮,七星里,44,374,599,1017,18,1035,0,1035,356,1391,74.4069
第15任總統副總統,在彰化縣各村(里),彰化縣,　北斗鎮,居仁里,59,424,472,955,20,975,0,975,275,1250,78.0000
第15任總統副總統,在彰化縣各村(里),彰化縣,　北斗鎮,東光里,84,615,909,1608,22,1630,0,1630,518,2148,75.8845
第15任總統副總統,在彰化縣各村(里),彰化縣,　北斗鎮,文昌里,101,869,1163,2133,36,2169,0,2169,779,2948,73.5753
第15任總統副總統,在彰化縣各村(里),彰化縣,　北斗鎮,中和里,45,322,530,897,15,912,0,912,332,1244,73.3119
第15任總統副總統,在彰化縣各村(里),彰化縣,　北斗鎮,新生里,64,537,727,1328,26,1354,0,1354,616,1970,68.7310
第15任總統副總統,在彰化縣各村(里),彰化縣,　北斗鎮,大新里,78,497,672,1247,22,1269,0,1269,457,1726,73.5226
第15任總統副總統,在彰化縣各村(里),彰化縣,　二林鎮,豐田里,75,720,870,1665,29,1694,0,1694,751,2445,69.2843
第15任總統副總統,在彰化縣各村(里),彰化縣,　二林鎮,東和里,56,618,808,1482,15,1497,0,1497,542,2039,73.4183
第15任總統副總統,在彰化縣各村(里),彰化縣,　二林鎮,南光里,106,986,1095,2187,37,2224,0,2224,832,3056,72.7749
第15任總統副總統,在彰化縣各村(里),彰化縣,　二林鎮,西平里,33,428,546,1007,17,1024,0,1024,362,1386,73.8817
第15任總統副總統,在彰化縣各村(里),彰化縣,　二林鎮,北平里,90,819,1141,2050,30,2080,0,2080,844,2924,71.1354
第15任總統副總統,在彰化縣各村(里),彰化縣,　二林鎮,中西里,57,517,489,1063,17,1080,0,1080,507,1587,68.0529
第15任總統副總統,在彰化縣各村(里),彰化縣,　二林鎮,廣興里,40,355,497,892,16,908,0,908,396,1304,69.6319
第15任總統副總統,在彰化縣各村(里),彰化縣,　二林鎮,香田里,19,235,396,650,11,661,0,661,329,990,66.7677
第15任總統副總統,在彰化縣各村(里),彰化縣,　二林鎮,外竹里,20,287,345,652,11,663,0,663,298,961,68.9906
第15任總統副總統,在彰化縣各村(里),彰化縣,　二林鎮,興華里,19,397,369,785,7,792,0,792,340,1132,69.9647
第15任總統副總統,在彰化縣各村(里),彰化縣,　二林鎮,東興里,54,476,564,1094,16,1110,0,1110,443,1553,71.4746
第15任總統副總統,在彰化縣各村(里),彰化縣,　二林鎮,後厝里,93,1021,1161,2275,38,2313,0,2313,849,3162,73.1499
第15任總統副總統,在彰化縣各村(里),彰化縣,　二林鎮,頂厝里,33,474,304,811,12,823,0,823,482,1305,63.0651
第15任總統副總統,在彰化縣各村(里),彰化縣,　二林鎮,趙甲里,48,465,554,1067,23,1090,0,1090,439,1529,71.2884
第15任總統副總統,在彰化縣各村(里),彰化縣,　二林鎮,振興里,43,346,396,785,22,807,0,807,378,1185,68.1013
第15任總統副總統,在彰化縣各村(里),彰化縣,　二林鎮,萬興里,28,245,276,549,10,559,0,559,185,744,75.1344
第15任總統副總統,在彰化縣各村(里),彰化縣,　二林鎮,永興里,56,409,541,1006,5,1011,0,1011,459,1470,68.7755
第15任總統副總統,在彰化縣各村(里),彰化縣,　二林鎮,西庄里,36,294,518,848,11,859,0,859,374,1233,69.6675
第15任總統副總統,在彰化縣各村(里),彰化縣,　二林鎮,梅芳里,37,279,412,728,13,741,0,741,311,1052,70.4373
第15任總統副總統,在彰化縣各村(里),彰化縣,　二林鎮,華崙里,69,1140,1175,2384,39,2423,0,2423,1061,3484,69.5465
第15任總統副總統,在彰化縣各村(里),彰化縣,　二林鎮,萬合里,29,374,316,719,8,727,0,727,365,1092,66.5751
第15任總統副總統,在彰化縣各村(里),彰化縣,　二林鎮,東勢里,32,279,336,647,17,664,0,664,257,921,72.0955
第15任總統副總統,在彰化縣各村(里),彰化縣,　二林鎮,大永里,27,239,340,606,10,616,0,616,259,875,70.4000
第15任總統副總統,在彰化縣各村(里),彰化縣,　二林鎮,原斗里,34,374,505,913,5,918,0,918,311,1229,74.6949
第15任總統副總統,在彰化縣各村(里),彰化縣,　二林鎮,西斗里,31,333,398,762,16,778,0,778,250,1028,75.6809
第15任總統副總統,在彰化縣各村(里),彰化縣,　二林鎮,東華里,24,263,418,705,6,711,0,711,244,955,74.4503
第15任總統副總統,在彰化縣各村(里),彰化縣,　二林鎮,復豐里,23,173,289,485,6,491,0,491,206,697,70.4448
第15任總統副總統,在彰化縣各村(里),彰化縣,　田尾鄉,田尾村,27,351,463,841,12,853,0,853,391,1244,68.5691
第15任總統副總統,在彰化縣各村(里),彰化縣,　田尾鄉,溪畔村,37,306,472,815,10,825,0,825,305,1130,73.0088
第15任總統副總統,在彰化縣各村(里),彰化縣,　田尾鄉,打簾村,47,487,723,1257,22,1279,0,1279,399,1678,76.2217
第15任總統副總統,在彰化縣各村(里),彰化縣,　田尾鄉,正義村,29,262,350,641,6,647,0,647,204,851,76.0282
第15任總統副總統,在彰化縣各村(里),彰化縣,　田尾鄉,北曾村,62,406,677,1145,24,1169,0,1169,341,1510,77.4172
第15任總統副總統,在彰化縣各村(里),彰化縣,　田尾鄉,南曾村,40,328,588,956,11,967,0,967,312,1279,75.6059
第15任總統副總統,在彰化縣各村(里),彰化縣,　田尾鄉,饒平村,103,758,984,1845,26,1871,0,1871,598,2469,75.7797
第15任總統副總統,在彰化縣各村(里),彰化縣,　田尾鄉,豐田村,21,245,307,573,7,580,0,580,202,782,74.1688
第15任總統副總統,在彰化縣各村(里),彰化縣,　田尾鄉,仁里村,48,430,652,1130,10,1140,0,1140,414,1554,73.3591
第15任總統副總統,在彰化縣各村(里),彰化縣,　田尾鄉,新厝村,21,79,93,193,1,194,0,194,58,252,76.9841
第15任總統副總統,在彰化縣各村(里),彰化縣,　田尾鄉,溪頂村,20,144,267,431,8,439,0,439,155,594,73.9057
第15任總統副總統,在彰化縣各村(里),彰化縣,　田尾鄉,柳鳳村,18,329,381,728,16,744,0,744,171,915,81.3115
第15任總統副總統,在彰化縣各村(里),彰化縣,　田尾鄉,陸豐村,34,248,344,626,8,634,0,634,220,854,74.2389
第15任總統副總統,在彰化縣各村(里),彰化縣,　田尾鄉,海豐村,33,330,591,954,9,963,0,963,370,1333,72.2431
第15任總統副總統,在彰化縣各村(里),彰化縣,　田尾鄉,睦宜村,38,287,450,775,15,790,0,790,256,1046,75.5258
第15任總統副總統,在彰化縣各村(里),彰化縣,　田尾鄉,新生村,32,334,587,953,15,968,0,968,311,1279,75.6841
第15任總統副總統,在彰化縣各村(里),彰化縣,　田尾鄉,北鎮村,49,291,510,850,13,863,1,864,317,1181,73.0737
第15任總統副總統,在彰化縣各村(里),彰化縣,　田尾鄉,南鎮村,12,157,273,442,7,449,0,449,157,606,74.0924
第15任總統副總統,在彰化縣各村(里),彰化縣,　田尾鄉,福田村,18,200,294,512,8,520,0,520,207,727,71.5268
第15任總統副總統,在彰化縣各村(里),彰化縣,　田尾鄉,新興村,21,284,494,799,6,805,0,805,229,1034,77.8530
第15任總統副總統,在彰化縣各村(里),彰化縣,　埤頭鄉,和豊村,80,586,965,1631,22,1653,0,1653,746,2399,68.9037
第15任總統副總統,在彰化縣各村(里),彰化縣,　埤頭鄉,興農村,51,460,724,1235,21,1256,0,1256,462,1718,73.1083
第15任總統副總統,在彰化縣各村(里),彰化縣,　埤頭鄉,埤頭村,46,363,693,1102,11,1113,0,1113,443,1556,71.5296
第15任總統副總統,在彰化縣各村(里),彰化縣,　埤頭鄉,豊崙村,79,760,680,1519,20,1539,0,1539,704,2243,68.6135
第15任總統副總統,在彰化縣各村(里),彰化縣,　埤頭鄉,崙子村,49,333,469,851,13,864,0,864,347,1211,71.3460
第15任總統副總統,在彰化縣各村(里),彰化縣,　埤頭鄉,永豊村,45,399,627,1071,13,1084,0,1084,463,1547,70.0711
第15任總統副總統,在彰化縣各村(里),彰化縣,　埤頭鄉,合興村,101,1016,1214,2331,33,2364,0,2364,823,3187,74.1763
第15任總統副總統,在彰化縣各村(里),彰化縣,　埤頭鄉,平原村,73,638,812,1523,27,1550,0,1550,604,2154,71.9591
第15任總統副總統,在彰化縣各村(里),彰化縣,　埤頭鄉,崙腳村,26,162,304,492,12,504,0,504,198,702,71.7949
第15任總統副總統,在彰化縣各村(里),彰化縣,　埤頭鄉,元埔村,18,137,251,406,6,412,0,412,146,558,73.8351
第15任總統副總統,在彰化縣各村(里),彰化縣,　埤頭鄉,芙朝村,39,416,536,991,25,1016,0,1016,439,1455,69.8282
第15任總統副總統,在彰化縣各村(里),彰化縣,　埤頭鄉,新庄村,31,212,497,740,10,750,0,750,274,1024,73.2422
第15任總統副總統,在彰化縣各村(里),彰化縣,　埤頭鄉,陸嘉村,24,153,361,538,6,544,0,544,248,792,68.6869
第15任總統副總統,在彰化縣各村(里),彰化縣,　埤頭鄉,竹圍村,41,205,472,718,16,734,0,734,320,1054,69.6395
第15任總統副總統,在彰化縣各村(里),彰化縣,　埤頭鄉,中和村,27,315,627,969,19,988,0,988,419,1407,70.2203
第15任總統副總統,在彰化縣各村(里),彰化縣,　埤頭鄉,庄內村,32,190,466,688,10,698,0,698,316,1014,68.8363
第15任總統副總統,在彰化縣各村(里),彰化縣,　埤頭鄉,大湖村,24,167,429,620,12,632,0,632,254,886,71.3318
第15任總統副總統,在彰化縣各村(里),彰化縣,　芳苑鄉,芳苑村,18,214,334,566,7,573,0,573,327,900,63.6667
第15任總統副總統,在彰化縣各村(里),彰化縣,　芳苑鄉,芳中村,10,112,153,275,6,281,0,281,109,390,72.0513
第15任總統副總統,在彰化縣各村(里),彰化縣,　芳苑鄉,仁愛村,15,198,285,498,7,505,0,505,232,737,68.5210
第15任總統副總統,在彰化縣各村(里),彰化縣,　芳苑鄉,信義村,11,98,194,303,9,312,0,312,218,530,58.8679
第15任總統副總統,在彰化縣各村(里),彰化縣,　芳苑鄉,後寮村,25,265,351,641,14,655,0,655,298,953,68.7303
第15任總統副總統,在彰化縣各村(里),彰化縣,　芳苑鄉,三合村,68,529,816,1413,10,1423,0,1423,650,2073,68.6445
第15任總統副總統,在彰化縣各村(里),彰化縣,　芳苑鄉,永興村,30,368,509,907,13,920,0,920,400,1320,69.6970
第15任總統副總統,在彰化縣各村(里),彰化縣,　芳苑鄉,新街村,17,154,282,453,9,462,0,462,310,772,59.8446
第15任總統副總統,在彰化縣各村(里),彰化縣,　芳苑鄉,路上村,9,163,222,394,4,398,0,398,236,634,62.7760
第15任總統副總統,在彰化縣各村(里),彰化縣,　芳苑鄉,路平村,23,219,261,503,13,516,0,516,216,732,70.4918
第15任總統副總統,在彰化縣各村(里),彰化縣,　芳苑鄉,三成村,44,190,387,621,13,634,0,634,336,970,65.3608
第15任總統副總統,在彰化縣各村(里),彰化縣,　芳苑鄉,福榮村,11,130,236,377,10,387,0,387,179,566,68.3746
第15任總統副總統,在彰化縣各村(里),彰化縣,　芳苑鄉,頂廍村,13,148,241,402,2,404,0,404,162,566,71.3781
第15任總統副總統,在彰化縣各村(里),彰化縣,　芳苑鄉,王功村,56,323,955,1334,18,1352,0,1352,707,2059,65.6629
第15任總統副總統,在彰化縣各村(里),彰化縣,　芳苑鄉,博愛村,14,126,329,469,7,476,0,476,200,676,70.4142
第15任總統副總統,在彰化縣各村(里),彰化縣,　芳苑鄉,和平村,9,151,299,459,5,464,0,464,252,716,64.8045
第15任總統副總統,在彰化縣各村(里),彰化縣,　芳苑鄉,興仁村,33,210,562,805,7,812,0,812,455,1267,64.0884
第15任總統副總統,在彰化縣各村(里),彰化縣,　芳苑鄉,民生村,14,111,303,428,11,439,0,439,215,654,67.1254
第15任總統副總統,在彰化縣各村(里),彰化縣,　芳苑鄉,新寶村,40,382,677,1099,14,1113,0,1113,513,1626,68.4502
第15任總統副總統,在彰化縣各村(里),彰化縣,　芳苑鄉,五俊村,8,117,149,274,5,279,0,279,184,463,60.2592
第15任總統副總統,在彰化縣各村(里),彰化縣,　芳苑鄉,草湖村,42,404,499,945,19,964,0,964,457,1421,67.8395
第15任總統副總統,在彰化縣各村(里),彰化縣,　芳苑鄉,建平村,58,521,789,1368,17,1385,0,1385,658,2043,67.7925
第15任總統副總統,在彰化縣各村(里),彰化縣,　芳苑鄉,崙腳村,34,232,310,576,18,594,0,594,146,740,80.2703
第15任總統副總統,在彰化縣各村(里),彰化縣,　芳苑鄉,文津村,13,262,368,643,9,652,0,652,391,1043,62.5120
第15任總統副總統,在彰化縣各村(里),彰化縣,　芳苑鄉,新生村,38,294,495,827,9,836,0,836,480,1316,63.5258
第15任總統副總統,在彰化縣各村(里),彰化縣,　芳苑鄉,漢寶村,108,738,1265,2111,26,2137,0,2137,973,3110,68.7138
第15任總統副總統,在彰化縣各村(里),彰化縣,　大城鄉,山腳村,30,288,452,770,16,786,0,786,458,1244,63.1833
第15任總統副總統,在彰化縣各村(里),彰化縣,　大城鄉,潭墘村,15,234,426,675,7,682,0,682,367,1049,65.0143
第15任總統副總統,在彰化縣各村(里),彰化縣,　大城鄉,大城村,24,317,287,628,12,640,0,640,280,920,69.5652
第15任總統副總統,在彰化縣各村(里),彰化縣,　大城鄉,東城村,35,411,425,871,17,888,0,888,402,1290,68.8372
第15任總統副總統,在彰化縣各村(里),彰化縣,　大城鄉,西城村,24,207,274,505,10,515,0,515,283,798,64.5363
第15任總統副總統,在彰化縣各村(里),彰化縣,　大城鄉,上山村,24,303,337,664,7,671,0,671,377,1048,64.0267
第15任總統副總統,在彰化縣各村(里),彰化縣,　大城鄉,永和村,19,193,216,428,5,433,0,433,240,673,64.3388
第15任總統副總統,在彰化縣各村(里),彰化縣,　大城鄉,公館村,28,299,329,656,4,660,0,660,371,1031,64.0155
第15任總統副總統,在彰化縣各村(里),彰化縣,　大城鄉,豐美村,15,206,292,513,12,525,0,525,317,842,62.3515
第15任總統副總統,在彰化縣各村(里),彰化縣,　大城鄉,三豐村,9,164,183,356,8,364,0,364,271,635,57.3228
第15任總統副總統,在彰化縣各村(里),彰化縣,　大城鄉,菜寮村,23,311,278,612,18,630,0,630,423,1053,59.8291
第15任總統副總統,在彰化縣各村(里),彰化縣,　大城鄉,東港村,26,344,322,692,14,706,0,706,437,1143,61.7673
第15任總統副總統,在彰化縣各村(里),彰化縣,　大城鄉,西港村,19,288,260,567,8,575,0,575,301,876,65.6393
第15任總統副總統,在彰化縣各村(里),彰化縣,　大城鄉,頂庄村,12,151,238,401,5,406,0,406,249,655,61.9847
第15任總統副總統,在彰化縣各村(里),彰化縣,　大城鄉,台西村,17,185,288,490,8,498,0,498,359,857,58.1097
第15任總統副總統,在彰化縣各村(里),彰化縣,　竹塘鄉,竹元村,20,327,459,806,9,815,0,815,298,1113,73.2255
第15任總統副總統,在彰化縣各村(里),彰化縣,　竹塘鄉,竹塘村,46,560,705,1311,27,1338,0,1338,522,1860,71.9355
第15任總統副總統,在彰化縣各村(里),彰化縣,　竹塘鄉,小西村,17,183,278,478,10,488,0,488,217,705,69.2199
第15任總統副總統,在彰化縣各村(里),彰化縣,　竹塘鄉,民靖村,16,198,271,485,11,496,0,496,239,735,67.4830
第15任總統副總統,在彰化縣各村(里),彰化縣,　竹塘鄉,五庄村,43,271,709,1023,12,1035,0,1035,460,1495,69.2308
第15任總統副總統,在彰化縣各村(里),彰化縣,　竹塘鄉,樹腳村,12,129,314,455,8,463,0,463,157,620,74.6774
第15任總統副總統,在彰化縣各村(里),彰化縣,　竹塘鄉,田頭村,25,245,426,696,12,708,0,708,319,1027,68.9387
第15任總統副總統,在彰化縣各村(里),彰化縣,　竹塘鄉,新廣村,28,231,501,760,4,764,0,764,314,1078,70.8720
第15任總統副總統,在彰化縣各村(里),彰化縣,　竹塘鄉,溪墘村,18,104,229,351,9,360,0,360,117,477,75.4717
第15任總統副總統,在彰化縣各村(里),彰化縣,　竹塘鄉,竹林村,21,186,316,523,7,530,0,530,254,784,67.6020
第15任總統副總統,在彰化縣各村(里),彰化縣,　竹塘鄉,土庫村,8,151,286,445,9,454,0,454,171,625,72.6400
第15任總統副總統,在彰化縣各村(里),彰化縣,　竹塘鄉,內新村,9,110,251,370,4,374,0,374,180,554,67.5090
第15任總統副總統,在彰化縣各村(里),彰化縣,　竹塘鄉,長安村,12,146,328,486,6,492,0,492,239,731,67.3051
第15任總統副總統,在彰化縣各村(里),彰化縣,　竹塘鄉,永安村,11,98,245,354,7,361,0,361,169,530,68.1132
第15任總統副總統,在彰化縣各村(里),彰化縣,　溪州鄉,溪厝村,48,409,781,1238,21,1259,0,1259,503,1762,71.4529
第15任總統副總統,在彰化縣各村(里),彰化縣,　溪州鄉,坑厝村,22,174,294,490,9,499,0,499,187,686,72.7405
第15任總統副總統,在彰化縣各村(里),彰化縣,　溪州鄉,瓦厝村,33,197,418,648,14,662,1,663,179,842,78.6223
第15任總統副總統,在彰化縣各村(里),彰化縣,　溪州鄉,溪州村,47,436,659,1142,15,1157,0,1157,323,1480,78.1757
第15任總統副總統,在彰化縣各村(里),彰化縣,　溪州鄉,尾厝村,61,512,762,1335,18,1353,0,1353,390,1743,77.6248
第15任總統副總統,在彰化縣各村(里),彰化縣,　溪州鄉,東州村,57,498,828,1383,21,1404,0,1404,444,1848,75.9740
第15任總統副總統,在彰化縣各村(里),彰化縣,　溪州鄉,舊眉村,46,298,668,1012,18,1030,0,1030,347,1377,74.8003
第15任總統副總統,在彰化縣各村(里),彰化縣,　溪州鄉,圳寮村,46,383,621,1050,20,1070,0,1070,385,1455,73.5395
第15任總統副總統,在彰化縣各村(里),彰化縣,　溪州鄉,西畔村,69,431,842,1342,15,1357,0,1357,628,1985,68.3627
第15任總統副總統,在彰化縣各村(里),彰化縣,　溪州鄉,柑園村,43,278,438,759,16,775,0,775,333,1108,69.9458
第15任總統副總統,在彰化縣各村(里),彰化縣,　溪州鄉,成功村,56,445,767,1268,18,1286,0,1286,492,1778,72.3285
第15任總統副總統,在彰化縣各村(里),彰化縣,　溪州鄉,大庄村,49,351,837,1237,18,1255,0,1255,548,1803,69.6062
第15任總統副總統,在彰化縣各村(里),彰化縣,　溪州鄉,榮光村,23,272,274,569,9,578,0,578,261,839,68.8915
第15任總統副總統,在彰化縣各村(里),彰化縣,　溪州鄉,潮洋村,25,167,371,563,9,572,0,572,238,810,70.6173
第15任總統副總統,在彰化縣各村(里),彰化縣,　溪州鄉,張厝村,18,129,290,437,10,447,0,447,232,679,65.8321
第15任總統副總統,在彰化縣各村(里),彰化縣,　溪州鄉,菜公村,26,181,371,578,17,595,0,595,231,826,72.0339
第15任總統副總統,在彰化縣各村(里),彰化縣,　溪州鄉,三條村,15,121,474,610,16,626,0,626,218,844,74.1706
第15任總統副總統,在彰化縣各村(里),彰化縣,　溪州鄉,三圳村,32,296,504,832,13,845,0,845,349,1194,70.7705
第15任總統副總統,在彰化縣各村(里),彰化縣,　溪州鄉,水尾村,26,223,764,1013,14,1027,0,1027,423,1450,70.8276
第15任總統副總統,在嘉義市各村(里),嘉義市,　東區,短竹里,56,683,977,1716,14,1730,0,1730,527,2257,76.6504
第15任總統副總統,在嘉義市各村(里),嘉義市,　東區,蘭潭里,53,617,892,1562,14,1576,0,1576,515,2091,75.3706
第15任總統副總統,在嘉義市各村(里),嘉義市,　東區,東川里,47,566,726,1339,14,1353,0,1353,366,1719,78.7086
第15任總統副總統,在嘉義市各村(里),嘉義市,　東區,鹿寮里,27,221,461,709,6,715,0,715,283,998,71.6433
第15任總統副總統,在嘉義市各村(里),嘉義市,　東區,盧厝里,54,481,840,1375,22,1397,0,1397,395,1792,77.9576
第15任總統副總統,在嘉義市各村(里),嘉義市,　東區,文雅里,130,1061,1489,2680,30,2710,0,2710,852,3562,76.0809
第15任總統副總統,在嘉義市各村(里),嘉義市,　東區,王田里,58,748,900,1706,25,1731,0,1731,493,2224,77.8327
第15任總統副總統,在嘉義市各村(里),嘉義市,　東區,長竹里,79,817,1271,2167,20,2187,2,2189,581,2770,78.9531
第15任總統副總統,在嘉義市各村(里),嘉義市,　東區,後庄里,109,1183,1631,2923,37,2960,0,2960,869,3829,77.3048
第15任總統副總統,在嘉義市各村(里),嘉義市,　東區,新店里,126,1214,1722,3062,44,3106,0,3106,899,4005,77.5531
第15任總統副總統,在嘉義市各村(里),嘉義市,　東區,圳頭里,114,1422,1552,3088,26,3114,0,3114,991,4105,75.8587
第15任總統副總統,在嘉義市各村(里),嘉義市,　東區,中山里,57,569,760,1386,15,1401,0,1401,404,1805,77.6177
第15任總統副總統,在嘉義市各村(里),嘉義市,　東區,太平里,145,1289,1674,3108,45,3153,0,3153,911,4064,77.5837
第15任總統副總統,在嘉義市各村(里),嘉義市,　東區,東興里,39,520,846,1405,15,1420,0,1420,394,1814,78.2800
第15任總統副總統,在嘉義市各村(里),嘉義市,　東區,華南里,38,508,878,1424,12,1436,0,1436,478,1914,75.0261
第15任總統副總統,在嘉義市各村(里),嘉義市,　東區,中央里,42,478,1062,1582,23,1605,0,1605,493,2098,76.5014
第15任總統副總統,在嘉義市各村(里),嘉義市,　東區,朝陽里,45,512,910,1467,10,1477,0,1477,461,1938,76.2126
第15任總統副總統,在嘉義市各村(里),嘉義市,　東區,民族里,30,423,705,1158,13,1171,0,1171,556,1727,67.8054
第15任總統副總統,在嘉義市各村(里),嘉義市,　東區,過溝里,41,516,966,1523,15,1538,0,1538,494,2032,75.6890
第15任總統副總統,在嘉義市各村(里),嘉義市,　東區,新開里,75,531,839,1445,20,1465,0,1465,478,1943,75.3989
第15任總統副總統,在嘉義市各村(里),嘉義市,　東區,宣信里,29,293,601,923,15,938,0,938,359,1297,72.3207
第15任總統副總統,在嘉義市各村(里),嘉義市,　東區,興南里,43,363,741,1147,15,1162,0,1162,416,1578,73.6375
第15任總統副總統,在嘉義市各村(里),嘉義市,　東區,豐年里,28,296,586,910,14,924,0,924,295,1219,75.7998
第15任總統副總統,在嘉義市各村(里),嘉義市,　東區,芳草里,79,844,1461,2384,30,2414,0,2414,888,3302,73.1072
第15任總統副總統,在嘉義市各村(里),嘉義市,　東區,芳安里,68,575,938,1581,18,1599,0,1599,477,2076,77.0231
第15任總統副總統,在嘉義市各村(里),嘉義市,　東區,頂寮里,63,608,1187,1858,28,1886,0,1886,539,2425,77.7732
第15任總統副總統,在嘉義市各村(里),嘉義市,　東區,安寮里,75,682,1186,1943,16,1959,0,1959,684,2643,74.1203
第15任總統副總統,在嘉義市各村(里),嘉義市,　東區,安業里,55,490,812,1357,12,1369,0,1369,467,1836,74.5643
第15任總統副總統,在嘉義市各村(里),嘉義市,　東區,興村里,120,978,1745,2843,21,2864,0,2864,896,3760,76.1702
第15任總統副總統,在嘉義市各村(里),嘉義市,　東區,興安里,78,695,1154,1927,24,1951,0,1951,605,2556,76.3302
第15任總統副總統,在嘉義市各村(里),嘉義市,　東區,興仁里,104,1017,1574,2695,20,2715,0,2715,843,3558,76.3069
第15任總統副總統,在嘉義市各村(里),嘉義市,　東區,北門里,60,475,988,1523,17,1540,0,1540,532,2072,74.3243
第15任總統副總統,在嘉義市各村(里),嘉義市,　東區,林森里,79,555,1093,1727,20,1747,0,1747,494,2241,77.9563
第15任總統副總統,在嘉義市各村(里),嘉義市,　東區,中庄里,115,824,1393,2332,28,2360,0,2360,724,3084,76.5240
第15任總統副總統,在嘉義市各村(里),嘉義市,　東區,頂庄里,72,585,951,1608,16,1624,0,1624,494,2118,76.6761
第15任總統副總統,在嘉義市各村(里),嘉義市,　東區,義教里,70,689,1217,1976,14,1990,0,1990,682,2672,74.4760
第15任總統副總統,在嘉義市各村(里),嘉義市,　東區,仁義里,97,745,1204,2046,15,2061,0,2061,667,2728,75.5499
第15任總統副總統,在嘉義市各村(里),嘉義市,　東區,後湖里,122,823,1520,2465,26,2491,0,2491,767,3258,76.4579
第15任總統副總統,在嘉義市各村(里),嘉義市,　東區,荖藤里,156,961,2079,3196,24,3220,0,3220,1078,4298,74.9186
第15任總統副總統,在嘉義市各村(里),嘉義市,　東區,東區各里平地、山地原住民,7,120,137,264,3,267,0,267,161,428,62.3832
第15任總統副總統,在嘉義市各村(里),嘉義市,　西區,書院里,57,469,883,1409,16,1425,1,1426,478,1904,74.8424
第15任總統副總統,在嘉義市各村(里),嘉義市,　西區,永和里,56,452,882,1390,14,1404,0,1404,457,1861,75.4433
第15任總統副總統,在嘉義市各村(里),嘉義市,　西區,新富里,44,333,825,1202,9,1211,0,1211,406,1617,74.8918
第15任總統副總統,在嘉義市各村(里),嘉義市,　西區,文化里,69,509,1055,1633,13,1646,0,1646,540,2186,75.2973
第15任總統副總統,在嘉義市各村(里),嘉義市,　西區,西榮里,59,480,1069,1608,23,1631,0,1631,529,2160,75.5093
第15任總統副總統,在嘉義市各村(里),嘉義市,　西區,番社里,31,340,669,1040,10,1050,0,1050,299,1349,77.8354
第15任總統副總統,在嘉義市各村(里),嘉義市,　西區,國華里,34,309,607,950,6,956,0,956,324,1280,74.6875
第15任總統副總統,在嘉義市各村(里),嘉義市,　西區,大溪里,64,416,1015,1495,15,1510,0,1510,534,2044,73.8748
第15任總統副總統,在嘉義市各村(里),嘉義市,　西區,磚磘里,110,707,1664,2481,32,2513,0,2513,852,3365,74.6805
第15任總統副總統,在嘉義市各村(里),嘉義市,　西區,福全里,126,974,1861,2961,25,2986,0,2986,1022,4008,74.5010
第15任總統副總統,在嘉義市各村(里),嘉義市,　西區,福安里,115,975,1986,3076,31,3107,0,3107,937,4044,76.8299
第15任總統副總統,在嘉義市各村(里),嘉義市,　西區,新西里,49,470,952,1471,13,1484,0,1484,490,1974,75.1773
第15任總統副總統,在嘉義市各村(里),嘉義市,　西區,港坪里,98,844,1559,2501,21,2522,0,2522,673,3195,78.9358
第15任總統副總統,在嘉義市各村(里),嘉義市,　西區,頭港里,60,400,901,1361,11,1372,0,1372,412,1784,76.9058
第15任總統副總統,在嘉義市各村(里),嘉義市,　西區,西平里,95,764,1508,2367,22,2389,0,2389,663,3052,78.2765
第15任總統副總統,在嘉義市各村(里),嘉義市,　西區,劉厝里,201,1767,2908,4876,52,4928,0,4928,1459,6387,77.1567
第15任總統副總統,在嘉義市各村(里),嘉義市,　西區,自強里,43,408,719,1170,8,1178,0,1178,357,1535,76.7427
第15任總統副總統,在嘉義市各村(里),嘉義市,　西區,美源里,98,957,1600,2655,26,2681,0,2681,861,3542,75.6917
第15任總統副總統,在嘉義市各村(里),嘉義市,　西區,湖內里,116,898,2140,3154,40,3194,0,3194,973,4167,76.6499
第15任總統副總統,在嘉義市各村(里),嘉義市,　西區,獅子里,75,711,1220,2006,15,2021,0,2021,623,2644,76.4372
第15任總統副總統,在嘉義市各村(里),嘉義市,　西區,紅瓦里,42,351,777,1170,12,1182,0,1182,368,1550,76.2581
第15任總統副總統,在嘉義市各村(里),嘉義市,　西區,光路里,124,1335,2226,3685,43,3728,0,3728,1130,4858,76.7394
第15任總統副總統,在嘉義市各村(里),嘉義市,　西區,福民里,150,1300,2405,3855,34,3889,1,3890,1370,5260,73.9354
第15任總統副總統,在嘉義市各村(里),嘉義市,　西區,車店里,168,1430,2574,4172,47,4219,0,4219,1298,5517,76.4727
第15任總統副總統,在嘉義市各村(里),嘉義市,　西區,垂楊里,40,447,849,1336,19,1355,0,1355,511,1866,72.6152
第15任總統副總統,在嘉義市各村(里),嘉義市,　西區,培元里,31,592,621,1244,12,1256,0,1256,346,1602,78.4020
第15任總統副總統,在嘉義市各村(里),嘉義市,　西區,育英里,49,468,820,1337,9,1346,0,1346,395,1741,77.3119
第15任總統副總統,在嘉義市各村(里),嘉義市,　西區,致遠里,45,844,375,1264,10,1274,0,1274,416,1690,75.3846
第15任總統副總統,在嘉義市各村(里),嘉義市,　西區,翠岱里,37,709,312,1058,5,1063,0,1063,290,1353,78.5661
第15任總統副總統,在嘉義市各村(里),嘉義市,　西區,導明里,39,364,726,1129,10,1139,0,1139,391,1530,74.4444
第15任總統副總統,在嘉義市各村(里),嘉義市,　西區,北榮里,75,470,1105,1650,18,1668,0,1668,478,2146,77.7260
第15任總統副總統,在嘉義市各村(里),嘉義市,　西區,慶安里,31,334,762,1127,12,1139,0,1139,378,1517,75.0824
第15任總統副總統,在嘉義市各村(里),嘉義市,　西區,香湖里,9,183,366,558,7,565,0,565,200,765,73.8562
第15任總統副總統,在嘉義市各村(里),嘉義市,　西區,重興里,56,429,903,1388,9,1397,0,1397,493,1890,73.9153
第15任總統副總統,在嘉義市各村(里),嘉義市,　西區,後驛里,62,412,1023,1497,22,1519,0,1519,520,2039,74.4973
第15任總統副總統,在嘉義市各村(里),嘉義市,　西區,湖邊里,54,392,1025,1471,10,1481,0,1481,495,1976,74.9494
第15任總統副總統,在嘉義市各村(里),嘉義市,　西區,竹圍里,103,1027,2022,3152,39,3191,0,3191,1073,4264,74.8358
第15任總統副總統,在嘉義市各村(里),嘉義市,　西區,保生里,117,960,2067,3144,29,3173,0,3173,998,4171,76.0729
第15任總統副總統,在嘉義市各村(里),嘉義市,　西區,保安里,108,790,1501,2399,26,2425,0,2425,710,3135,77.3525
第15任總統副總統,在嘉義市各村(里),嘉義市,　西區,北新里,26,236,573,835,10,845,0,845,210,1055,80.0948
第15任總統副總統,在嘉義市各村(里),嘉義市,　西區,新厝里,110,846,2105,3061,24,3085,0,3085,878,3963,77.8451
第15任總統副總統,在嘉義市各村(里),嘉義市,　西區,保福里,93,870,1581,2544,22,2566,0,2566,923,3489,73.5454
第15任總統副總統,在嘉義市各村(里),嘉義市,　西區,竹村里,29,261,577,867,7,874,0,874,238,1112,78.5971
第15任總統副總統,在嘉義市各村(里),嘉義市,　西區,北湖里,66,642,1421,2129,17,2146,0,2146,651,2797,76.7251
第15任總統副總統,在嘉義市各村(里),嘉義市,　西區,下埤里,44,339,739,1122,10,1132,0,1132,365,1497,75.6179
第15任總統副總統,在嘉義市各村(里),嘉義市,　西區,西區各里平地、山地原住民,11,78,119,208,3,211,0,211,127,338,62.4260
第15任總統副總統,在嘉義縣各村(里),嘉義縣,　太保市,太保里,86,590,909,1585,19,1604,1,1605,614,2219,72.2848
第15任總統副總統,在嘉義縣各村(里),嘉義縣,　太保市,後庄里,8,80,264,352,3,355,0,355,112,467,76.0171
第15任總統副總統,在嘉義縣各村(里),嘉義縣,　太保市,前潭里,36,283,736,1055,14,1069,0,1069,358,1427,74.9124
第15任總統副總統,在嘉義縣各村(里),嘉義縣,　太保市,後潭里,40,390,793,1223,16,1239,0,1239,391,1630,76.0123
第15任總統副總統,在嘉義縣各村(里),嘉義縣,　太保市,梅埔里,33,275,486,794,10,804,0,804,300,1104,72.8261
第15任總統副總統,在嘉義縣各村(里),嘉義縣,　太保市,春珠里,17,247,536,800,16,816,0,816,258,1074,75.9777
第15任總統副總統,在嘉義縣各村(里),嘉義縣,　太保市,崙頂里,25,240,360,625,12,637,0,637,187,824,77.3058
第15任總統副總統,在嘉義縣各村(里),嘉義縣,　太保市,安仁里,70,664,1099,1833,30,1863,0,1863,597,2460,75.7317
第15任總統副總統,在嘉義縣各村(里),嘉義縣,　太保市,東勢里,62,400,776,1238,18,1256,0,1256,370,1626,77.2448
第15任總統副總統,在嘉義縣各村(里),嘉義縣,　太保市,新埤里,27,228,645,900,10,910,0,910,321,1231,73.9236
第15任總統副總統,在嘉義縣各村(里),嘉義縣,　太保市,舊埤里,67,542,1071,1680,24,1704,0,1704,638,2342,72.7583
第15任總統副總統,在嘉義縣各村(里),嘉義縣,　太保市,田尾里,16,162,340,518,4,522,0,522,187,709,73.6248
第15任總統副總統,在嘉義縣各村(里),嘉義縣,　太保市,港尾里,18,135,253,406,4,410,0,410,152,562,72.9537
第15任總統副總統,在嘉義縣各村(里),嘉義縣,　太保市,過溝里,105,660,1740,2505,23,2528,0,2528,757,3285,76.9559
第15任總統副總統,在嘉義縣各村(里),嘉義縣,　太保市,麻寮里,152,922,2148,3222,31,3253,0,3253,1073,4326,75.1965
第15任總統副總統,在嘉義縣各村(里),嘉義縣,　太保市,南新里,40,336,973,1349,17,1366,0,1366,415,1781,76.6985
第15任總統副總統,在嘉義縣各村(里),嘉義縣,　太保市,北新里,84,628,1503,2215,24,2239,0,2239,716,2955,75.7699
第15任總統副總統,在嘉義縣各村(里),嘉義縣,　太保市,埤鄉里,19,152,336,507,8,515,0,515,153,668,77.0958
第15任總統副總統,在嘉義縣各村(里),嘉義縣,　朴子市,安福里,50,503,774,1327,9,1336,0,1336,501,1837,72.7273
第15任總統副總統,在嘉義縣各村(里),嘉義縣,　朴子市,平和里,66,634,983,1683,23,1706,0,1706,512,2218,76.9161
第15任總統副總統,在嘉義縣各村(里),嘉義縣,　朴子市,內厝里,32,223,560,815,10,825,0,825,251,1076,76.6729
第15任總統副總統,在嘉義縣各村(里),嘉義縣,　朴子市,開元里,5,87,207,299,2,301,0,301,83,384,78.3854
第15任總統副總統,在嘉義縣各村(里),嘉義縣,　朴子市,順天里,17,154,276,447,6,453,0,453,165,618,73.3010
第15任總統副總統,在嘉義縣各村(里),嘉義縣,　朴子市,中正里,16,165,285,466,10,476,0,476,151,627,75.9171
第15任總統副總統,在嘉義縣各村(里),嘉義縣,　朴子市,博厚里,25,181,406,612,4,616,0,616,168,784,78.5714
第15任總統副總統,在嘉義縣各村(里),嘉義縣,　朴子市,文化里,48,414,791,1253,14,1267,0,1267,406,1673,75.7322
第15任總統副總統,在嘉義縣各村(里),嘉義縣,　朴子市,永和里,56,533,1166,1755,16,1771,0,1771,648,2419,73.2121
第15任總統副總統,在嘉義縣各村(里),嘉義縣,　朴子市,竹圍里,113,1044,1898,3055,27,3082,0,3082,951,4033,76.4195
第15任總統副總統,在嘉義縣各村(里),嘉義縣,　朴子市,新寮里,8,156,309,473,9,482,0,482,172,654,73.7003
第15任總統副總統,在嘉義縣各村(里),嘉義縣,　朴子市,双溪里,8,122,268,398,4,402,0,402,198,600,67.0000
第15任總統副總統,在嘉義縣各村(里),嘉義縣,　朴子市,溪口里,19,160,369,548,6,554,0,554,219,773,71.6688
第15任總統副總統,在嘉義縣各村(里),嘉義縣,　朴子市,德興里,15,158,570,743,7,750,0,750,241,991,75.6811
第15任總統副總統,在嘉義縣各村(里),嘉義縣,　朴子市,仁和里,59,370,791,1220,13,1233,0,1233,402,1635,75.4128
第15任總統副總統,在嘉義縣各村(里),嘉義縣,　朴子市,大鄉里,86,688,1481,2255,37,2292,0,2292,844,3136,73.0867
第15任總統副總統,在嘉義縣各村(里),嘉義縣,　朴子市,大葛里,79,701,1256,2036,22,2058,1,2059,750,2809,73.2645
第15任總統副總統,在嘉義縣各村(里),嘉義縣,　朴子市,佳禾里,12,162,314,488,10,498,0,498,218,716,69.5531
第15任總統副總統,在嘉義縣各村(里),嘉義縣,　朴子市,竹村里,24,230,478,732,12,744,0,744,284,1028,72.3735
第15任總統副總統,在嘉義縣各村(里),嘉義縣,　朴子市,崁前里,14,133,413,560,10,570,0,570,295,865,65.8960
第15任總統副總統,在嘉義縣各村(里),嘉義縣,　朴子市,崁後里,14,114,344,472,8,480,0,480,222,702,68.3761
第15任總統副總統,在嘉義縣各村(里),嘉義縣,　朴子市,順安里,6,47,126,179,0,179,0,179,72,251,71.3147
第15任總統副總統,在嘉義縣各村(里),嘉義縣,　朴子市,德家里,8,139,357,504,6,510,0,510,235,745,68.4564
第15任總統副總統,在嘉義縣各村(里),嘉義縣,　朴子市,新庄里,14,152,302,468,5,473,0,473,211,684,69.1520
第15任總統副總統,在嘉義縣各村(里),嘉義縣,　朴子市,梅華里,14,160,542,716,12,728,0,728,283,1011,72.0079
第15任總統副總統,在嘉義縣各村(里),嘉義縣,　朴子市,松華里,12,163,606,781,9,790,0,790,390,1180,66.9492
第15任總統副總統,在嘉義縣各村(里),嘉義縣,　朴子市,南竹里,3,64,264,331,6,337,0,337,148,485,69.4845
第15任總統副總統,在嘉義縣各村(里),嘉義縣,　布袋鎮,岱江里,11,165,208,384,7,391,0,391,208,599,65.2755
第15任總統副總統,在嘉義縣各村(里),嘉義縣,　布袋鎮,九龍里,6,80,157,243,7,250,0,250,113,363,68.8705
第15任總統副總統,在嘉義縣各村(里),嘉義縣,　布袋鎮,岑海里,44,525,871,1440,27,1467,0,1467,585,2052,71.4912
第15任總統副總統,在嘉義縣各村(里),嘉義縣,　布袋鎮,興中里,32,273,433,738,21,759,0,759,315,1074,70.6704
第15任總統副總統,在嘉義縣各村(里),嘉義縣,　布袋鎮,光復里,33,454,680,1167,19,1186,0,1186,419,1605,73.8941
第15任總統副總統,在嘉義縣各村(里),嘉義縣,　布袋鎮,見龍里,23,211,386,620,10,630,0,630,196,826,76.2712
第15任總統副總統,在嘉義縣各村(里),嘉義縣,　布袋鎮,新厝里,18,173,237,428,6,434,0,434,249,683,63.5432
第15任總統副總統,在嘉義縣各村(里),嘉義縣,　布袋鎮,龍江里,13,165,283,461,12,473,0,473,267,740,63.9189
第15任總統副總統,在嘉義縣各村(里),嘉義縣,　布袋鎮,振寮里,12,217,232,461,11,472,0,472,260,732,64.4809
第15任總統副總統,在嘉義縣各村(里),嘉義縣,　布袋鎮,西安里,22,291,476,789,8,797,0,797,334,1131,70.4686
第15任總統副總統,在嘉義縣各村(里),嘉義縣,　布袋鎮,中安里,24,242,633,899,20,919,0,919,440,1359,67.6233
第15任總統副總統,在嘉義縣各村(里),嘉義縣,　布袋鎮,東安里,21,244,647,912,12,924,0,924,368,1292,71.5170
第15任總統副總統,在嘉義縣各村(里),嘉義縣,　布袋鎮,樹林里,9,119,230,358,8,366,0,366,134,500,73.2000
第15任總統副總統,在嘉義縣各村(里),嘉義縣,　布袋鎮,貴舍里,11,143,296,450,6,456,0,456,191,647,70.4791
第15任總統副總統,在嘉義縣各村(里),嘉義縣,　布袋鎮,永安里,22,263,468,753,17,770,0,770,330,1100,70.0000
第15任總統副總統,在嘉義縣各村(里),嘉義縣,　布袋鎮,東港里,38,410,862,1310,20,1330,0,1330,510,1840,72.2826
第15任總統副總統,在嘉義縣各村(里),嘉義縣,　布袋鎮,江山里,10,71,132,213,2,215,0,215,67,282,76.2411
第15任總統副總統,在嘉義縣各村(里),嘉義縣,　布袋鎮,菜舖里,9,118,148,275,5,280,0,280,130,410,68.2927
第15任總統副總統,在嘉義縣各村(里),嘉義縣,　布袋鎮,考試里,0,69,124,193,1,194,0,194,92,286,67.8322
第15任總統副總統,在嘉義縣各村(里),嘉義縣,　布袋鎮,新岑里,18,188,470,676,1,677,0,677,244,921,73.5071
第15任總統副總統,在嘉義縣各村(里),嘉義縣,　布袋鎮,新民里,23,283,573,879,9,888,0,888,384,1272,69.8113
第15任總統副總統,在嘉義縣各村(里),嘉義縣,　布袋鎮,復興里,73,506,1033,1612,17,1629,0,1629,672,2301,70.7953
第15任總統副總統,在嘉義縣各村(里),嘉義縣,　布袋鎮,好美里,21,198,510,729,14,743,0,743,325,1068,69.5693
第15任總統副總統,在嘉義縣各村(里),嘉義縣,　大林鎮,東林里,20,131,213,364,3,367,0,367,110,477,76.9392
第15任總統副總統,在嘉義縣各村(里),嘉義縣,　大林鎮,西林里,61,470,866,1397,9,1406,0,1406,406,1812,77.5938
第15任總統副總統,在嘉義縣各村(里),嘉義縣,　大林鎮,吉林里,21,269,369,659,7,666,0,666,219,885,75.2542
第15任總統副總統,在嘉義縣各村(里),嘉義縣,　大林鎮,平林里,179,1459,2562,4200,50,4250,0,4250,1414,5664,75.0353
第15任總統副總統,在嘉義縣各村(里),嘉義縣,　大林鎮,明華里,22,233,557,812,19,831,0,831,287,1118,74.3292
第15任總統副總統,在嘉義縣各村(里),嘉義縣,　大林鎮,明和里,49,416,786,1251,9,1260,2,1262,453,1715,73.4694
第15任總統副總統,在嘉義縣各村(里),嘉義縣,　大林鎮,排路里,17,92,303,412,1,413,0,413,168,581,71.0843
第15任總統副總統,在嘉義縣各村(里),嘉義縣,　大林鎮,西結里,15,87,383,485,7,492,0,492,201,693,70.9957
第15任總統副總統,在嘉義縣各村(里),嘉義縣,　大林鎮,湖北里,21,130,280,431,6,437,0,437,161,598,73.0769
第15任總統副總統,在嘉義縣各村(里),嘉義縣,　大林鎮,大糖里,3,65,61,129,3,132,0,132,57,189,69.8413
第15任總統副總統,在嘉義縣各村(里),嘉義縣,　大林鎮,大美里,44,397,616,1057,19,1076,0,1076,480,1556,69.1517
第15任總統副總統,在嘉義縣各村(里),嘉義縣,　大林鎮,過溪里,21,374,595,990,9,999,0,999,394,1393,71.7157
第15任總統副總統,在嘉義縣各村(里),嘉義縣,　大林鎮,中坑里,33,320,534,887,11,898,0,898,405,1303,68.9179
第15任總統副總統,在嘉義縣各村(里),嘉義縣,　大林鎮,上林里,13,189,364,566,11,577,0,577,207,784,73.5969
第15任總統副總統,在嘉義縣各村(里),嘉義縣,　大林鎮,中林里,36,265,825,1126,12,1138,0,1138,387,1525,74.6230
第15任總統副總統,在嘉義縣各村(里),嘉義縣,　大林鎮,三和里,56,500,847,1403,17,1420,0,1420,560,1980,71.7172
第15任總統副總統,在嘉義縣各村(里),嘉義縣,　大林鎮,溝背里,23,197,445,665,5,670,0,670,213,883,75.8777
第15任總統副總統,在嘉義縣各村(里),嘉義縣,　大林鎮,義和里,21,177,275,473,7,480,0,480,170,650,73.8462
第15任總統副總統,在嘉義縣各村(里),嘉義縣,　大林鎮,內林里,13,184,261,458,7,465,0,465,171,636,73.1132
第15任總統副總統,在嘉義縣各村(里),嘉義縣,　大林鎮,三角里,22,246,324,592,3,595,0,595,217,812,73.2759
第15任總統副總統,在嘉義縣各村(里),嘉義縣,　大林鎮,三村里,30,195,373,598,10,608,0,608,197,805,75.5280
第15任總統副總統,在嘉義縣各村(里),嘉義縣,　民雄鄉,東榮村,67,597,986,1650,23,1673,0,1673,589,2262,73.9611
第15任總統副總統,在嘉義縣各村(里),嘉義縣,　民雄鄉,中樂村,38,438,688,1164,21,1185,0,1185,336,1521,77.9093
第15任總統副總統,在嘉義縣各村(里),嘉義縣,　民雄鄉,西安村,105,777,1608,2490,22,2512,0,2512,758,3270,76.8196
第15任總統副總統,在嘉義縣各村(里),嘉義縣,　民雄鄉,寮頂村,54,462,1062,1578,25,1603,0,1603,483,2086,76.8456
第15任總統副總統,在嘉義縣各村(里),嘉義縣,　民雄鄉,福權村,54,294,829,1177,15,1192,0,1192,322,1514,78.7318
第15任總統副總統,在嘉義縣各村(里),嘉義縣,　民雄鄉,東湖村,64,428,805,1297,17,1314,0,1314,510,1824,72.0395
第15任總統副總統,在嘉義縣各村(里),嘉義縣,　民雄鄉,頂崙村,34,309,672,1015,11,1026,0,1026,371,1397,73.4431
第15任總統副總統,在嘉義縣各村(里),嘉義縣,　民雄鄉,菁埔村,30,239,988,1257,8,1265,0,1265,410,1675,75.5224
第15任總統副總統,在嘉義縣各村(里),嘉義縣,　民雄鄉,中和村,21,231,434,686,12,698,0,698,234,932,74.8927
第15任總統副總統,在嘉義縣各村(里),嘉義縣,　民雄鄉,平和村,23,157,419,599,7,606,0,606,195,801,75.6554
第15任總統副總統,在嘉義縣各村(里),嘉義縣,　民雄鄉,西昌村,31,142,417,590,11,601,0,601,205,806,74.5658
第15任總統副總統,在嘉義縣各村(里),嘉義縣,　民雄鄉,豊收村,63,495,941,1499,24,1523,0,1523,580,2103,72.4204
第15任總統副總統,在嘉義縣各村(里),嘉義縣,　民雄鄉,三興村,32,313,609,954,11,965,0,965,310,1275,75.6863
第15任總統副總統,在嘉義縣各村(里),嘉義縣,　民雄鄉,東興村,8,119,233,360,7,367,0,367,158,525,69.9048
第15任總統副總統,在嘉義縣各村(里),嘉義縣,　民雄鄉,鎮北村,29,258,526,813,16,829,0,829,222,1051,78.8773
第15任總統副總統,在嘉義縣各村(里),嘉義縣,　民雄鄉,北斗村,182,1132,2321,3635,42,3677,1,3678,1352,5030,73.1014
第15任總統副總統,在嘉義縣各村(里),嘉義縣,　民雄鄉,双福村,65,605,985,1655,27,1682,0,1682,622,2304,73.0035
第15任總統副總統,在嘉義縣各村(里),嘉義縣,　民雄鄉,福樂村,210,1499,2889,4598,32,4630,0,4630,1616,6246,74.1274
第15任總統副總統,在嘉義縣各村(里),嘉義縣,　民雄鄉,大崎村,60,572,1050,1682,18,1700,0,1700,619,2319,73.3075
第15任總統副總統,在嘉義縣各村(里),嘉義縣,　民雄鄉,秀林村,75,518,1245,1838,14,1852,0,1852,648,2500,74.0800
第15任總統副總統,在嘉義縣各村(里),嘉義縣,　民雄鄉,松山村,43,351,714,1108,28,1136,0,1136,522,1658,68.5163
第15任總統副總統,在嘉義縣各村(里),嘉義縣,　民雄鄉,興中村,45,412,858,1315,14,1329,0,1329,480,1809,73.4660
第15任總統副總統,在嘉義縣各村(里),嘉義縣,　民雄鄉,興南村,78,568,1236,1882,28,1910,1,1911,781,2692,70.9510
第15任總統副總統,在嘉義縣各村(里),嘉義縣,　民雄鄉,金興村,103,739,1295,2137,18,2155,0,2155,742,2897,74.3873
第15任總統副總統,在嘉義縣各村(里),嘉義縣,　民雄鄉,福興村,64,394,1006,1464,13,1477,0,1477,474,1951,75.7048
第15任總統副總統,在嘉義縣各村(里),嘉義縣,　民雄鄉,文隆村,70,591,1085,1746,26,1772,0,1772,573,2345,75.5650
第15任總統副總統,在嘉義縣各村(里),嘉義縣,　民雄鄉,山中村,94,732,1772,2598,31,2629,0,2629,841,3470,75.7637
第15任總統副總統,在嘉義縣各村(里),嘉義縣,　民雄鄉,中央村,31,204,683,918,11,929,0,929,329,1258,73.8474
第15任總統副總統,在嘉義縣各村(里),嘉義縣,　溪口鄉,溪東村,30,283,615,928,13,941,0,941,304,1245,75.5823
第15任總統副總統,在嘉義縣各村(里),嘉義縣,　溪口鄉,溪西村,19,152,315,486,6,492,0,492,156,648,75.9259
第15任總統副總統,在嘉義縣各村(里),嘉義縣,　溪口鄉,溪北村,22,135,322,479,2,481,0,481,183,664,72.4398
第15任總統副總統,在嘉義縣各村(里),嘉義縣,　溪口鄉,柳溝村,39,236,636,911,11,922,0,922,310,1232,74.8377
第15任總統副總統,在嘉義縣各村(里),嘉義縣,　溪口鄉,疊溪村,22,176,544,742,8,750,0,750,270,1020,73.5294
第15任總統副總統,在嘉義縣各村(里),嘉義縣,　溪口鄉,妙崙村,15,142,322,479,8,487,0,487,187,674,72.2552
第15任總統副總統,在嘉義縣各村(里),嘉義縣,　溪口鄉,坪頂村,26,145,442,613,6,619,0,619,224,843,73.4282
第15任總統副總統,在嘉義縣各村(里),嘉義縣,　溪口鄉,柴林村,9,120,377,506,4,510,0,510,236,746,68.3646
第15任總統副總統,在嘉義縣各村(里),嘉義縣,　溪口鄉,林腳村,17,103,384,504,10,514,0,514,252,766,67.1018
第15任總統副總統,在嘉義縣各村(里),嘉義縣,　溪口鄉,美南村,25,176,609,810,8,818,0,818,305,1123,72.8406
第15任總統副總統,在嘉義縣各村(里),嘉義縣,　溪口鄉,美北村,25,185,493,703,10,713,0,713,257,970,73.5052
第15任總統副總統,在嘉義縣各村(里),嘉義縣,　溪口鄉,本厝村,22,194,449,665,7,672,0,672,254,926,72.5702
第15任總統副總統,在嘉義縣各村(里),嘉義縣,　溪口鄉,游西村,7,101,366,474,3,477,0,477,207,684,69.7368
第15任總統副總統,在嘉義縣各村(里),嘉義縣,　溪口鄉,游東村,26,157,492,675,3,678,0,678,289,967,70.1138
第15任總統副總統,在嘉義縣各村(里),嘉義縣,　新港鄉,宮前村,58,561,1044,1663,11,1674,0,1674,438,2112,79.2614
第15任總統副總統,在嘉義縣各村(里),嘉義縣,　新港鄉,宮後村,34,292,747,1073,14,1087,0,1087,433,1520,71.5132
第15任總統副總統,在嘉義縣各村(里),嘉義縣,　新港鄉,大興村,36,284,740,1060,12,1072,0,1072,328,1400,76.5714
第15任總統副總統,在嘉義縣各村(里),嘉義縣,　新港鄉,福德村,30,347,747,1124,12,1136,0,1136,423,1559,72.8672
第15任總統副總統,在嘉義縣各村(里),嘉義縣,　新港鄉,古民村,25,186,709,920,8,928,0,928,353,1281,72.4434
第15任總統副總統,在嘉義縣各村(里),嘉義縣,　新港鄉,中庄村,28,241,845,1114,25,1139,0,1139,396,1535,74.2020
第15任總統副總統,在嘉義縣各村(里),嘉義縣,　新港鄉,大潭村,45,241,841,1127,19,1146,0,1146,431,1577,72.6696
第15任總統副總統,在嘉義縣各村(里),嘉義縣,　新港鄉,西庄村,21,191,412,624,8,632,0,632,277,909,69.5270
第15任總統副總統,在嘉義縣各村(里),嘉義縣,　新港鄉,埤子村,10,85,265,360,3,363,0,363,168,531,68.3616
第15任總統副總統,在嘉義縣各村(里),嘉義縣,　新港鄉,南崙村,16,70,566,652,4,656,0,656,237,893,73.4602
第15任總統副總統,在嘉義縣各村(里),嘉義縣,　新港鄉,北崙村,7,39,257,303,2,305,0,305,152,457,66.7396
第15任總統副總統,在嘉義縣各村(里),嘉義縣,　新港鄉,海瀛村,9,95,252,356,3,359,0,359,116,475,75.5789
第15任總統副總統,在嘉義縣各村(里),嘉義縣,　新港鄉,月眉村,41,267,928,1236,11,1247,0,1247,381,1628,76.5971
第15任總統副總統,在嘉義縣各村(里),嘉義縣,　新港鄉,月潭村,30,245,807,1082,11,1093,0,1093,428,1521,71.8606
第15任總統副總統,在嘉義縣各村(里),嘉義縣,　新港鄉,溪北村,23,248,697,968,11,979,0,979,320,1299,75.3657
第15任總統副總統,在嘉義縣各村(里),嘉義縣,　新港鄉,菜公村,37,185,452,674,7,681,0,681,253,934,72.9122
第15任總統副總統,在嘉義縣各村(里),嘉義縣,　新港鄉,中洋村,34,204,498,736,3,739,0,739,243,982,75.2546
第15任總統副總統,在嘉義縣各村(里),嘉義縣,　新港鄉,三間村,44,310,691,1045,13,1058,0,1058,337,1395,75.8423
第15任總統副總統,在嘉義縣各村(里),嘉義縣,　新港鄉,安和村,20,140,509,669,13,682,0,682,299,981,69.5209
第15任總統副總統,在嘉義縣各村(里),嘉義縣,　新港鄉,潭大村,23,174,566,763,13,776,0,776,323,1099,70.6096
第15任總統副總統,在嘉義縣各村(里),嘉義縣,　新港鄉,南港村,27,206,496,729,1,730,0,730,282,1012,72.1344
第15任總統副總統,在嘉義縣各村(里),嘉義縣,　新港鄉,板頭村,13,110,260,383,3,386,0,386,153,539,71.6141
第15任總統副總統,在嘉義縣各村(里),嘉義縣,　新港鄉,共和村,17,157,403,577,5,582,0,582,240,822,70.8029
第15任總統副總統,在嘉義縣各村(里),嘉義縣,　六腳鄉,蒜頭村,29,276,485,790,9,799,0,799,333,1132,70.5830
第15任總統副總統,在嘉義縣各村(里),嘉義縣,　六腳鄉,蒜東村,18,159,328,505,10,515,0,515,279,794,64.8615
第15任總統副總統,在嘉義縣各村(里),嘉義縣,　六腳鄉,蒜南村,22,152,426,600,5,605,0,605,211,816,74.1422
第15任總統副總統,在嘉義縣各村(里),嘉義縣,　六腳鄉,工廠村,6,94,49,149,4,153,0,153,55,208,73.5577
第15任總統副總統,在嘉義縣各村(里),嘉義縣,　六腳鄉,灣南村,28,238,561,827,15,842,0,842,315,1157,72.7744
第15任總統副總統,在嘉義縣各村(里),嘉義縣,　六腳鄉,灣北村,24,289,495,808,14,822,0,822,329,1151,71.4162
第15任總統副總統,在嘉義縣各村(里),嘉義縣,　六腳鄉,雙涵村,28,131,435,594,5,599,0,599,265,864,69.3287
第15任總統副總統,在嘉義縣各村(里),嘉義縣,　六腳鄉,塗師村,7,80,325,412,5,417,0,417,184,601,69.3844
第15任總統副總統,在嘉義縣各村(里),嘉義縣,　六腳鄉,三義村,13,94,384,491,6,497,0,497,238,735,67.6190
第15任總統副總統,在嘉義縣各村(里),嘉義縣,　六腳鄉,正義村,24,215,737,976,14,990,0,990,381,1371,72.2101
第15任總統副總統,在嘉義縣各村(里),嘉義縣,　六腳鄉,溪厝村,15,99,281,395,6,401,0,401,188,589,68.0815
第15任總統副總統,在嘉義縣各村(里),嘉義縣,　六腳鄉,港美村,14,68,373,455,9,464,0,464,233,697,66.5710
第15任總統副總統,在嘉義縣各村(里),嘉義縣,　六腳鄉,豐美村,12,181,522,715,10,725,0,725,282,1007,71.9960
第15任總統副總統,在嘉義縣各村(里),嘉義縣,　六腳鄉,六斗村,19,160,455,634,7,641,0,641,280,921,69.5983
第15任總統副總統,在嘉義縣各村(里),嘉義縣,　六腳鄉,崙陽村,21,183,525,729,9,738,0,738,284,1022,72.2114
第15任總統副總統,在嘉義縣各村(里),嘉義縣,　六腳鄉,蘇厝村,35,251,726,1012,15,1027,0,1027,399,1426,72.0196
第15任總統副總統,在嘉義縣各村(里),嘉義縣,　六腳鄉,竹本村,11,94,272,377,1,378,0,378,221,599,63.1052
第15任總統副總統,在嘉義縣各村(里),嘉義縣,　六腳鄉,永賢村,9,74,209,292,3,295,0,295,173,468,63.0342
第15任總統副總統,在嘉義縣各村(里),嘉義縣,　六腳鄉,魚寮村,10,87,288,385,5,390,0,390,228,618,63.1068
第15任總統副總統,在嘉義縣各村(里),嘉義縣,　六腳鄉,潭墘村,19,173,354,546,9,555,0,555,282,837,66.3082
第15任總統副總統,在嘉義縣各村(里),嘉義縣,　六腳鄉,六腳村,11,176,274,461,12,473,0,473,255,728,64.9725
第15任總統副總統,在嘉義縣各村(里),嘉義縣,　六腳鄉,六南村,11,91,242,344,4,348,0,348,185,533,65.2908
第15任總統副總統,在嘉義縣各村(里),嘉義縣,　六腳鄉,崩山村,13,99,290,402,11,413,0,413,208,621,66.5056
第15任總統副總統,在嘉義縣各村(里),嘉義縣,　六腳鄉,古林村,5,93,358,456,6,462,0,462,204,666,69.3694
第15任總統副總統,在嘉義縣各村(里),嘉義縣,　六腳鄉,更寮村,8,109,273,390,7,397,0,397,170,567,70.0176
第15任總統副總統,在嘉義縣各村(里),嘉義縣,　東石鄉,東石村,48,377,836,1261,15,1276,0,1276,575,1851,68.9357
第15任總統副總統,在嘉義縣各村(里),嘉義縣,　東石鄉,猿樹村,12,196,373,581,9,590,0,590,319,909,64.9065
第15任總統副總統,在嘉義縣各村(里),嘉義縣,　東石鄉,型厝村,37,314,531,882,14,896,0,896,425,1321,67.8274
第15任總統副總統,在嘉義縣各村(里),嘉義縣,　東石鄉,塭港村,44,415,602,1061,25,1086,0,1086,516,1602,67.7903
第15任總統副總統,在嘉義縣各村(里),嘉義縣,　東石鄉,三家村,26,261,455,742,11,753,0,753,343,1096,68.7044
第15任總統副總統,在嘉義縣各村(里),嘉義縣,　東石鄉,永屯村,24,174,281,479,8,487,0,487,192,679,71.7231
第15任總統副總統,在嘉義縣各村(里),嘉義縣,　東石鄉,海埔村,6,77,166,249,5,254,0,254,136,390,65.1282
第15任總統副總統,在嘉義縣各村(里),嘉義縣,　東石鄉,龍港村,17,264,261,542,8,550,0,550,275,825,66.6667
第15任總統副總統,在嘉義縣各村(里),嘉義縣,　東石鄉,副瀨村,22,182,390,594,9,603,0,603,273,876,68.8356
第15任總統副總統,在嘉義縣各村(里),嘉義縣,　東石鄉,下揖村,19,125,336,480,9,489,0,489,230,719,68.0111
第15任總統副總統,在嘉義縣各村(里),嘉義縣,　東石鄉,頂揖村,5,66,169,240,4,244,0,244,120,364,67.0330
第15任總統副總統,在嘉義縣各村(里),嘉義縣,　東石鄉,溪下村,19,181,369,569,11,580,0,580,387,967,59.9793
第15任總統副總統,在嘉義縣各村(里),嘉義縣,　東石鄉,港口村,9,78,104,191,2,193,0,193,99,292,66.0959
第15任總統副總統,在嘉義縣各村(里),嘉義縣,　東石鄉,鰲鼓村,23,260,546,829,10,839,0,839,387,1226,68.4339
第15任總統副總統,在嘉義縣各村(里),嘉義縣,　東石鄉,港墘村,27,279,556,862,13,875,0,875,297,1172,74.6587
第15任總統副總統,在嘉義縣各村(里),嘉義縣,　東石鄉,蔦松村,27,184,360,571,10,581,0,581,251,832,69.8317
第15任總統副總統,在嘉義縣各村(里),嘉義縣,　東石鄉,圍潭村,12,134,302,448,7,455,0,455,208,663,68.6275
第15任總統副總統,在嘉義縣各村(里),嘉義縣,　東石鄉,洲仔村,21,197,359,577,8,585,0,585,229,814,71.8673
第15任總統副總統,在嘉義縣各村(里),嘉義縣,　東石鄉,東崙村,17,131,271,419,5,424,0,424,251,675,62.8148
第15任總統副總統,在嘉義縣各村(里),嘉義縣,　東石鄉,西崙村,22,208,494,724,14,738,1,739,307,1046,70.5545
第15任總統副總統,在嘉義縣各村(里),嘉義縣,　東石鄉,塭仔村,23,158,424,605,6,611,0,611,265,876,69.7489
第15任總統副總統,在嘉義縣各村(里),嘉義縣,　東石鄉,網寮村,32,260,445,737,4,741,0,741,436,1177,62.9567
第15任總統副總統,在嘉義縣各村(里),嘉義縣,　東石鄉,掌潭村,20,210,313,543,11,554,0,554,219,773,71.6688
第15任總統副總統,在嘉義縣各村(里),嘉義縣,　義竹鄉,岸腳村,18,129,312,459,8,467,0,467,201,668,69.9102
第15任總統副總統,在嘉義縣各村(里),嘉義縣,　義竹鄉,義竹村,46,347,694,1087,11,1098,0,1098,356,1454,75.5158
第15任總統副總統,在嘉義縣各村(里),嘉義縣,　義竹鄉,六桂村,24,301,506,831,12,843,0,843,278,1121,75.2007
第15任總統副總統,在嘉義縣各村(里),嘉義縣,　義竹鄉,仁里村,17,247,387,651,7,658,0,658,186,844,77.9621
第15任總統副總統,在嘉義縣各村(里),嘉義縣,　義竹鄉,傳芳村,18,175,334,527,8,535,0,535,191,726,73.6915
第15任總統副總統,在嘉義縣各村(里),嘉義縣,　義竹鄉,頭竹村,16,221,655,892,10,902,0,902,285,1187,75.9899
第15任總統副總統,在嘉義縣各村(里),嘉義縣,　義竹鄉,五厝村,15,95,172,282,3,285,0,285,86,371,76.8194
第15任總統副總統,在嘉義縣各村(里),嘉義縣,　義竹鄉,中平村,12,118,180,310,4,314,0,314,113,427,73.5363
第15任總統副總統,在嘉義縣各村(里),嘉義縣,　義竹鄉,埤前村,18,215,319,552,7,559,0,559,162,721,77.5312
第15任總統副總統,在嘉義縣各村(里),嘉義縣,　義竹鄉,平溪村,5,84,239,328,2,330,0,330,95,425,77.6471
第15任總統副總統,在嘉義縣各村(里),嘉義縣,　義竹鄉,後鎮村,8,99,193,300,5,305,0,305,114,419,72.7924
第15任總統副總統,在嘉義縣各村(里),嘉義縣,　義竹鄉,北華村,13,131,295,439,10,449,0,449,131,580,77.4138
第15任總統副總統,在嘉義縣各村(里),嘉義縣,　義竹鄉,新店村,30,296,727,1053,13,1066,0,1066,371,1437,74.1823
第15任總統副總統,在嘉義縣各村(里),嘉義縣,　義竹鄉,東過村,35,159,364,558,10,568,0,568,246,814,69.7789
第15任總統副總統,在嘉義縣各村(里),嘉義縣,　義竹鄉,西過村,13,152,357,522,9,531,0,531,246,777,68.3398
第15任總統副總統,在嘉義縣各村(里),嘉義縣,　義竹鄉,官和村,17,117,418,552,13,565,0,565,237,802,70.4489
第15任總統副總統,在嘉義縣各村(里),嘉義縣,　義竹鄉,官順村,6,75,185,266,4,270,0,270,140,410,65.8537
第15任總統副總統,在嘉義縣各村(里),嘉義縣,　義竹鄉,新富村,20,152,203,375,8,383,0,383,150,533,71.8574
第15任總統副總統,在嘉義縣各村(里),嘉義縣,　義竹鄉,東光村,15,166,332,513,11,524,0,524,189,713,73.4923
第15任總統副總統,在嘉義縣各村(里),嘉義縣,　義竹鄉,東榮村,11,86,173,270,4,274,0,274,106,380,72.1053
第15任總統副總統,在嘉義縣各村(里),嘉義縣,　義竹鄉,龍蛟村,14,142,233,389,2,391,0,391,161,552,70.8333
第15任總統副總統,在嘉義縣各村(里),嘉義縣,　義竹鄉,溪洲村,13,109,337,459,6,465,0,465,171,636,73.1132
第15任總統副總統,在嘉義縣各村(里),嘉義縣,　鹿草鄉,後寮村,12,80,267,359,4,363,0,363,152,515,70.4854
第15任總統副總統,在嘉義縣各村(里),嘉義縣,　鹿草鄉,鹿東村,13,96,283,392,3,395,0,395,151,546,72.3443
第15任總統副總統,在嘉義縣各村(里),嘉義縣,　鹿草鄉,鹿草村,36,302,576,914,15,929,0,929,327,1256,73.9650
第15任總統副總統,在嘉義縣各村(里),嘉義縣,　鹿草鄉,西井村,23,326,544,893,14,907,0,907,385,1292,70.2012
第15任總統副總統,在嘉義縣各村(里),嘉義縣,　鹿草鄉,豊稠村,6,121,209,336,3,339,0,339,411,750,45.2000
第15任總統副總統,在嘉義縣各村(里),嘉義縣,　鹿草鄉,重寮村,15,171,510,696,16,712,0,712,289,1001,71.1289
第15任總統副總統,在嘉義縣各村(里),嘉義縣,　鹿草鄉,施家村,4,84,220,308,3,311,0,311,130,441,70.5215
第15任總統副總統,在嘉義縣各村(里),嘉義縣,　鹿草鄉,下潭村,17,125,406,548,8,556,0,556,240,796,69.8492
第15任總統副總統,在嘉義縣各村(里),嘉義縣,　鹿草鄉,光潭村,13,176,503,692,11,703,0,703,294,997,70.5115
第15任總統副總統,在嘉義縣各村(里),嘉義縣,　鹿草鄉,碧潭村,16,234,371,621,13,634,0,634,292,926,68.4665
第15任總統副總統,在嘉義縣各村(里),嘉義縣,　鹿草鄉,松竹村,13,185,407,605,17,622,0,622,304,926,67.1706
第15任總統副總統,在嘉義縣各村(里),嘉義縣,　鹿草鄉,竹山村,21,152,451,624,8,632,0,632,275,907,69.6803
第15任總統副總統,在嘉義縣各村(里),嘉義縣,　鹿草鄉,後堀村,22,239,576,837,8,845,0,845,308,1153,73.2871
第15任總統副總統,在嘉義縣各村(里),嘉義縣,　鹿草鄉,三角村,30,278,696,1004,21,1025,0,1025,358,1383,74.1142
第15任總統副總統,在嘉義縣各村(里),嘉義縣,　鹿草鄉,下麻村,10,156,257,423,7,430,0,430,153,583,73.7564
第15任總統副總統,在嘉義縣各村(里),嘉義縣,　水上鄉,水上村,133,1053,1730,2916,36,2952,0,2952,938,3890,75.8869
第15任總統副總統,在嘉義縣各村(里),嘉義縣,　水上鄉,水頭村,80,683,1129,1892,20,1912,0,1912,490,2402,79.6003
第15任總統副總統,在嘉義縣各村(里),嘉義縣,　水上鄉,粗溪村,44,356,692,1092,16,1108,0,1108,397,1505,73.6213
第15任總統副總統,在嘉義縣各村(里),嘉義縣,　水上鄉,下寮村,40,451,869,1360,12,1372,0,1372,419,1791,76.6052
第15任總統副總統,在嘉義縣各村(里),嘉義縣,　水上鄉,三和村,60,484,763,1307,14,1321,0,1321,437,1758,75.1422
第15任總統副總統,在嘉義縣各村(里),嘉義縣,　水上鄉,回歸村,11,140,181,332,3,335,0,335,97,432,77.5463
第15任總統副總統,在嘉義縣各村(里),嘉義縣,　水上鄉,大堀村,31,344,876,1251,22,1273,0,1273,312,1585,80.3155
第15任總統副總統,在嘉義縣各村(里),嘉義縣,　水上鄉,大崙村,51,412,992,1455,19,1474,0,1474,559,2033,72.5037
第15任總統副總統,在嘉義縣各村(里),嘉義縣,　水上鄉,塗溝村,15,167,409,591,3,594,0,594,187,781,76.0563
第15任總統副總統,在嘉義縣各村(里),嘉義縣,　水上鄉,龍德村,48,400,1020,1468,22,1490,0,1490,387,1877,79.3820
第15任總統副總統,在嘉義縣各村(里),嘉義縣,　水上鄉,溪洲村,25,215,470,710,8,718,0,718,270,988,72.6721
第15任總統副總統,在嘉義縣各村(里),嘉義縣,　水上鄉,三鎮村,22,190,225,437,5,442,0,442,165,607,72.8171
第15任總統副總統,在嘉義縣各村(里),嘉義縣,　水上鄉,靖和村,14,148,167,329,2,331,0,331,75,406,81.5271
第15任總統副總統,在嘉義縣各村(里),嘉義縣,　水上鄉,南和村,36,322,607,965,12,977,0,977,340,1317,74.1838
第15任總統副總統,在嘉義縣各村(里),嘉義縣,　水上鄉,柳新村,48,506,719,1273,17,1290,0,1290,417,1707,75.5712
第15任總統副總統,在嘉義縣各村(里),嘉義縣,　水上鄉,柳林村,69,459,909,1437,19,1456,0,1456,509,1965,74.0967
第15任總統副總統,在嘉義縣各村(里),嘉義縣,　水上鄉,柳鄉村,41,408,988,1437,15,1452,0,1452,477,1929,75.2722
第15任總統副總統,在嘉義縣各村(里),嘉義縣,　水上鄉,內溪村,29,256,556,841,11,852,0,852,275,1127,75.5989
第15任總統副總統,在嘉義縣各村(里),嘉義縣,　水上鄉,寬士村,95,930,2070,3095,43,3138,0,3138,1105,4243,73.9571
第15任總統副總統,在嘉義縣各村(里),嘉義縣,　水上鄉,民生村,101,711,1332,2144,12,2156,1,2157,757,2914,73.9876
第15任總統副總統,在嘉義縣各村(里),嘉義縣,　水上鄉,義興村,20,195,369,584,8,592,0,592,199,791,74.8420
第15任總統副總統,在嘉義縣各村(里),嘉義縣,　水上鄉,中庄村,34,456,794,1284,15,1299,0,1299,440,1739,74.6981
第15任總統副總統,在嘉義縣各村(里),嘉義縣,　水上鄉,忠和村,45,503,752,1300,24,1324,0,1324,523,1847,71.6838
第15任總統副總統,在嘉義縣各村(里),嘉義縣,　水上鄉,南鄉村,19,198,408,625,6,631,0,631,246,877,71.9498
第15任總統副總統,在嘉義縣各村(里),嘉義縣,　水上鄉,三界村,17,215,446,678,6,684,0,684,269,953,71.7733
第15任總統副總統,在嘉義縣各村(里),嘉義縣,　水上鄉,國姓村,35,231,538,804,13,817,0,817,404,1221,66.9124
第15任總統副總統,在嘉義縣各村(里),嘉義縣,　中埔鄉,富收村,88,630,1309,2027,20,2047,0,2047,740,2787,73.4482
第15任總統副總統,在嘉義縣各村(里),嘉義縣,　中埔鄉,和睦村,72,776,1491,2339,20,2359,0,2359,892,3251,72.5623
第15任總統副總統,在嘉義縣各村(里),嘉義縣,　中埔鄉,和美村,177,1837,3034,5048,43,5091,0,5091,1825,6916,73.6119
第15任總統副總統,在嘉義縣各村(里),嘉義縣,　中埔鄉,和興村,140,1253,2434,3827,53,3880,2,3882,1607,5489,70.6868
第15任總統副總統,在嘉義縣各村(里),嘉義縣,　中埔鄉,中埔村,46,416,798,1260,12,1272,0,1272,478,1750,72.6857
第15任總統副總統,在嘉義縣各村(里),嘉義縣,　中埔鄉,塩舘村,19,217,419,655,4,659,0,659,261,920,71.6304
第15任總統副總統,在嘉義縣各村(里),嘉義縣,　中埔鄉,金蘭村,37,306,607,950,10,960,0,960,465,1425,67.3684
第15任總統副總統,在嘉義縣各村(里),嘉義縣,　中埔鄉,隆興村,45,476,747,1268,8,1276,0,1276,535,1811,70.4583
第15任總統副總統,在嘉義縣各村(里),嘉義縣,　中埔鄉,義仁村,40,319,697,1056,10,1066,0,1066,364,1430,74.5455
第15任總統副總統,在嘉義縣各村(里),嘉義縣,　中埔鄉,社口村,40,520,843,1403,14,1417,0,1417,615,2032,69.7343
第15任總統副總統,在嘉義縣各村(里),嘉義縣,　中埔鄉,灣潭村,28,253,403,684,8,692,0,692,320,1012,68.3794
第15任總統副總統,在嘉義縣各村(里),嘉義縣,　中埔鄉,裕民村,18,128,431,577,3,580,0,580,271,851,68.1551
第15任總統副總統,在嘉義縣各村(里),嘉義縣,　中埔鄉,龍門村,22,206,334,562,5,567,0,567,220,787,72.0457
第15任總統副總統,在嘉義縣各村(里),嘉義縣,　中埔鄉,石硦村,30,285,509,824,5,829,0,829,306,1135,73.0396
第15任總統副總統,在嘉義縣各村(里),嘉義縣,　中埔鄉,頂埔村,20,199,437,656,4,660,0,660,271,931,70.8915
第15任總統副總統,在嘉義縣各村(里),嘉義縣,　中埔鄉,同仁村,45,394,860,1299,17,1316,0,1316,531,1847,71.2507
第15任總統副總統,在嘉義縣各村(里),嘉義縣,　中埔鄉,深坑村,21,182,335,538,6,544,0,544,178,722,75.3463
第15任總統副總統,在嘉義縣各村(里),嘉義縣,　中埔鄉,三層村,15,128,290,433,4,437,0,437,188,625,69.9200
第15任總統副總統,在嘉義縣各村(里),嘉義縣,　中埔鄉,瑞豐村,27,178,306,511,9,520,0,520,195,715,72.7273
第15任總統副總統,在嘉義縣各村(里),嘉義縣,　中埔鄉,沄水村,28,228,442,698,10,708,0,708,262,970,72.9897
第15任總統副總統,在嘉義縣各村(里),嘉義縣,　中埔鄉,東興村,15,109,127,251,0,251,0,251,88,339,74.0413
第15任總統副總統,在嘉義縣各村(里),嘉義縣,　中埔鄉,中崙村,12,92,94,198,3,201,0,201,92,293,68.6007
第15任總統副總統,在嘉義縣各村(里),嘉義縣,　竹崎鄉,竹崎村,77,616,1094,1787,21,1808,0,1808,582,2390,75.6485
第15任總統副總統,在嘉義縣各村(里),嘉義縣,　竹崎鄉,和平村,67,486,946,1499,13,1512,0,1512,605,2117,71.4218
第15任總統副總統,在嘉義縣各村(里),嘉義縣,　竹崎鄉,坑頭村,17,172,314,503,5,508,0,508,220,728,69.7802
第15任總統副總統,在嘉義縣各村(里),嘉義縣,　竹崎鄉,沙坑村,16,152,423,591,13,604,0,604,207,811,74.4760
第15任總統副總統,在嘉義縣各村(里),嘉義縣,　竹崎鄉,獅埜村,27,263,607,897,7,904,0,904,281,1185,76.2869
第15任總統副總統,在嘉義縣各村(里),嘉義縣,　竹崎鄉,義和村,19,153,305,477,3,480,0,480,112,592,81.0811
第15任總統副總統,在嘉義縣各村(里),嘉義縣,　竹崎鄉,義仁村,24,226,466,716,5,721,0,721,288,1009,71.4569
第15任總統副總統,在嘉義縣各村(里),嘉義縣,　竹崎鄉,灣橋村,136,1356,2231,3723,25,3748,0,3748,1391,5139,72.9325
第15任總統副總統,在嘉義縣各村(里),嘉義縣,　竹崎鄉,鹿滿村,36,337,644,1017,16,1033,0,1033,350,1383,74.6927
第15任總統副總統,在嘉義縣各村(里),嘉義縣,　竹崎鄉,紫雲村,54,334,577,965,8,973,0,973,395,1368,71.1257
第15任總統副總統,在嘉義縣各村(里),嘉義縣,　竹崎鄉,內埔村,56,373,717,1146,11,1157,0,1157,390,1547,74.7899
第15任總統副總統,在嘉義縣各村(里),嘉義縣,　竹崎鄉,昇平村,36,406,718,1160,16,1176,0,1176,536,1712,68.6916
第15任總統副總統,在嘉義縣各村(里),嘉義縣,　竹崎鄉,桃源村,23,258,404,685,6,691,0,691,291,982,70.3666
第15任總統副總統,在嘉義縣各村(里),嘉義縣,　竹崎鄉,白杞村,19,190,241,450,6,456,0,456,171,627,72.7273
第15任總統副總統,在嘉義縣各村(里),嘉義縣,　竹崎鄉,塘興村,26,262,304,592,9,601,0,601,230,831,72.3225
第15任總統副總統,在嘉義縣各村(里),嘉義縣,　竹崎鄉,義隆村,22,177,250,449,10,459,0,459,157,616,74.5130
第15任總統副總統,在嘉義縣各村(里),嘉義縣,　竹崎鄉,龍山村,41,348,839,1228,9,1237,0,1237,468,1705,72.5513
第15任總統副總統,在嘉義縣各村(里),嘉義縣,　竹崎鄉,文峯村,19,149,255,423,2,425,0,425,211,636,66.8239
第15任總統副總統,在嘉義縣各村(里),嘉義縣,　竹崎鄉,金獅村,18,101,172,291,4,295,0,295,110,405,72.8395
第15任總統副總統,在嘉義縣各村(里),嘉義縣,　竹崎鄉,復金村,45,435,822,1302,17,1319,0,1319,516,1835,71.8801
第15任總統副總統,在嘉義縣各村(里),嘉義縣,　竹崎鄉,緞繻村,21,227,328,576,3,579,0,579,320,899,64.4049
第15任總統副總統,在嘉義縣各村(里),嘉義縣,　竹崎鄉,仁壽村,1,27,94,122,4,126,0,126,102,228,55.2632
第15任總統副總統,在嘉義縣各村(里),嘉義縣,　竹崎鄉,中和村,29,181,333,543,5,548,0,548,221,769,71.2614
第15任總統副總統,在嘉義縣各村(里),嘉義縣,　竹崎鄉,光華村,17,175,266,458,2,460,0,460,233,693,66.3781
第15任總統副總統,在嘉義縣各村(里),嘉義縣,　梅山鄉,梅東村,49,531,997,1577,5,1582,0,1582,620,2202,71.8438
第15任總統副總統,在嘉義縣各村(里),嘉義縣,　梅山鄉,梅南村,20,261,377,658,3,661,0,661,216,877,75.3706
第15任總統副總統,在嘉義縣各村(里),嘉義縣,　梅山鄉,梅北村,133,1017,1956,3106,18,3124,0,3124,1132,4256,73.4023
第15任總統副總統,在嘉義縣各村(里),嘉義縣,　梅山鄉,過山村,15,144,233,392,9,401,0,401,132,533,75.2345
第15任總統副總統,在嘉義縣各村(里),嘉義縣,　梅山鄉,圳南村,14,95,162,271,3,274,0,274,130,404,67.8218
第15任總統副總統,在嘉義縣各村(里),嘉義縣,　梅山鄉,圳北村,23,176,236,435,3,438,0,438,172,610,71.8033
第15任總統副總統,在嘉義縣各村(里),嘉義縣,　梅山鄉,双溪村,16,160,229,405,7,412,0,412,143,555,74.2342
第15任總統副總統,在嘉義縣各村(里),嘉義縣,　梅山鄉,大南村,35,429,710,1174,15,1189,0,1189,431,1620,73.3951
第15任總統副總統,在嘉義縣各村(里),嘉義縣,　梅山鄉,安靖村,18,213,313,544,6,550,0,550,271,821,66.9915
第15任總統副總統,在嘉義縣各村(里),嘉義縣,　梅山鄉,永興村,11,150,211,372,2,374,0,374,126,500,74.8000
第15任總統副總統,在嘉義縣各村(里),嘉義縣,　梅山鄉,半天村,9,68,148,225,4,229,0,229,116,345,66.3768
第15任總統副總統,在嘉義縣各村(里),嘉義縣,　梅山鄉,太平村,12,125,193,330,7,337,0,337,154,491,68.6354
第15任總統副總統,在嘉義縣各村(里),嘉義縣,　梅山鄉,太興村,17,142,137,296,5,301,0,301,123,424,70.9906
第15任總統副總統,在嘉義縣各村(里),嘉義縣,　梅山鄉,龍眼村,11,70,192,273,3,276,0,276,121,397,69.5214
第15任總統副總統,在嘉義縣各村(里),嘉義縣,　梅山鄉,碧湖村,8,67,102,177,2,179,0,179,99,278,64.3885
第15任總統副總統,在嘉義縣各村(里),嘉義縣,　梅山鄉,瑞峯村,52,175,252,479,8,487,0,487,210,697,69.8709
第15任總統副總統,在嘉義縣各村(里),嘉義縣,　梅山鄉,瑞里村,21,214,179,414,7,421,0,421,161,582,72.3368
第15任總統副總統,在嘉義縣各村(里),嘉義縣,　梅山鄉,太和村,20,269,299,588,7,595,0,595,307,902,65.9645
第15任總統副總統,在嘉義縣各村(里),嘉義縣,　番路鄉,江西村,19,343,484,846,6,852,0,852,259,1111,76.6877
第15任總統副總統,在嘉義縣各村(里),嘉義縣,　番路鄉,內甕村,14,127,188,329,5,334,0,334,98,432,77.3148
第15任總統副總統,在嘉義縣各村(里),嘉義縣,　番路鄉,新福村,35,321,513,869,8,877,0,877,398,1275,68.7843
第15任總統副總統,在嘉義縣各村(里),嘉義縣,　番路鄉,下坑村,42,448,767,1257,16,1273,0,1273,438,1711,74.4009
第15任總統副總統,在嘉義縣各村(里),嘉義縣,　番路鄉,番路村,21,225,373,619,7,626,0,626,192,818,76.5281
第15任總統副總統,在嘉義縣各村(里),嘉義縣,　番路鄉,民和村,25,216,373,614,3,617,0,617,213,830,74.3373
第15任總統副總統,在嘉義縣各村(里),嘉義縣,　番路鄉,觸口村,26,351,467,844,4,848,0,848,333,1181,71.8036
第15任總統副總統,在嘉義縣各村(里),嘉義縣,　番路鄉,大湖村,7,147,218,372,3,375,0,375,223,598,62.7090
第15任總統副總統,在嘉義縣各村(里),嘉義縣,　番路鄉,公田村,47,268,341,656,7,663,0,663,289,952,69.6429
第15任總統副總統,在嘉義縣各村(里),嘉義縣,　番路鄉,公興村,12,141,155,308,4,312,0,312,181,493,63.2860
第15任總統副總統,在嘉義縣各村(里),嘉義縣,　番路鄉,草山村,25,120,87,232,4,236,0,236,127,363,65.0138
第15任總統副總統,在嘉義縣各村(里),嘉義縣,　大埔鄉,大埔村,23,305,491,819,8,827,0,827,585,1412,58.5694
第15任總統副總統,在嘉義縣各村(里),嘉義縣,　大埔鄉,和平村,9,147,200,356,5,361,0,361,256,617,58.5089
第15任總統副總統,在嘉義縣各村(里),嘉義縣,　大埔鄉,永樂村,14,127,108,249,2,251,0,251,156,407,61.6708
第15任總統副總統,在嘉義縣各村(里),嘉義縣,　大埔鄉,茄苳村,16,200,243,459,5,464,0,464,451,915,50.7104
第15任總統副總統,在嘉義縣各村(里),嘉義縣,　大埔鄉,西興村,14,151,182,347,3,350,0,350,211,561,62.3886
第15任總統副總統,在嘉義縣各村(里),嘉義縣,　阿里山鄉,中山村,12,126,88,226,3,229,0,229,137,366,62.5683
第15任總統副總統,在嘉義縣各村(里),嘉義縣,　阿里山鄉,中正村,8,75,43,126,1,127,0,127,55,182,69.7802
第15任總統副總統,在嘉義縣各村(里),嘉義縣,　阿里山鄉,香林村,6,53,15,74,0,74,0,74,73,147,50.3401
第15任總統副總統,在嘉義縣各村(里),嘉義縣,　阿里山鄉,十字村,6,140,45,191,2,193,0,193,108,301,64.1196
第15任總統副總統,在嘉義縣各村(里),嘉義縣,　阿里山鄉,豐山村,5,101,79,185,4,189,0,189,114,303,62.3762
第15任總統副總統,在嘉義縣各村(里),嘉義縣,　阿里山鄉,來吉村,4,151,58,213,3,216,0,216,81,297,72.7273
第15任總統副總統,在嘉義縣各村(里),嘉義縣,　阿里山鄉,樂野村,37,373,237,647,7,654,0,654,270,924,70.7792
第15任總統副總統,在嘉義縣各村(里),嘉義縣,　阿里山鄉,達邦村,8,412,133,553,3,556,0,556,237,793,70.1135
第15任總統副總統,在嘉義縣各村(里),嘉義縣,　阿里山鄉,里佳村,2,114,39,155,1,156,0,156,75,231,67.5325
第15任總統副總統,在嘉義縣各村(里),嘉義縣,　阿里山鄉,山美村,6,240,63,309,2,311,0,311,160,471,66.0297
第15任總統副總統,在嘉義縣各村(里),嘉義縣,　阿里山鄉,新美村,6,127,47,180,2,182,0,182,100,282,64.5390
第15任總統副總統,在嘉義縣各村(里),嘉義縣,　阿里山鄉,茶山村,6,94,84,184,0,184,0,184,61,245,75.1020
第15任總統副總統,在高雄市各村(里),高雄市,　鹽埕區,藍橋里,30,294,662,986,7,993,0,993,256,1249,79.5036
第15任總統副總統,在高雄市各村(里),高雄市,　鹽埕區,慈愛里,4,80,183,267,1,268,0,268,58,326,82.2086
第15任總統副總統,在高雄市各村(里),高雄市,　鹽埕區,博愛里,12,130,355,497,5,502,0,502,120,622,80.7074
第15任總統副總統,在高雄市各村(里),高雄市,　鹽埕區,壽星里,18,367,547,932,7,939,0,939,340,1279,73.4167
第15任總統副總統,在高雄市各村(里),高雄市,　鹽埕區,中山里,28,296,539,863,9,872,0,872,232,1104,78.9855
第15任總統副總統,在高雄市各村(里),高雄市,　鹽埕區,教仁里,44,532,981,1557,11,1568,0,1568,387,1955,80.2046
第15任總統副總統,在高雄市各村(里),高雄市,　鹽埕區,新樂里,16,234,390,640,8,648,0,648,168,816,79.4118
第15任總統副總統,在高雄市各村(里),高雄市,　鹽埕區,中原里,12,141,298,451,6,457,0,457,125,582,78.5223
第15任總統副總統,在高雄市各村(里),高雄市,　鹽埕區,光明里,22,328,631,981,10,991,0,991,453,1444,68.6288
第15任總統副總統,在高雄市各村(里),高雄市,　鹽埕區,育仁里,21,177,379,577,10,587,0,587,166,753,77.9548
第15任總統副總統,在高雄市各村(里),高雄市,　鹽埕區,河濱里,55,407,780,1242,14,1256,0,1256,332,1588,79.0932
第15任總統副總統,在高雄市各村(里),高雄市,　鹽埕區,沙地里,11,151,356,518,4,522,0,522,167,689,75.7620
第15任總統副總統,在高雄市各村(里),高雄市,　鹽埕區,南端里,23,259,424,706,9,715,0,715,236,951,75.1840
第15任總統副總統,在高雄市各村(里),高雄市,　鹽埕區,港都里,29,251,547,827,3,830,0,830,202,1032,80.4264
第15任總統副總統,在高雄市各村(里),高雄市,　鹽埕區,江西里,20,252,560,832,8,840,0,840,224,1064,78.9474
第15任總統副總統,在高雄市各村(里),高雄市,　鹽埕區,新豐里,20,213,357,590,5,595,0,595,176,771,77.1725
第15任總統副總統,在高雄市各村(里),高雄市,　鹽埕區,府北里,39,518,933,1490,19,1509,0,1509,506,2015,74.8883
第15任總統副總統,在高雄市各村(里),高雄市,　鹽埕區,陸橋里,23,286,558,867,7,874,0,874,262,1136,76.9366
第15任總統副總統,在高雄市各村(里),高雄市,　鹽埕區,瀨南里,11,135,290,436,4,440,0,440,127,567,77.6014
第15任總統副總統,在高雄市各村(里),高雄市,　鹽埕區,新化里,10,133,295,438,13,451,0,451,96,547,82.4497
第15任總統副總統,在高雄市各村(里),高雄市,　鹽埕區,江南里,7,86,360,453,2,455,0,455,144,599,75.9599
第15任總統副總統,在高雄市各村(里),高雄市,　鼓山區,鼓峰里,47,675,703,1425,14,1439,0,1439,439,1878,76.6241
第15任總統副總統,在高雄市各村(里),高雄市,　鼓山區,雄峰里,37,841,579,1457,14,1471,0,1471,482,1953,75.3200
第15任總統副總統,在高雄市各村(里),高雄市,　鼓山區,前峰里,99,1426,1647,3172,45,3217,0,3217,817,4034,79.7471
第15任總統副總統,在高雄市各村(里),高雄市,　鼓山區,光榮里,62,698,1813,2573,24,2597,0,2597,710,3307,78.5304
第15任總統副總統,在高雄市各村(里),高雄市,　鼓山區,民族里,24,340,661,1025,8,1033,0,1033,211,1244,83.0386
第15任總統副總統,在高雄市各村(里),高雄市,　鼓山區,內惟里,22,245,552,819,11,830,0,830,235,1065,77.9343
第15任總統副總統,在高雄市各村(里),高雄市,　鼓山區,建國里,60,644,1167,1871,26,1897,0,1897,467,2364,80.2453
第15任總統副總統,在高雄市各村(里),高雄市,　鼓山區,忠正里,90,970,1755,2815,23,2838,0,2838,799,3637,78.0313
第15任總統副總統,在高雄市各村(里),高雄市,　鼓山區,自強里,14,458,78,550,3,553,0,553,145,698,79.2264
第15任總統副總統,在高雄市各村(里),高雄市,　鼓山區,龍井里,21,333,552,906,8,914,0,914,291,1205,75.8506
第15任總統副總統,在高雄市各村(里),高雄市,　鼓山區,正德里,39,421,1040,1500,10,1510,0,1510,398,1908,79.1405
第15任總統副總統,在高雄市各村(里),高雄市,　鼓山區,平和里,66,751,1804,2621,27,2648,0,2648,669,3317,79.8312
第15任總統副總統,在高雄市各村(里),高雄市,　鼓山區,民強里,65,613,1389,2067,15,2082,0,2082,506,2588,80.4482
第15任總統副總統,在高雄市各村(里),高雄市,　鼓山區,厚生里,41,697,1541,2279,14,2293,0,2293,615,2908,78.8514
第15任總統副總統,在高雄市各村(里),高雄市,　鼓山區,龍子里,369,4352,6689,11410,108,11518,0,11518,3255,14773,77.9666
第15任總統副總統,在高雄市各村(里),高雄市,　鼓山區,龍水里,615,6516,9202,16333,170,16503,0,16503,4606,21109,78.1799
第15任總統副總統,在高雄市各村(里),高雄市,　鼓山區,明誠里,392,5062,6487,11941,114,12055,0,12055,3612,15667,76.9452
第15任總統副總統,在高雄市各村(里),高雄市,　鼓山區,華豐里,111,1317,1578,3006,27,3033,0,3033,751,3784,80.1533
第15任總統副總統,在高雄市各村(里),高雄市,　鼓山區,裕興里,85,1249,1328,2662,22,2684,0,2684,784,3468,77.3933
第15任總統副總統,在高雄市各村(里),高雄市,　鼓山區,裕豐里,48,1009,903,1960,11,1971,0,1971,512,2483,79.3798
第15任總統副總統,在高雄市各村(里),高雄市,　鼓山區,鼓岩里,12,262,573,847,12,859,0,859,299,1158,74.1796
第15任總統副總統,在高雄市各村(里),高雄市,　鼓山區,樹德里,20,254,633,907,6,913,0,913,195,1108,82.4007
第15任總統副總統,在高雄市各村(里),高雄市,　鼓山區,寶樹里,22,305,558,885,6,891,0,891,911,1802,49.4451
第15任總統副總統,在高雄市各村(里),高雄市,　鼓山區,興宗里,23,342,614,979,6,985,0,985,265,1250,78.8000
第15任總統副總統,在高雄市各村(里),高雄市,　鼓山區,光化里,44,326,528,898,8,906,0,906,291,1197,75.6892
第15任總統副總統,在高雄市各村(里),高雄市,　鼓山區,山下里,32,400,545,977,13,990,0,990,309,1299,76.2125
第15任總統副總統,在高雄市各村(里),高雄市,　鼓山區,河邊里,31,426,690,1147,8,1155,0,1155,354,1509,76.5408
第15任總統副總統,在高雄市各村(里),高雄市,　鼓山區,綠川里,32,305,705,1042,7,1049,0,1049,300,1349,77.7613
第15任總統副總統,在高雄市各村(里),高雄市,　鼓山區,登山里,7,163,282,452,1,453,0,453,145,598,75.7525
第15任總統副總統,在高雄市各村(里),高雄市,　鼓山區,峰南里,11,187,420,618,5,623,0,623,195,818,76.1614
第15任總統副總統,在高雄市各村(里),高雄市,　鼓山區,麗興里,26,203,482,711,9,720,0,720,226,946,76.1099
第15任總統副總統,在高雄市各村(里),高雄市,　鼓山區,新民里,23,184,512,719,10,729,0,729,210,939,77.6358
第15任總統副總統,在高雄市各村(里),高雄市,　鼓山區,延平里,14,146,422,582,3,585,0,585,143,728,80.3571
第15任總統副總統,在高雄市各村(里),高雄市,　鼓山區,維生里,22,245,643,910,5,915,0,915,285,1200,76.2500
第15任總統副總統,在高雄市各村(里),高雄市,　鼓山區,惠安里,39,216,554,809,7,816,0,816,270,1086,75.1381
第15任總統副總統,在高雄市各村(里),高雄市,　鼓山區,壽山里,20,241,701,962,11,973,0,973,335,1308,74.3884
第15任總統副總統,在高雄市各村(里),高雄市,　鼓山區,哨船頭里,22,290,434,746,14,760,0,760,221,981,77.4720
第15任總統副總統,在高雄市各村(里),高雄市,　鼓山區,桃源里,10,158,259,427,1,428,0,428,122,550,77.8182
第15任總統副總統,在高雄市各村(里),高雄市,　左營區,進學里,35,565,664,1264,11,1275,0,1275,1274,2549,50.0196
第15任總統副總統,在高雄市各村(里),高雄市,　左營區,尾西里,29,227,523,779,8,787,0,787,203,990,79.4949
第15任總統副總統,在高雄市各村(里),高雄市,　左營區,頂北里,17,124,279,420,5,425,0,425,81,506,83.9921
第15任總統副總統,在高雄市各村(里),高雄市,　左營區,中北里,6,128,355,489,3,492,0,492,124,616,79.8701
第15任總統副總統,在高雄市各村(里),高雄市,　左營區,中南里,9,79,287,375,2,377,0,377,118,495,76.1616
第15任總統副總統,在高雄市各村(里),高雄市,　左營區,廟東里,12,113,504,629,5,634,0,634,150,784,80.8673
第15任總統副總統,在高雄市各村(里),高雄市,　左營區,廟北里,14,141,486,641,8,649,0,649,210,859,75.5530
第15任總統副總統,在高雄市各村(里),高雄市,　左營區,尾南里,12,131,404,547,6,553,0,553,153,706,78.3286
第15任總統副總統,在高雄市各村(里),高雄市,　左營區,尾北里,75,836,1550,2461,30,2491,0,2491,684,3175,78.4567
第15任總統副總統,在高雄市各村(里),高雄市,　左營區,屏山里,29,673,388,1090,17,1107,0,1107,393,1500,73.8000
第15任總統副總統,在高雄市各村(里),高雄市,　左營區,祥和里,15,360,89,464,1,465,0,465,148,613,75.8564
第15任總統副總統,在高雄市各村(里),高雄市,　左營區,永清里,15,244,139,398,1,399,0,399,141,540,73.8889
第15任總統副總統,在高雄市各村(里),高雄市,　左營區,莒光里,44,677,558,1279,6,1285,0,1285,420,1705,75.3666
第15任總統副總統,在高雄市各村(里),高雄市,　左營區,光輝里,73,849,929,1851,12,1863,0,1863,513,2376,78.4091
第15任總統副總統,在高雄市各村(里),高雄市,　左營區,合群里,64,1590,298,1952,22,1974,0,1974,505,2479,79.6289
第15任總統副總統,在高雄市各村(里),高雄市,　左營區,明建里,15,270,194,479,3,482,0,482,123,605,79.6694
第15任總統副總統,在高雄市各村(里),高雄市,　左營區,頂西里,21,164,545,730,6,736,0,736,186,922,79.8265
第15任總統副總統,在高雄市各村(里),高雄市,　左營區,聖后里,19,150,421,590,5,595,0,595,127,722,82.4100
第15任總統副總統,在高雄市各村(里),高雄市,　左營區,聖西里,9,230,264,503,3,506,0,506,176,682,74.1935
第15任總統副總統,在高雄市各村(里),高雄市,　左營區,聖南里,8,94,291,393,2,395,0,395,111,506,78.0632
第15任總統副總統,在高雄市各村(里),高雄市,　左營區,城南里,11,98,265,374,3,377,0,377,119,496,76.0081
第15任總統副總統,在高雄市各村(里),高雄市,　左營區,路東里,16,151,383,550,10,560,0,560,134,694,80.6916
第15任總統副總統,在高雄市各村(里),高雄市,　左營區,廍北里,3,57,244,304,6,310,0,310,82,392,79.0816
第15任總統副總統,在高雄市各村(里),高雄市,　左營區,廍南里,13,131,314,458,3,461,0,461,125,586,78.6689
第15任總統副總統,在高雄市各村(里),高雄市,　左營區,埤西里,24,244,401,669,6,675,0,675,212,887,76.0992
第15任總統副總統,在高雄市各村(里),高雄市,　左營區,埤北里,19,548,360,927,10,937,0,937,358,1295,72.3552
第15任總統副總統,在高雄市各村(里),高雄市,　左營區,埤東里,16,271,419,706,6,712,0,712,214,926,76.8898
第15任總統副總統,在高雄市各村(里),高雄市,　左營區,海勝里,158,3110,1014,4282,50,4332,1,4333,1172,5505,78.6921
第15任總統副總統,在高雄市各村(里),高雄市,　左營區,崇實里,103,1102,1135,2340,23,2363,0,2363,660,3023,78.1674
第15任總統副總統,在高雄市各村(里),高雄市,　左營區,自助里,14,147,109,270,2,272,0,272,101,373,72.9223
第15任總統副總統,在高雄市各村(里),高雄市,　左營區,果貿里,54,1454,500,2008,12,2020,0,2020,607,2627,76.8938
第15任總統副總統,在高雄市各村(里),高雄市,　左營區,果惠里,44,739,330,1113,7,1120,0,1120,310,1430,78.3217
第15任總統副總統,在高雄市各村(里),高雄市,　左營區,果峰里,34,846,286,1166,10,1176,0,1176,378,1554,75.6757
第15任總統副總統,在高雄市各村(里),高雄市,　左營區,新下里,328,4105,5649,10082,105,10187,0,10187,2749,12936,78.7492
第15任總統副總統,在高雄市各村(里),高雄市,　左營區,新上里,608,7042,11363,19013,166,19179,0,19179,5119,24298,78.9324
第15任總統副總統,在高雄市各村(里),高雄市,　左營區,新中里,122,1069,2649,3840,36,3876,0,3876,995,4871,79.5730
第15任總統副總統,在高雄市各村(里),高雄市,　左營區,新光里,332,3892,5718,9942,76,10018,0,10018,2714,12732,78.6836
第15任總統副總統,在高雄市各村(里),高雄市,　左營區,菜公里,720,7960,12159,20839,157,20996,1,20997,5867,26864,78.1566
第15任總統副總統,在高雄市各村(里),高雄市,　左營區,福山里,958,10117,14199,25274,195,25469,0,25469,7617,33086,76.9782
第15任總統副總統,在高雄市各村(里),高雄市,　楠梓區,清豐里,555,5031,10339,15925,124,16049,0,16049,4346,20395,78.6909
第15任總統副總統,在高雄市各村(里),高雄市,　楠梓區,東寧里,102,1009,1862,2973,22,2995,0,2995,820,3815,78.5059
第15任總統副總統,在高雄市各村(里),高雄市,　楠梓區,五常里,126,1325,2914,4365,45,4410,0,4410,1393,5803,75.9952
第15任總統副總統,在高雄市各村(里),高雄市,　楠梓區,享平里,103,849,1733,2685,24,2709,0,2709,840,3549,76.3314
第15任總統副總統,在高雄市各村(里),高雄市,　楠梓區,惠楠里,65,664,1247,1976,15,1991,0,1991,1044,3035,65.6013
第15任總統副總統,在高雄市各村(里),高雄市,　楠梓區,中陽里,74,655,1713,2442,17,2459,0,2459,689,3148,78.1131
第15任總統副總統,在高雄市各村(里),高雄市,　楠梓區,惠民里,99,949,1881,2929,31,2960,0,2960,835,3795,77.9974
第15任總統副總統,在高雄市各村(里),高雄市,　楠梓區,惠豐里,151,1354,1988,3493,25,3518,0,3518,984,4502,78.1430
第15任總統副總統,在高雄市各村(里),高雄市,　楠梓區,錦屏里,51,676,1818,2545,18,2563,0,2563,699,3262,78.5714
第15任總統副總統,在高雄市各村(里),高雄市,　楠梓區,玉屏里,30,307,1381,1718,12,1730,0,1730,369,2099,82.4202
第15任總統副總統,在高雄市各村(里),高雄市,　楠梓區,金田里,83,606,1991,2680,30,2710,0,2710,736,3446,78.6419
第15任總統副總統,在高雄市各村(里),高雄市,　楠梓區,稔田里,20,210,883,1113,10,1123,0,1123,250,1373,81.7917
第15任總統副總統,在高雄市各村(里),高雄市,　楠梓區,瑞屏里,84,872,1714,2670,13,2683,0,2683,769,3452,77.7231
第15任總統副總統,在高雄市各村(里),高雄市,　楠梓區,翠屏里,432,4847,6248,11527,83,11610,0,11610,3782,15392,75.4288
第15任總統副總統,在高雄市各村(里),高雄市,　楠梓區,宏南里,14,299,261,574,8,582,0,582,151,733,79.3997
第15任總統副總統,在高雄市各村(里),高雄市,　楠梓區,宏毅里,60,643,1055,1758,17,1775,0,1775,411,2186,81.1985
第15任總統副總統,在高雄市各村(里),高雄市,　楠梓區,宏榮里,69,820,996,1885,22,1907,0,1907,526,2433,78.3806
第15任總統副總統,在高雄市各村(里),高雄市,　楠梓區,廣昌里,68,902,1270,2240,22,2262,0,2262,594,2856,79.2017
第15任總統副總統,在高雄市各村(里),高雄市,　楠梓區,久昌里,57,821,1150,2028,15,2043,0,2043,638,2681,76.2029
第15任總統副總統,在高雄市各村(里),高雄市,　楠梓區,大昌里,51,645,812,1508,12,1520,0,1520,495,2015,75.4342
第15任總統副總統,在高雄市各村(里),高雄市,　楠梓區,福昌里,46,509,996,1551,18,1569,0,1569,376,1945,80.6684
第15任總統副總統,在高雄市各村(里),高雄市,　楠梓區,盛昌里,150,1687,2222,4059,35,4094,0,4094,1081,5175,79.1111
第15任總統副總統,在高雄市各村(里),高雄市,　楠梓區,泰昌里,24,404,647,1075,13,1088,0,1088,312,1400,77.7143
第15任總統副總統,在高雄市各村(里),高雄市,　楠梓區,興昌里,93,1156,1990,3239,24,3263,0,3263,843,4106,79.4691
第15任總統副總統,在高雄市各村(里),高雄市,　楠梓區,建昌里,63,758,1043,1864,23,1887,1,1888,571,2459,76.7385
第15任總統副總統,在高雄市各村(里),高雄市,　楠梓區,宏昌里,87,945,1351,2383,16,2399,0,2399,617,3016,79.5424
第15任總統副總統,在高雄市各村(里),高雄市,　楠梓區,和昌里,50,637,839,1526,13,1539,0,1539,433,1972,78.0426
第15任總統副總統,在高雄市各村(里),高雄市,　楠梓區,慶昌里,70,1112,1284,2466,25,2491,0,2491,574,3065,81.2724
第15任總統副總統,在高雄市各村(里),高雄市,　楠梓區,隆昌里,87,1406,1591,3084,23,3107,0,3107,889,3996,77.7528
第15任總統副總統,在高雄市各村(里),高雄市,　楠梓區,秀昌里,70,683,847,1600,12,1612,0,1612,455,2067,77.9874
第15任總統副總統,在高雄市各村(里),高雄市,　楠梓區,裕昌里,127,1185,2120,3432,32,3464,1,3465,980,4445,77.9303
第15任總統副總統,在高雄市各村(里),高雄市,　楠梓區,國昌里,75,933,1543,2551,20,2571,0,2571,717,3288,78.1934
第15任總統副總統,在高雄市各村(里),高雄市,　楠梓區,加昌里,224,2585,3221,6030,60,6090,0,6090,1828,7918,76.9134
第15任總統副總統,在高雄市各村(里),高雄市,　楠梓區,仁昌里,155,1558,1932,3645,26,3671,0,3671,1140,4811,76.3043
第15任總統副總統,在高雄市各村(里),高雄市,　楠梓區,藍田里,214,1806,3115,5135,53,5188,0,5188,1388,6576,78.8929
第15任總統副總統,在高雄市各村(里),高雄市,　楠梓區,中興里,39,308,819,1166,9,1175,0,1175,273,1448,81.1464
第15任總統副總統,在高雄市各村(里),高雄市,　楠梓區,中和里,70,733,1848,2651,15,2666,0,2666,877,3543,75.2470
第15任總統副總統,在高雄市各村(里),高雄市,　三民區,鼎金里,69,920,1857,2846,20,2866,0,2866,904,3770,76.0212
第15任總統副總統,在高雄市各村(里),高雄市,　三民區,鼎盛里,188,1921,3363,5472,54,5526,0,5526,1628,7154,77.2435
第15任總統副總統,在高雄市各村(里),高雄市,　三民區,鼎強里,93,984,2046,3123,31,3154,0,3154,885,4039,78.0886
第15任總統副總統,在高雄市各村(里),高雄市,　三民區,鼎力里,81,880,1875,2836,19,2855,0,2855,779,3634,78.5636
第15任總統副總統,在高雄市各村(里),高雄市,　三民區,鼎西里,159,1659,3513,5331,45,5376,0,5376,1498,6874,78.2077
第15任總統副總統,在高雄市各村(里),高雄市,　三民區,鼎中里,81,777,1763,2621,24,2645,0,2645,657,3302,80.1030
第15任總統副總統,在高雄市各村(里),高雄市,　三民區,鼎泰里,577,6072,9247,15896,146,16042,0,16042,4067,20109,79.7752
第15任總統副總統,在高雄市各村(里),高雄市,　三民區,本館里,179,2160,4067,6406,54,6460,0,6460,1738,8198,78.7997
第15任總統副總統,在高雄市各村(里),高雄市,　三民區,本和里,153,1830,3254,5237,61,5298,0,5298,1474,6772,78.2339
第15任總統副總統,在高雄市各村(里),高雄市,　三民區,本文里,53,546,1025,1624,14,1638,0,1638,426,2064,79.3605
第15任總統副總統,在高雄市各村(里),高雄市,　三民區,本武里,40,354,852,1246,15,1261,0,1261,306,1567,80.4722
第15任總統副總統,在高雄市各村(里),高雄市,　三民區,本元里,149,1300,2428,3877,33,3910,0,3910,975,4885,80.0409
第15任總統副總統,在高雄市各村(里),高雄市,　三民區,本安里,112,1223,2037,3372,35,3407,0,3407,814,4221,80.7155
第15任總統副總統,在高雄市各村(里),高雄市,　三民區,本上里,112,1279,2140,3531,27,3558,0,3558,854,4412,80.6437
第15任總統副總統,在高雄市各村(里),高雄市,　三民區,本揚里,167,1972,3381,5520,62,5582,0,5582,1391,6973,80.0516
第15任總統副總統,在高雄市各村(里),高雄市,　三民區,寶獅里,91,926,1713,2730,38,2768,0,2768,748,3516,78.7258
第15任總統副總統,在高雄市各村(里),高雄市,　三民區,寶德里,117,1222,2393,3732,32,3764,0,3764,1032,4796,78.4821
第15任總統副總統,在高雄市各村(里),高雄市,　三民區,寶泰里,108,1049,1874,3031,21,3052,0,3052,958,4010,76.1097
第15任總統副總統,在高雄市各村(里),高雄市,　三民區,寶興里,161,1677,3143,4981,41,5022,0,5022,1281,6303,79.6763
第15任總統副總統,在高雄市各村(里),高雄市,　三民區,寶中里,84,681,1445,2210,16,2226,0,2226,584,2810,79.2171
第15任總統副總統,在高雄市各村(里),高雄市,　三民區,寶華里,65,914,1358,2337,20,2357,0,2357,649,3006,78.4098
第15任總統副總統,在高雄市各村(里),高雄市,　三民區,寶國里,203,2040,3484,5727,55,5782,0,5782,1535,7317,79.0215
第15任總統副總統,在高雄市各村(里),高雄市,　三民區,寶民里,70,803,1428,2301,23,2324,0,2324,638,2962,78.4605
第15任總統副總統,在高雄市各村(里),高雄市,　三民區,寶慶里,65,651,1240,1956,28,1984,0,1984,562,2546,77.9262
第15任總統副總統,在高雄市各村(里),高雄市,　三民區,寶業里,140,1428,2544,4112,29,4141,0,4141,1103,5244,78.9664
第15任總統副總統,在高雄市各村(里),高雄市,　三民區,寶盛里,128,1356,2252,3736,54,3790,0,3790,920,4710,80.4671
第15任總統副總統,在高雄市各村(里),高雄市,　三民區,寶安里,148,1956,3048,5152,47,5199,0,5199,1486,6685,77.7711
第15任總統副總統,在高雄市各村(里),高雄市,　三民區,寶龍里,89,1066,1974,3129,29,3158,0,3158,806,3964,79.6670
第15任總統副總統,在高雄市各村(里),高雄市,　三民區,寶珠里,128,1287,2484,3899,33,3932,0,3932,2154,6086,64.6073
第15任總統副總統,在高雄市各村(里),高雄市,　三民區,寶玉里,198,2089,3820,6107,69,6176,0,6176,1616,7792,79.2608
第15任總統副總統,在高雄市各村(里),高雄市,　三民區,灣子里,90,998,1736,2824,33,2857,0,2857,837,3694,77.3416
第15任總統副總統,在高雄市各村(里),高雄市,　三民區,灣愛里,57,606,1386,2049,24,2073,0,2073,799,2872,72.1797
第15任總統副總統,在高雄市各村(里),高雄市,　三民區,灣中里,110,1178,2510,3798,35,3833,0,3833,1344,5177,74.0390
第15任總統副總統,在高雄市各村(里),高雄市,　三民區,灣華里,51,653,1207,1911,19,1930,0,1930,650,2580,74.8062
第15任總統副總統,在高雄市各村(里),高雄市,　三民區,灣勝里,40,391,1005,1436,9,1445,0,1445,373,1818,79.4829
第15任總統副總統,在高雄市各村(里),高雄市,　三民區,灣利里,61,653,1705,2419,23,2442,0,2442,602,3044,80.2234
第15任總統副總統,在高雄市各村(里),高雄市,　三民區,灣復里,82,855,1671,2608,24,2632,0,2632,819,3451,76.2677
第15任總統副總統,在高雄市各村(里),高雄市,　三民區,正興里,314,3111,5246,8671,80,8751,0,8751,2510,11261,77.7107
第15任總統副總統,在高雄市各村(里),高雄市,　三民區,正順里,103,994,1881,2978,22,3000,0,3000,776,3776,79.4492
第15任總統副總統,在高雄市各村(里),高雄市,　三民區,灣興里,40,444,937,1421,10,1431,0,1431,364,1795,79.7214
第15任總統副總統,在高雄市各村(里),高雄市,　三民區,灣成里,45,545,1096,1686,10,1696,0,1696,526,2222,76.3276
第15任總統副總統,在高雄市各村(里),高雄市,　三民區,安康里,60,694,1332,2086,20,2106,0,2106,803,2909,72.3960
第15任總統副總統,在高雄市各村(里),高雄市,　三民區,安寧里,42,397,905,1344,13,1357,0,1357,410,1767,76.7968
第15任總統副總統,在高雄市各村(里),高雄市,　三民區,安吉里,113,1167,2004,3284,22,3306,0,3306,977,4283,77.1889
第15任總統副總統,在高雄市各村(里),高雄市,　三民區,安發里,105,1105,2092,3302,33,3335,0,3335,887,4222,78.9910
第15任總統副總統,在高雄市各村(里),高雄市,　三民區,安東里,80,693,1452,2225,20,2245,0,2245,505,2750,81.6364
第15任總統副總統,在高雄市各村(里),高雄市,　三民區,安和里,61,548,1277,1886,16,1902,0,1902,457,2359,80.6274
第15任總統副總統,在高雄市各村(里),高雄市,　三民區,達德里,26,272,691,989,11,1000,0,1000,225,1225,81.6327
第15任總統副總統,在高雄市各村(里),高雄市,　三民區,達明里,22,329,748,1099,12,1111,0,1111,304,1415,78.5159
第15任總統副總統,在高雄市各村(里),高雄市,　三民區,達仁里,34,352,762,1148,9,1157,0,1157,262,1419,81.5363
第15任總統副總統,在高雄市各村(里),高雄市,　三民區,達勇里,25,231,445,701,6,707,0,707,209,916,77.1834
第15任總統副總統,在高雄市各村(里),高雄市,　三民區,同德里,65,659,1342,2066,19,2085,0,2085,506,2591,80.4709
第15任總統副總統,在高雄市各村(里),高雄市,　三民區,德智里,50,539,1054,1643,14,1657,0,1657,408,2065,80.2421
第15任總統副總統,在高雄市各村(里),高雄市,　三民區,德仁里,38,449,906,1393,12,1405,0,1405,411,1816,77.3678
第15任總統副總統,在高雄市各村(里),高雄市,　三民區,安生里,34,326,735,1095,11,1106,0,1106,239,1345,82.2305
第15任總統副總統,在高雄市各村(里),高雄市,　三民區,德東里,19,186,416,621,6,627,0,627,134,761,82.3916
第15任總統副總統,在高雄市各村(里),高雄市,　三民區,德行里,19,252,600,871,8,879,0,879,174,1053,83.4758
第15任總統副總統,在高雄市各村(里),高雄市,　三民區,精華里,40,381,739,1160,14,1174,0,1174,277,1451,80.9097
第15任總統副總統,在高雄市各村(里),高雄市,　三民區,民享里,40,476,1037,1553,18,1571,0,1571,349,1920,81.8229
第15任總統副總統,在高雄市各村(里),高雄市,　三民區,安宜里,87,716,1619,2422,26,2448,0,2448,513,2961,82.6748
第15任總統副總統,在高雄市各村(里),高雄市,　三民區,安泰里,99,981,1805,2885,23,2908,0,2908,735,3643,79.8243
第15任總統副總統,在高雄市各村(里),高雄市,　三民區,安邦里,89,877,1922,2888,31,2919,0,2919,1096,4015,72.7024
第15任總統副總統,在高雄市各村(里),高雄市,　三民區,十全里,32,366,902,1300,12,1312,0,1312,330,1642,79.9026
第15任總統副總統,在高雄市各村(里),高雄市,　三民區,十美里,48,476,961,1485,11,1496,0,1496,445,1941,77.0737
第15任總統副總統,在高雄市各村(里),高雄市,　三民區,德北里,46,459,915,1420,23,1443,0,1443,373,1816,79.4604
第15任總統副總統,在高雄市各村(里),高雄市,　三民區,立誠里,14,168,384,566,7,573,0,573,107,680,84.2647
第15任總統副總統,在高雄市各村(里),高雄市,　三民區,立業里,21,203,506,730,4,734,0,734,212,946,77.5899
第15任總統副總統,在高雄市各村(里),高雄市,　三民區,港東里,30,287,655,972,7,979,0,979,348,1327,73.7754
第15任總統副總統,在高雄市各村(里),高雄市,　三民區,港新里,32,406,652,1090,3,1093,0,1093,260,1353,80.7834
第15任總統副總統,在高雄市各村(里),高雄市,　三民區,港西里,15,178,346,539,7,546,0,546,216,762,71.6535
第15任總統副總統,在高雄市各村(里),高雄市,　三民區,博愛里,45,318,526,889,7,896,0,896,234,1130,79.2920
第15任總統副總統,在高雄市各村(里),高雄市,　三民區,博惠里,84,1067,1892,3043,23,3066,0,3066,789,3855,79.5331
第15任總統副總統,在高雄市各村(里),高雄市,　三民區,長明里,29,300,438,767,5,772,0,772,247,1019,75.7605
第15任總統副總統,在高雄市各村(里),高雄市,　三民區,建東里,18,324,474,816,10,826,0,826,331,1157,71.3915
第15任總統副總統,在高雄市各村(里),高雄市,　三民區,興德里,40,487,807,1334,19,1353,0,1353,353,1706,79.3083
第15任總統副總統,在高雄市各村(里),高雄市,　三民區,鳳南里,17,174,463,654,5,659,0,659,165,824,79.9757
第15任總統副總統,在高雄市各村(里),高雄市,　三民區,鳳北里,15,316,751,1082,6,1088,0,1088,262,1350,80.5926
第15任總統副總統,在高雄市各村(里),高雄市,　三民區,德西里,25,225,404,654,6,660,0,660,160,820,80.4878
第15任總統副總統,在高雄市各村(里),高雄市,　三民區,豐裕里,51,568,1184,1803,12,1815,0,1815,574,2389,75.9732
第15任總統副總統,在高雄市各村(里),高雄市,　三民區,川東里,20,309,602,931,11,942,0,942,263,1205,78.1743
第15任總統副總統,在高雄市各村(里),高雄市,　三民區,裕民里,23,319,613,955,9,964,0,964,252,1216,79.2763
第15任總統副總統,在高雄市各村(里),高雄市,　三民區,力行里,26,231,604,861,6,867,0,867,198,1065,81.4085
第15任總統副總統,在高雄市各村(里),高雄市,　三民區,千歲里,39,287,558,884,5,889,0,889,202,1091,81.4849
第15任總統副總統,在高雄市各村(里),高雄市,　三民區,立德里,31,312,551,894,12,906,0,906,232,1138,79.6134
第15任總統副總統,在高雄市各村(里),高雄市,　三民區,千北里,29,262,538,829,10,839,0,839,162,1001,83.8162
第15任總統副總統,在高雄市各村(里),高雄市,　三民區,千秋里,31,463,1011,1505,9,1514,0,1514,432,1946,77.8006
第15任總統副總統,在高雄市各村(里),高雄市,　新興區,浩然里,49,580,715,1344,8,1352,0,1352,389,1741,77.6565
第15任總統副總統,在高雄市各村(里),高雄市,　新興區,振成里,27,299,468,794,6,800,0,800,253,1053,75.9734
第15任總統副總統,在高雄市各村(里),高雄市,　新興區,德生里,71,846,1269,2186,28,2214,0,2214,622,2836,78.0677
第15任總統副總統,在高雄市各村(里),高雄市,　新興區,振華里,23,324,426,773,4,777,0,777,244,1021,76.1019
第15任總統副總統,在高雄市各村(里),高雄市,　新興區,正氣里,28,381,603,1012,15,1027,0,1027,294,1321,77.7441
第15任總統副總統,在高雄市各村(里),高雄市,　新興區,德政里,19,207,276,502,7,509,0,509,133,642,79.2835
第15任總統副總統,在高雄市各村(里),高雄市,　新興區,仁聲里,20,250,433,703,3,706,0,706,239,945,74.7090
第15任總統副總統,在高雄市各村(里),高雄市,　新興區,德望里,46,565,828,1439,13,1452,0,1452,425,1877,77.3575
第15任總統副總統,在高雄市各村(里),高雄市,　新興區,華聲里,16,251,452,719,4,723,0,723,210,933,77.4920
第15任總統副總統,在高雄市各村(里),高雄市,　新興區,蕉園里,18,189,378,585,8,593,0,593,117,710,83.5211
第15任總統副總統,在高雄市各村(里),高雄市,　新興區,永寧里,34,320,610,964,10,974,0,974,325,1299,74.9808
第15任總統副總統,在高雄市各村(里),高雄市,　新興區,玉衡里,15,191,359,565,7,572,0,572,172,744,76.8817
第15任總統副總統,在高雄市各村(里),高雄市,　新興區,順昌里,47,526,940,1513,11,1524,0,1524,403,1927,79.0867
第15任總統副總統,在高雄市各村(里),高雄市,　新興區,文昌里,79,761,1188,2028,23,2051,0,2051,576,2627,78.0738
第15任總統副總統,在高雄市各村(里),高雄市,　新興區,光耀里,40,652,1007,1699,14,1713,0,1713,471,2184,78.4341
第15任總統副總統,在高雄市各村(里),高雄市,　新興區,興昌里,45,520,796,1361,13,1374,0,1374,351,1725,79.6522
第15任總統副總統,在高雄市各村(里),高雄市,　新興區,開平里,92,932,1535,2559,25,2584,0,2584,693,3277,78.8526
第15任總統副總統,在高雄市各村(里),高雄市,　新興區,成功里,33,401,520,954,13,967,0,967,301,1268,76.2618
第15任總統副總統,在高雄市各村(里),高雄市,　新興區,新江里,31,232,518,781,9,790,0,790,285,1075,73.4884
第15任總統副總統,在高雄市各村(里),高雄市,　新興區,黎明里,21,207,393,621,8,629,0,629,192,821,76.6139
第15任總統副總統,在高雄市各村(里),高雄市,　新興區,愛平里,30,251,466,747,7,754,0,754,232,986,76.4706
第15任總統副總統,在高雄市各村(里),高雄市,　新興區,南港里,35,472,1004,1511,13,1524,0,1524,342,1866,81.6720
第15任總統副總統,在高雄市各村(里),高雄市,　新興區,中東里,67,712,1042,1821,14,1835,0,1835,873,2708,67.7622
第15任總統副總統,在高雄市各村(里),高雄市,　新興區,明莊里,15,175,355,545,4,549,0,549,162,711,77.2152
第15任總統副總統,在高雄市各村(里),高雄市,　新興區,大明里,29,261,485,775,6,781,0,781,248,1029,75.8989
第15任總統副總統,在高雄市各村(里),高雄市,　新興區,秋山里,26,202,432,660,7,667,0,667,249,916,72.8166
第15任總統副總統,在高雄市各村(里),高雄市,　新興區,長驛里,22,258,410,690,9,699,0,699,230,929,75.2422
第15任總統副總統,在高雄市各村(里),高雄市,　新興區,建興里,16,224,449,689,10,699,0,699,229,928,75.3233
第15任總統副總統,在高雄市各村(里),高雄市,　新興區,建華里,26,189,388,603,5,608,0,608,201,809,75.1545
第15任總統副總統,在高雄市各村(里),高雄市,　新興區,漢民里,17,164,352,533,6,539,0,539,151,690,78.1159
第15任總統副總統,在高雄市各村(里),高雄市,　新興區,榮治里,13,227,290,530,7,537,0,537,161,698,76.9341
第15任總統副總統,在高雄市各村(里),高雄市,　新興區,東坡里,22,265,612,899,13,912,0,912,258,1170,77.9487
第15任總統副總統,在高雄市各村(里),高雄市,　前金區,三川里,13,151,363,527,3,530,0,530,126,656,80.7927
第15任總統副總統,在高雄市各村(里),高雄市,　前金區,草江里,21,330,442,793,6,799,0,799,203,1002,79.7405
第15任總統副總統,在高雄市各村(里),高雄市,　前金區,長城里,32,289,659,980,12,992,0,992,312,1304,76.0736
第15任總統副總統,在高雄市各村(里),高雄市,　前金區,北金里,11,203,388,602,4,606,0,606,200,806,75.1861
第15任總統副總統,在高雄市各村(里),高雄市,　前金區,東金里,24,225,476,725,5,730,0,730,227,957,76.2800
第15任總統副總統,在高雄市各村(里),高雄市,　前金區,新生里,98,1067,1557,2722,31,2753,0,2753,792,3545,77.6587
第15任總統副總統,在高雄市各村(里),高雄市,　前金區,後金里,26,199,313,538,13,551,0,551,146,697,79.0531
第15任總統副總統,在高雄市各村(里),高雄市,　前金區,長興里,27,326,494,847,16,863,0,863,266,1129,76.4393
第15任總統副總統,在高雄市各村(里),高雄市,　前金區,青山里,62,454,801,1317,15,1332,0,1332,418,1750,76.1143
第15任總統副總統,在高雄市各村(里),高雄市,　前金區,民生里,29,235,355,619,6,625,0,625,198,823,75.9417
第15任總統副總統,在高雄市各村(里),高雄市,　前金區,復元里,32,274,398,704,5,709,0,709,217,926,76.5659
第15任總統副總統,在高雄市各村(里),高雄市,　前金區,林投里,18,211,419,648,3,651,0,651,338,989,65.8241
第15任總統副總統,在高雄市各村(里),高雄市,　前金區,國民里,21,271,418,710,8,718,0,718,197,915,78.4699
第15任總統副總統,在高雄市各村(里),高雄市,　前金區,社東里,40,465,633,1138,15,1153,0,1153,322,1475,78.1695
第15任總統副總統,在高雄市各村(里),高雄市,　前金區,社西里,27,307,448,782,9,791,0,791,244,1035,76.4251
第15任總統副總統,在高雄市各村(里),高雄市,　前金區,博孝里,32,264,457,753,7,760,0,760,213,973,78.1089
第15任總統副總統,在高雄市各村(里),高雄市,　前金區,長生里,52,484,688,1224,11,1235,0,1235,373,1608,76.8035
第15任總統副總統,在高雄市各村(里),高雄市,　前金區,榮復里,18,301,512,831,13,844,0,844,207,1051,80.3045
第15任總統副總統,在高雄市各村(里),高雄市,　前金區,文西里,19,250,436,705,10,715,0,715,193,908,78.7445
第15任總統副總統,在高雄市各村(里),高雄市,　前金區,文東里,38,335,486,859,13,872,0,872,267,1139,76.5584
第15任總統副總統,在高雄市各村(里),高雄市,　苓雅區,安祥里,55,681,976,1712,18,1730,0,1730,457,2187,79.1038
第15任總統副總統,在高雄市各村(里),高雄市,　苓雅區,五權里,62,648,1004,1714,9,1723,0,1723,372,2095,82.2434
第15任總統副總統,在高雄市各村(里),高雄市,　苓雅區,民主里,83,1089,1685,2857,31,2888,0,2888,793,3681,78.4569
第15任總統副總統,在高雄市各村(里),高雄市,　苓雅區,五福里,90,1105,1609,2804,33,2837,0,2837,777,3614,78.5003
第15任總統副總統,在高雄市各村(里),高雄市,　苓雅區,正心里,97,995,1587,2679,39,2718,0,2718,722,3440,79.0116
第15任總統副總統,在高雄市各村(里),高雄市,　苓雅區,正道里,74,1141,1805,3020,26,3046,0,3046,901,3947,77.1725
第15任總統副總統,在高雄市各村(里),高雄市,　苓雅區,文昌里,77,921,1771,2769,21,2790,0,2790,800,3590,77.7159
第15任總統副總統,在高雄市各村(里),高雄市,　苓雅區,建軍里,50,547,965,1562,17,1579,0,1579,416,1995,79.1479
第15任總統副總統,在高雄市各村(里),高雄市,　苓雅區,博仁里,22,226,295,543,7,550,0,550,154,704,78.1250
第15任總統副總統,在高雄市各村(里),高雄市,　苓雅區,苓洲里,45,443,652,1140,8,1148,0,1148,338,1486,77.2544
第15任總統副總統,在高雄市各村(里),高雄市,　苓雅區,苓昇里,18,323,546,887,8,895,0,895,287,1182,75.7191
第15任總統副總統,在高雄市各村(里),高雄市,　苓雅區,苓中里,41,378,809,1228,20,1248,0,1248,318,1566,79.6935
第15任總統副總統,在高雄市各村(里),高雄市,　苓雅區,苓雅里,40,412,623,1075,8,1083,0,1083,290,1373,78.8784
第15任總統副總統,在高雄市各村(里),高雄市,　苓雅區,苓東里,28,338,666,1032,10,1042,0,1042,369,1411,73.8483
第15任總統副總統,在高雄市各村(里),高雄市,　苓雅區,城北里,35,422,661,1118,7,1125,0,1125,344,1469,76.5827
第15任總統副總統,在高雄市各村(里),高雄市,　苓雅區,城西里,14,203,329,546,4,550,0,550,204,754,72.9443
第15任總統副總統,在高雄市各村(里),高雄市,　苓雅區,城東里,36,514,812,1362,14,1376,0,1376,483,1859,74.0183
第15任總統副總統,在高雄市各村(里),高雄市,　苓雅區,意誠里,97,1062,1376,2535,24,2559,0,2559,998,3557,71.9426
第15任總統副總統,在高雄市各村(里),高雄市,　苓雅區,鼓中里,21,238,449,708,7,715,0,715,188,903,79.1805
第15任總統副總統,在高雄市各村(里),高雄市,　苓雅區,田西里,30,348,569,947,11,958,0,958,275,1233,77.6967
第15任總統副總統,在高雄市各村(里),高雄市,　苓雅區,人和里,26,440,801,1267,9,1276,0,1276,413,1689,75.5477
第15任總統副總統,在高雄市各村(里),高雄市,　苓雅區,仁政里,29,374,535,938,11,949,0,949,278,1227,77.3431
第15任總統副總統,在高雄市各村(里),高雄市,　苓雅區,廣澤里,36,424,871,1331,8,1339,0,1339,361,1700,78.7647
第15任總統副總統,在高雄市各村(里),高雄市,　苓雅區,美田里,32,314,494,840,9,849,0,849,248,1097,77.3929
第15任總統副總統,在高雄市各村(里),高雄市,　苓雅區,華堂里,51,779,1358,2188,24,2212,0,2212,694,2906,76.1184
第15任總統副總統,在高雄市各村(里),高雄市,　苓雅區,日中里,51,578,1006,1635,23,1658,0,1658,430,2088,79.4061
第15任總統副總統,在高雄市各村(里),高雄市,　苓雅區,普照里,76,826,1356,2258,24,2282,0,2282,659,2941,77.5927
第15任總統副總統,在高雄市各村(里),高雄市,　苓雅區,和煦里,48,567,902,1517,9,1526,0,1526,390,1916,79.6451
第15任總統副總統,在高雄市各村(里),高雄市,　苓雅區,晴朗里,54,432,724,1210,10,1220,0,1220,1123,2343,52.0700
第15任總統副總統,在高雄市各村(里),高雄市,　苓雅區,普天里,87,919,1502,2508,23,2531,0,2531,714,3245,77.9969
第15任總統副總統,在高雄市各村(里),高雄市,　苓雅區,林富里,51,577,888,1516,12,1528,0,1528,429,1957,78.0787
第15任總統副總統,在高雄市各村(里),高雄市,　苓雅區,林圍里,60,735,970,1765,18,1783,0,1783,450,2233,79.8477
第15任總統副總統,在高雄市各村(里),高雄市,　苓雅區,林安里,48,454,622,1124,8,1132,0,1132,285,1417,79.8871
第15任總統副總統,在高雄市各村(里),高雄市,　苓雅區,光華里,16,150,347,513,6,519,0,519,143,662,78.3988
第15任總統副總統,在高雄市各村(里),高雄市,　苓雅區,林興里,27,283,642,952,9,961,0,961,272,1233,77.9400
第15任總統副總統,在高雄市各村(里),高雄市,　苓雅區,林華里,62,676,1346,2084,18,2102,0,2102,530,2632,79.8632
第15任總統副總統,在高雄市各村(里),高雄市,　苓雅區,林西里,37,414,714,1165,10,1175,0,1175,335,1510,77.8146
第15任總統副總統,在高雄市各村(里),高雄市,　苓雅區,林中里,74,759,1271,2104,25,2129,0,2129,607,2736,77.8143
第15任總統副總統,在高雄市各村(里),高雄市,　苓雅區,林泉里,49,623,773,1445,16,1461,0,1461,345,1806,80.8970
第15任總統副總統,在高雄市各村(里),高雄市,　苓雅區,林南里,59,934,1134,2127,28,2155,0,2155,613,2768,77.8540
第15任總統副總統,在高雄市各村(里),高雄市,　苓雅區,中正里,68,797,1241,2106,17,2123,0,2123,565,2688,78.9807
第15任總統副總統,在高雄市各村(里),高雄市,　苓雅區,尚義里,44,457,651,1152,13,1165,0,1165,308,1473,79.0903
第15任總統副總統,在高雄市各村(里),高雄市,　苓雅區,同慶里,55,701,935,1691,16,1707,0,1707,384,2091,81.6356
第15任總統副總統,在高雄市各村(里),高雄市,　苓雅區,凱旋里,75,719,834,1628,11,1639,0,1639,387,2026,80.8983
第15任總統副總統,在高雄市各村(里),高雄市,　苓雅區,奏捷里,35,485,642,1162,9,1171,0,1171,304,1475,79.3898
第15任總統副總統,在高雄市各村(里),高雄市,　苓雅區,福壽里,26,310,764,1100,11,1111,0,1111,292,1403,79.1875
第15任總統副總統,在高雄市各村(里),高雄市,　苓雅區,福南里,40,365,882,1287,19,1306,0,1306,350,1656,78.8647
第15任總統副總統,在高雄市各村(里),高雄市,　苓雅區,林德里,40,576,780,1396,11,1407,0,1407,374,1781,79.0006
第15任總統副總統,在高雄市各村(里),高雄市,　苓雅區,林貴里,50,489,815,1354,17,1371,0,1371,360,1731,79.2028
第15任總統副總統,在高雄市各村(里),高雄市,　苓雅區,林榮里,85,1135,1676,2896,29,2925,0,2925,862,3787,77.2379
第15任總統副總統,在高雄市各村(里),高雄市,　苓雅區,英明里,37,451,917,1405,12,1417,0,1417,385,1802,78.6349
第15任總統副總統,在高雄市各村(里),高雄市,　苓雅區,林靖里,40,575,541,1156,12,1168,0,1168,292,1460,80.0000
第15任總統副總統,在高雄市各村(里),高雄市,　苓雅區,朝陽里,24,365,685,1074,15,1089,0,1089,308,1397,77.9528
第15任總統副總統,在高雄市各村(里),高雄市,　苓雅區,福隆里,35,642,1222,1899,13,1912,0,1912,518,2430,78.6831
第15任總統副總統,在高雄市各村(里),高雄市,　苓雅區,福祥里,34,340,537,911,10,921,0,921,255,1176,78.3163
第15任總統副總統,在高雄市各村(里),高雄市,　苓雅區,福海里,39,305,450,794,9,803,0,803,210,1013,79.2695
第15任總統副總統,在高雄市各村(里),高雄市,　苓雅區,福康里,59,411,947,1417,19,1436,0,1436,373,1809,79.3809
第15任總統副總統,在高雄市各村(里),高雄市,　苓雅區,福人里,46,555,910,1511,12,1523,0,1523,456,1979,76.9581
第15任總統副總統,在高雄市各村(里),高雄市,　苓雅區,福地里,50,705,1188,1943,22,1965,0,1965,586,2551,77.0286
第15任總統副總統,在高雄市各村(里),高雄市,　苓雅區,福居里,43,627,1304,1974,20,1994,0,1994,582,2576,77.4068
第15任總統副總統,在高雄市各村(里),高雄市,　苓雅區,福東里,65,685,1160,1910,17,1927,0,1927,565,2492,77.3274
第15任總統副總統,在高雄市各村(里),高雄市,　苓雅區,福西里,34,410,864,1308,13,1321,0,1321,386,1707,77.3872
第15任總統副總統,在高雄市各村(里),高雄市,　苓雅區,永康里,45,624,943,1612,17,1629,0,1629,428,2057,79.1930
第15任總統副總統,在高雄市各村(里),高雄市,　苓雅區,正文里,53,531,970,1554,16,1570,0,1570,449,2019,77.7613
第15任總統副總統,在高雄市各村(里),高雄市,　苓雅區,正言里,73,791,1248,2112,21,2133,0,2133,722,2855,74.7110
第15任總統副總統,在高雄市各村(里),高雄市,　苓雅區,正大里,114,1398,2123,3635,56,3691,0,3691,1160,4851,76.0874
第15任總統副總統,在高雄市各村(里),高雄市,　苓雅區,正義里,55,617,1218,1890,18,1908,0,1908,434,2342,81.4688
第15任總統副總統,在高雄市各村(里),高雄市,　苓雅區,正仁里,46,716,1093,1855,16,1871,0,1871,578,2449,76.3985
第15任總統副總統,在高雄市各村(里),高雄市,　苓雅區,衛武里,54,602,819,1475,13,1488,0,1488,409,1897,78.4396
第15任總統副總統,在高雄市各村(里),高雄市,　前鎮區,草衙里,179,1960,4686,6825,58,6883,0,6883,2138,9021,76.2997
第15任總統副總統,在高雄市各村(里),高雄市,　前鎮區,明孝里,51,573,1284,1908,18,1926,0,1926,574,2500,77.0400
第15任總統副總統,在高雄市各村(里),高雄市,　前鎮區,明正里,113,1056,2612,3781,38,3819,0,3819,997,4816,79.2982
第15任總統副總統,在高雄市各村(里),高雄市,　前鎮區,明義里,47,509,1153,1709,19,1728,0,1728,404,2132,81.0507
第15任總統副總統,在高雄市各村(里),高雄市,　前鎮區,仁愛里,27,252,695,974,11,985,0,985,273,1258,78.2989
第15任總統副總統,在高雄市各村(里),高雄市,　前鎮區,德昌里,29,458,823,1310,12,1322,0,1322,413,1735,76.1960
第15任總統副總統,在高雄市各村(里),高雄市,　前鎮區,平等里,35,421,1071,1527,10,1537,0,1537,1222,2759,55.7086
第15任總統副總統,在高雄市各村(里),高雄市,　前鎮區,平昌里,8,116,321,445,4,449,0,449,146,595,75.4622
第15任總統副總統,在高雄市各村(里),高雄市,　前鎮區,明禮里,25,243,774,1042,14,1056,0,1056,323,1379,76.5772
第15任總統副總統,在高雄市各村(里),高雄市,　前鎮區,信義里,20,276,772,1068,6,1074,0,1074,281,1355,79.2620
第15任總統副總統,在高雄市各村(里),高雄市,　前鎮區,信德里,42,487,1114,1643,16,1659,0,1659,491,2150,77.1628
第15任總統副總統,在高雄市各村(里),高雄市,　前鎮區,明道里,20,194,580,794,3,797,0,797,222,1019,78.2139
第15任總統副總統,在高雄市各村(里),高雄市,　前鎮區,興化里,13,117,386,516,7,523,0,523,126,649,80.5855
第15任總統副總統,在高雄市各村(里),高雄市,　前鎮區,興仁里,11,109,415,535,1,536,0,536,152,688,77.9070
第15任總統副總統,在高雄市各村(里),高雄市,　前鎮區,前鎮里,25,247,747,1019,17,1036,0,1036,255,1291,80.2479
第15任總統副總統,在高雄市各村(里),高雄市,　前鎮區,鎮東里,38,329,911,1278,12,1290,0,1290,331,1621,79.5805
第15任總統副總統,在高雄市各村(里),高雄市,　前鎮區,鎮榮里,37,432,1153,1622,5,1627,0,1627,446,2073,78.4853
第15任總統副總統,在高雄市各村(里),高雄市,　前鎮區,鎮昌里,49,385,1041,1475,22,1497,0,1497,405,1902,78.7066
第15任總統副總統,在高雄市各村(里),高雄市,　前鎮區,鎮海里,87,923,1958,2968,33,3001,0,3001,884,3885,77.2458
第15任總統副總統,在高雄市各村(里),高雄市,　前鎮區,鎮陽里,22,222,465,709,10,719,0,719,191,910,79.0110
第15任總統副總統,在高雄市各村(里),高雄市,　前鎮區,興邦里,89,958,1416,2463,33,2496,0,2496,646,3142,79.4398
第15任總統副總統,在高雄市各村(里),高雄市,　前鎮區,鎮中里,15,157,421,593,9,602,0,602,207,809,74.4129
第15任總統副總統,在高雄市各村(里),高雄市,　前鎮區,鎮北里,20,264,572,856,13,869,0,869,205,1074,80.9125
第15任總統副總統,在高雄市各村(里),高雄市,　前鎮區,忠純里,115,2451,1398,3964,34,3998,0,3998,1014,5012,79.7686
第15任總統副總統,在高雄市各村(里),高雄市,　前鎮區,忠誠里,45,1113,430,1588,10,1598,0,1598,400,1998,79.9800
第15任總統副總統,在高雄市各村(里),高雄市,　前鎮區,西山里,90,1014,1476,2580,12,2592,0,2592,727,3319,78.0958
第15任總統副總統,在高雄市各村(里),高雄市,　前鎮區,民權里,105,1355,1721,3181,25,3206,0,3206,694,3900,82.2051
第15任總統副總統,在高雄市各村(里),高雄市,　前鎮區,建隆里,17,342,535,894,13,907,0,907,283,1190,76.2185
第15任總統副總統,在高雄市各村(里),高雄市,　前鎮區,振興里,78,645,983,1706,19,1725,0,1725,480,2205,78.2313
第15任總統副總統,在高雄市各村(里),高雄市,　前鎮區,良和里,69,991,1102,2162,20,2182,0,2182,586,2768,78.8295
第15任總統副總統,在高雄市各村(里),高雄市,　前鎮區,西甲里,46,487,1017,1550,7,1557,0,1557,440,1997,77.9670
第15任總統副總統,在高雄市各村(里),高雄市,　前鎮區,盛興里,58,784,1126,1968,8,1976,0,1976,674,2650,74.5660
第15任總統副總統,在高雄市各村(里),高雄市,　前鎮區,盛豐里,67,778,1398,2243,16,2259,0,2259,676,2935,76.9676
第15任總統副總統,在高雄市各村(里),高雄市,　前鎮區,興中里,66,834,1358,2258,21,2279,0,2279,729,3008,75.7646
第15任總統副總統,在高雄市各村(里),高雄市,　前鎮區,興東里,120,1508,2475,4103,50,4153,0,4153,1127,5280,78.6553
第15任總統副總統,在高雄市各村(里),高雄市,　前鎮區,忠孝里,65,874,1168,2107,19,2126,0,2126,614,2740,77.5912
第15任總統副總統,在高雄市各村(里),高雄市,　前鎮區,復國里,55,681,1257,1993,29,2022,0,2022,572,2594,77.9491
第15任總統副總統,在高雄市各村(里),高雄市,　前鎮區,竹內里,75,756,1481,2312,22,2334,0,2334,638,2972,78.5330
第15任總統副總統,在高雄市各村(里),高雄市,　前鎮區,竹東里,61,568,977,1606,18,1624,0,1624,468,2092,77.6291
第15任總統副總統,在高雄市各村(里),高雄市,　前鎮區,竹南里,196,1832,3020,5048,48,5096,0,5096,1412,6508,78.3036
第15任總統副總統,在高雄市各村(里),高雄市,　前鎮區,竹北里,56,565,1051,1672,10,1682,0,1682,491,2173,77.4045
第15任總統副總統,在高雄市各村(里),高雄市,　前鎮區,竹西里,120,1157,1868,3145,33,3178,0,3178,804,3982,79.8091
第15任總統副總統,在高雄市各村(里),高雄市,　前鎮區,竹中里,82,903,1489,2474,27,2501,0,2501,695,3196,78.2541
第15任總統副總統,在高雄市各村(里),高雄市,　前鎮區,瑞竹里,40,323,803,1166,11,1177,0,1177,318,1495,78.7291
第15任總統副總統,在高雄市各村(里),高雄市,　前鎮區,瑞南里,99,1121,2226,3446,23,3469,0,3469,973,4442,78.0955
第15任總統副總統,在高雄市各村(里),高雄市,　前鎮區,瑞豐里,62,611,1308,1981,19,2000,0,2000,569,2569,77.8513
第15任總統副總統,在高雄市各村(里),高雄市,　前鎮區,瑞祥里,109,1091,2224,3424,35,3459,0,3459,940,4399,78.6315
第15任總統副總統,在高雄市各村(里),高雄市,　前鎮區,瑞東里,54,481,1187,1722,12,1734,0,1734,471,2205,78.6395
第15任總統副總統,在高雄市各村(里),高雄市,　前鎮區,瑞和里,36,374,979,1389,17,1406,0,1406,415,1821,77.2103
第15任總統副總統,在高雄市各村(里),高雄市,　前鎮區,瑞平里,83,815,1831,2729,26,2755,0,2755,651,3406,80.8867
第15任總統副總統,在高雄市各村(里),高雄市,　前鎮區,瑞隆里,70,776,1748,2594,25,2619,0,2619,736,3355,78.0626
第15任總統副總統,在高雄市各村(里),高雄市,　前鎮區,瑞北里,63,694,1648,2405,16,2421,0,2421,695,3116,77.6958
第15任總統副總統,在高雄市各村(里),高雄市,　前鎮區,瑞西里,60,521,1401,1982,14,1996,0,1996,527,2523,79.1122
第15任總統副總統,在高雄市各村(里),高雄市,　前鎮區,瑞崗里,56,597,1312,1965,17,1982,0,1982,510,2492,79.5345
第15任總統副總統,在高雄市各村(里),高雄市,　前鎮區,瑞興里,43,530,1366,1939,16,1955,0,1955,471,2426,80.5853
第15任總統副總統,在高雄市各村(里),高雄市,　前鎮區,瑞誠里,55,631,1260,1946,16,1962,0,1962,500,2462,79.6913
第15任總統副總統,在高雄市各村(里),高雄市,　前鎮區,瑞文里,51,472,1230,1753,12,1765,0,1765,539,2304,76.6059
第15任總統副總統,在高雄市各村(里),高雄市,　前鎮區,瑞華里,98,1144,2144,3386,22,3408,0,3408,886,4294,79.3666
第15任總統副總統,在高雄市各村(里),高雄市,　前鎮區,瑞昌里,77,659,1621,2357,21,2378,0,2378,658,3036,78.3267
第15任總統副總統,在高雄市各村(里),高雄市,　旗津區,旗下里,26,215,618,859,16,875,0,875,279,1154,75.8232
第15任總統副總統,在高雄市各村(里),高雄市,　旗津區,永安里,26,222,552,800,4,804,0,804,260,1064,75.5639
第15任總統副總統,在高雄市各村(里),高雄市,　旗津區,振興里,33,306,847,1186,13,1199,0,1199,362,1561,76.8097
第15任總統副總統,在高雄市各村(里),高雄市,　旗津區,慈愛里,40,417,1122,1579,19,1598,0,1598,611,2209,72.3404
第15任總統副總統,在高雄市各村(里),高雄市,　旗津區,復興里,46,742,1343,2131,21,2152,0,2152,764,2916,73.7997
第15任總統副總統,在高雄市各村(里),高雄市,　旗津區,中華里,22,279,831,1132,8,1140,0,1140,315,1455,78.3505
第15任總統副總統,在高雄市各村(里),高雄市,　旗津區,實踐里,29,510,410,949,13,962,0,962,352,1314,73.2116
第15任總統副總統,在高雄市各村(里),高雄市,　旗津區,北汕里,42,545,1258,1845,15,1860,0,1860,692,2552,72.8840
第15任總統副總統,在高雄市各村(里),高雄市,　旗津區,南汕里,37,325,1102,1464,17,1481,0,1481,520,2001,74.0130
第15任總統副總統,在高雄市各村(里),高雄市,　旗津區,上竹里,41,414,1556,2011,20,2031,0,2031,658,2689,75.5299
第15任總統副總統,在高雄市各村(里),高雄市,　旗津區,中洲里,27,291,1070,1388,10,1398,0,1398,393,1791,78.0570
第15任總統副總統,在高雄市各村(里),高雄市,　旗津區,安順里,13,124,492,629,7,636,0,636,227,863,73.6964
第15任總統副總統,在高雄市各村(里),高雄市,　旗津區,中興里,45,427,1444,1916,15,1931,0,1931,489,2420,79.7934
第15任總統副總統,在高雄市各村(里),高雄市,　小港區,小港里,60,777,1299,2136,11,2147,0,2147,651,2798,76.7334
第15任總統副總統,在高雄市各村(里),高雄市,　小港區,港口里,74,927,1325,2326,26,2352,0,2352,647,2999,78.4261
第15任總統副總統,在高雄市各村(里),高雄市,　小港區,港正里,70,740,1047,1857,24,1881,0,1881,501,2382,78.9673
第15任總統副總統,在高雄市各村(里),高雄市,　小港區,港墘里,47,383,811,1241,10,1251,0,1251,319,1570,79.6815
第15任總統副總統,在高雄市各村(里),高雄市,　小港區,港明里,67,694,1461,2222,17,2239,0,2239,652,2891,77.4473
第15任總統副總統,在高雄市各村(里),高雄市,　小港區,港后里,51,547,1214,1812,17,1829,0,1829,466,2295,79.6950
第15任總統副總統,在高雄市各村(里),高雄市,　小港區,港南里,57,501,1081,1639,18,1657,0,1657,830,2487,66.6265
第15任總統副總統,在高雄市各村(里),高雄市,　小港區,港興里,43,555,1120,1718,11,1729,0,1729,447,2176,79.4577
第15任總統副總統,在高雄市各村(里),高雄市,　小港區,鳳宮里,63,528,1248,1839,14,1853,0,1853,614,2467,75.1115
第15任總統副總統,在高雄市各村(里),高雄市,　小港區,店鎮里,131,1264,2825,4220,29,4249,0,4249,1292,5541,76.6829
第15任總統副總統,在高雄市各村(里),高雄市,　小港區,大苓里,61,554,1221,1836,18,1854,0,1854,537,2391,77.5408
第15任總統副總統,在高雄市各村(里),高雄市,　小港區,二苓里,87,745,1825,2657,23,2680,0,2680,823,3503,76.5059
第15任總統副總統,在高雄市各村(里),高雄市,　小港區,三苓里,60,644,1411,2115,18,2133,0,2133,596,2729,78.1605
第15任總統副總統,在高雄市各村(里),高雄市,　小港區,正苓里,76,1005,1772,2853,24,2877,0,2877,930,3807,75.5713
第15任總統副總統,在高雄市各村(里),高雄市,　小港區,順苓里,89,1054,1983,3126,26,3152,0,3152,963,4115,76.5978
第15任總統副總統,在高雄市各村(里),高雄市,　小港區,六苓里,67,788,1419,2274,33,2307,0,2307,641,2948,78.2564
第15任總統副總統,在高雄市各村(里),高雄市,　小港區,宏亮里,69,733,1523,2325,18,2343,0,2343,712,3055,76.6939
第15任總統副總統,在高雄市各村(里),高雄市,　小港區,山東里,63,891,1135,2089,14,2103,0,2103,673,2776,75.7565
第15任總統副總統,在高雄市各村(里),高雄市,　小港區,青島里,65,951,825,1841,24,1865,0,1865,552,2417,77.1618
第15任總統副總統,在高雄市各村(里),高雄市,　小港區,濟南里,99,1215,1681,2995,31,3026,0,3026,858,3884,77.9094
第15任總統副總統,在高雄市各村(里),高雄市,　小港區,泰山里,61,769,1595,2425,21,2446,0,2446,643,3089,79.1842
第15任總統副總統,在高雄市各村(里),高雄市,　小港區,山明里,221,2280,5512,8013,62,8075,1,8076,2397,10473,77.1030
第15任總統副總統,在高雄市各村(里),高雄市,　小港區,高松里,80,873,1954,2907,22,2929,0,2929,864,3793,77.2212
第15任總統副總統,在高雄市各村(里),高雄市,　小港區,松金里,63,740,1345,2148,16,2164,0,2164,687,2851,75.9032
第15任總統副總統,在高雄市各村(里),高雄市,　小港區,松山里,84,723,1505,2312,25,2337,0,2337,597,2934,79.6524
第15任總統副總統,在高雄市各村(里),高雄市,　小港區,大坪里,72,513,1403,1988,27,2015,0,2015,577,2592,77.7392
第15任總統副總統,在高雄市各村(里),高雄市,　小港區,坪頂里,102,1175,2907,4184,33,4217,0,4217,1335,5552,75.9546
第15任總統副總統,在高雄市各村(里),高雄市,　小港區,孔宅里,114,1236,2394,3744,40,3784,0,3784,1171,4955,76.3673
第15任總統副總統,在高雄市各村(里),高雄市,　小港區,廈莊里,84,843,1819,2746,32,2778,0,2778,760,3538,78.5189
第15任總統副總統,在高雄市各村(里),高雄市,　小港區,合作里,57,564,1376,1997,9,2006,0,2006,487,2493,80.4653
第15任總統副總統,在高雄市各村(里),高雄市,　小港區,桂林里,165,1687,3782,5634,63,5697,0,5697,1691,7388,77.1115
第15任總統副總統,在高雄市各村(里),高雄市,　小港區,中厝里,72,786,1794,2652,24,2676,0,2676,826,3502,76.4135
第15任總統副總統,在高雄市各村(里),高雄市,　小港區,鳳鳴里,53,744,1494,2291,23,2314,0,2314,731,3045,75.9934
第15任總統副總統,在高雄市各村(里),高雄市,　小港區,龍鳳里,46,644,1510,2200,26,2226,0,2226,709,2935,75.8433
第15任總統副總統,在高雄市各村(里),高雄市,　小港區,鳳森里,42,431,1170,1643,10,1653,0,1653,508,2161,76.4924
第15任總統副總統,在高雄市各村(里),高雄市,　小港區,鳳林里,48,552,1691,2291,18,2309,0,2309,664,2973,77.6657
第15任總統副總統,在高雄市各村(里),高雄市,　小港區,鳳興里,40,417,1369,1826,21,1847,0,1847,577,2424,76.1964
第15任總統副總統,在高雄市各村(里),高雄市,　小港區,鳳源里,57,601,1961,2619,26,2645,0,2645,924,3569,74.1104
第15任總統副總統,在高雄市各村(里),高雄市,　鳳山區,鳳崗里,20,367,441,828,8,836,0,836,208,1044,80.0766
第15任總統副總統,在高雄市各村(里),高雄市,　鳳山區,縣衙里,27,249,312,588,2,590,0,590,197,787,74.9682
第15任總統副總統,在高雄市各村(里),高雄市,　鳳山區,曹公里,44,550,809,1403,15,1418,0,1418,418,1836,77.2331
第15任總統副總統,在高雄市各村(里),高雄市,　鳳山區,鎮西里,123,1344,2267,3734,36,3770,0,3770,1010,4780,78.8703
第15任總統副總統,在高雄市各村(里),高雄市,　鳳山區,北門里,93,1039,1891,3023,29,3052,0,3052,884,3936,77.5407
第15任總統副總統,在高雄市各村(里),高雄市,　鳳山區,鎮北里,227,2273,4410,6910,75,6985,0,6985,2135,9120,76.5899
第15任總統副總統,在高雄市各村(里),高雄市,　鳳山區,武松里,74,691,1232,1997,25,2022,0,2022,557,2579,78.4025
第15任總統副總統,在高雄市各村(里),高雄市,　鳳山區,忠誠里,70,832,1704,2606,22,2628,0,2628,706,3334,78.8242
第15任總統副總統,在高雄市各村(里),高雄市,　鳳山區,文英里,94,936,1680,2710,23,2733,0,2733,728,3461,78.9656
第15任總統副總統,在高雄市各村(里),高雄市,　鳳山區,文華里,198,2848,3269,6315,65,6380,0,6380,1600,7980,79.9499
第15任總統副總統,在高雄市各村(里),高雄市,　鳳山區,文山里,158,1512,3109,4779,47,4826,0,4826,1276,6102,79.0888
第15任總統副總統,在高雄市各村(里),高雄市,　鳳山區,文德里,224,2664,3705,6593,73,6666,0,6666,1848,8514,78.2946
第15任總統副總統,在高雄市各村(里),高雄市,　鳳山區,文衡里,102,1100,1843,3045,28,3073,0,3073,837,3910,78.5934
第15任總統副總統,在高雄市各村(里),高雄市,　鳳山區,文福里,233,2734,4120,7087,64,7151,0,7151,1885,9036,79.1390
第15任總統副總統,在高雄市各村(里),高雄市,　鳳山區,成功里,17,179,360,556,2,558,0,558,163,721,77.3925
第15任總統副總統,在高雄市各村(里),高雄市,　鳳山區,縣口里,21,285,258,564,6,570,0,570,196,766,74.4125
第15任總統副總統,在高雄市各村(里),高雄市,　鳳山區,光明里,31,358,586,975,5,980,0,980,287,1267,77.3481
第15任總統副總統,在高雄市各村(里),高雄市,　鳳山區,和德里,57,584,887,1528,15,1543,0,1543,354,1897,81.3390
第15任總統副總統,在高雄市各村(里),高雄市,　鳳山區,和興里,122,1356,2202,3680,33,3713,0,3713,854,4567,81.3006
第15任總統副總統,在高雄市各村(里),高雄市,　鳳山區,南興里,22,241,427,690,8,698,0,698,167,865,80.6936
第15任總統副總統,在高雄市各村(里),高雄市,　鳳山區,三民里,19,289,461,769,5,774,0,774,216,990,78.1818
第15任總統副總統,在高雄市各村(里),高雄市,　鳳山區,新興里,28,429,755,1212,11,1223,0,1223,1262,2485,49.2153
第15任總統副總統,在高雄市各村(里),高雄市,　鳳山區,興仁里,81,982,1516,2579,33,2612,0,2612,695,3307,78.9840
第15任總統副總統,在高雄市各村(里),高雄市,　鳳山區,興中里,25,278,378,681,10,691,0,691,144,835,82.7545
第15任總統副總統,在高雄市各村(里),高雄市,　鳳山區,協和里,102,1070,1354,2526,27,2553,0,2553,621,3174,80.4348
第15任總統副總統,在高雄市各村(里),高雄市,　鳳山區,忠義里,112,1391,1967,3470,29,3499,0,3499,941,4440,78.8063
第15任總統副總統,在高雄市各村(里),高雄市,　鳳山區,忠孝里,147,1689,2447,4283,31,4314,0,4314,1213,5527,78.0532
第15任總統副總統,在高雄市各村(里),高雄市,　鳳山區,中和里,92,1136,1404,2632,27,2659,0,2659,641,3300,80.5758
第15任總統副總統,在高雄市各村(里),高雄市,　鳳山區,誠義里,113,1272,1554,2939,36,2975,0,2975,605,3580,83.1006
第15任總統副總統,在高雄市各村(里),高雄市,　鳳山區,生明里,48,735,726,1509,15,1524,0,1524,419,1943,78.4354
第15任總統副總統,在高雄市各村(里),高雄市,　鳳山區,鎮東里,48,697,1073,1818,19,1837,0,1837,529,2366,77.6416
第15任總統副總統,在高雄市各村(里),高雄市,　鳳山區,瑞竹里,119,1552,2151,3822,29,3851,0,3851,1028,4879,78.9301
第15任總統副總統,在高雄市各村(里),高雄市,　鳳山區,瑞興里,125,1556,1939,3620,43,3663,0,3663,942,4605,79.5440
第15任總統副總統,在高雄市各村(里),高雄市,　鳳山區,東門里,115,1861,1923,3899,46,3945,0,3945,1222,5167,76.3499
第15任總統副總統,在高雄市各村(里),高雄市,　鳳山區,誠德里,70,917,946,1933,12,1945,0,1945,487,2432,79.9753
第15任總統副總統,在高雄市各村(里),高雄市,　鳳山區,誠信里,50,841,721,1612,12,1624,0,1624,515,2139,75.9233
第15任總統副總統,在高雄市各村(里),高雄市,　鳳山區,誠智里,73,929,942,1944,19,1963,0,1963,631,2594,75.6746
第15任總統副總統,在高雄市各村(里),高雄市,　鳳山區,鳳東里,161,1758,2752,4671,43,4714,0,4714,1155,5869,80.3203
第15任總統副總統,在高雄市各村(里),高雄市,　鳳山區,埤頂里,162,1875,2519,4556,29,4585,0,4585,1226,5811,78.9021
第15任總統副總統,在高雄市各村(里),高雄市,　鳳山區,中正里,90,2249,759,3098,30,3128,0,3128,831,3959,79.0099
第15任總統副總統,在高雄市各村(里),高雄市,　鳳山區,海光里,69,1020,1060,2149,17,2166,0,2166,627,2793,77.5510
第15任總統副總統,在高雄市各村(里),高雄市,　鳳山區,國泰里,84,1056,1678,2818,21,2839,0,2839,793,3632,78.1663
第15任總統副總統,在高雄市各村(里),高雄市,　鳳山區,國光里,72,959,1504,2535,27,2562,0,2562,690,3252,78.7823
第15任總統副總統,在高雄市各村(里),高雄市,　鳳山區,國隆里,42,572,1210,1824,13,1837,0,1837,565,2402,76.4779
第15任總統副總統,在高雄市各村(里),高雄市,　鳳山區,國富里,80,759,1185,2024,20,2044,0,2044,443,2487,82.1874
第15任總統副總統,在高雄市各村(里),高雄市,　鳳山區,武慶里,49,574,1157,1780,20,1800,0,1800,456,2256,79.7872
第15任總統副總統,在高雄市各村(里),高雄市,　鳳山區,武漢里,131,1148,2270,3549,21,3570,0,3570,996,4566,78.1866
第15任總統副總統,在高雄市各村(里),高雄市,　鳳山區,新甲里,60,653,1409,2122,23,2145,1,2146,595,2741,78.2561
第15任總統副總統,在高雄市各村(里),高雄市,　鳳山區,新武里,72,513,1157,1742,17,1759,0,1759,464,2223,79.1273
第15任總統副總統,在高雄市各村(里),高雄市,　鳳山區,新泰里,115,993,1944,3052,26,3078,0,3078,829,3907,78.7817
第15任總統副總統,在高雄市各村(里),高雄市,　鳳山區,新樂里,115,1145,2107,3367,36,3403,0,3403,836,4239,80.2784
第15任總統副總統,在高雄市各村(里),高雄市,　鳳山區,新強里,156,1385,2512,4053,32,4085,0,4085,1032,5117,79.8319
第15任總統副總統,在高雄市各村(里),高雄市,　鳳山區,海洋里,99,974,1865,2938,23,2961,0,2961,681,3642,81.3015
第15任總統副總統,在高雄市各村(里),高雄市,　鳳山區,新富里,100,951,1942,2993,24,3017,0,3017,859,3876,77.8380
第15任總統副總統,在高雄市各村(里),高雄市,　鳳山區,老爺里,156,1493,3438,5087,50,5137,1,5138,1446,6584,78.0225
第15任總統副總統,在高雄市各村(里),高雄市,　鳳山區,中民里,99,1025,2178,3302,39,3341,0,3341,1021,4362,76.5933
第15任總統副總統,在高雄市各村(里),高雄市,　鳳山區,中崙里,52,729,1138,1919,15,1934,0,1934,579,2513,76.9598
第15任總統副總統,在高雄市各村(里),高雄市,　鳳山區,中榮里,132,1161,2045,3338,25,3363,0,3363,958,4321,77.8292
第15任總統副總統,在高雄市各村(里),高雄市,　鳳山區,過埤里,301,3402,6216,9919,90,10009,0,10009,2957,12966,77.1942
第15任總統副總統,在高雄市各村(里),高雄市,　鳳山區,正義里,116,1353,3241,4710,45,4755,0,4755,1244,5999,79.2632
第15任總統副總統,在高雄市各村(里),高雄市,　鳳山區,保安里,161,1512,3124,4797,46,4843,0,4843,1140,5983,80.9460
第15任總統副總統,在高雄市各村(里),高雄市,　鳳山區,一甲里,48,707,1675,2430,22,2452,0,2452,773,3225,76.0310
第15任總統副總統,在高雄市各村(里),高雄市,　鳳山區,二甲里,109,1040,2245,3394,36,3430,0,3430,908,4338,79.0687
第15任總統副總統,在高雄市各村(里),高雄市,　鳳山區,龍成里,75,568,1467,2110,16,2126,0,2126,595,2721,78.1330
第15任總統副總統,在高雄市各村(里),高雄市,　鳳山區,鎮南里,120,1112,2353,3585,42,3627,0,3627,1004,4631,78.3200
第15任總統副總統,在高雄市各村(里),高雄市,　鳳山區,富甲里,53,444,961,1458,10,1468,0,1468,1037,2505,58.6028
第15任總統副總統,在高雄市各村(里),高雄市,　鳳山區,善美里,111,1258,2657,4026,30,4056,0,4056,1178,5234,77.4933
第15任總統副總統,在高雄市各村(里),高雄市,　鳳山區,富榮里,68,577,1171,1816,26,1842,0,1842,531,2373,77.6233
第15任總統副總統,在高雄市各村(里),高雄市,　鳳山區,南和里,56,604,1355,2015,17,2032,0,2032,569,2601,78.1238
第15任總統副總統,在高雄市各村(里),高雄市,　鳳山區,南成里,156,1742,4108,6006,51,6057,0,6057,1504,7561,80.1085
第15任總統副總統,在高雄市各村(里),高雄市,　鳳山區,天興里,67,774,1757,2598,29,2627,0,2627,751,3378,77.7679
第15任總統副總統,在高雄市各村(里),高雄市,　鳳山區,大德里,95,951,2183,3229,32,3261,0,3261,911,4172,78.1640
第15任總統副總統,在高雄市各村(里),高雄市,　鳳山區,五福里,74,712,1506,2292,33,2325,0,2325,593,2918,79.6779
第15任總統副總統,在高雄市各村(里),高雄市,　鳳山區,福興里,119,1288,2933,4340,49,4389,0,4389,1330,5719,76.7442
第15任總統副總統,在高雄市各村(里),高雄市,　鳳山區,福祥里,53,553,1371,1977,17,1994,0,1994,560,2554,78.0736
第15任總統副總統,在高雄市各村(里),高雄市,　鳳山區,福誠里,93,1077,2251,3421,32,3453,0,3453,861,4314,80.0417
第15任總統副總統,在高雄市各村(里),高雄市,　林園區,東林里,59,608,1386,2053,23,2076,0,2076,632,2708,76.6617
第15任總統副總統,在高雄市各村(里),高雄市,　林園區,林園里,57,715,1517,2289,30,2319,0,2319,628,2947,78.6902
第15任總統副總統,在高雄市各村(里),高雄市,　林園區,溪州里,81,810,1969,2860,44,2904,0,2904,940,3844,75.5463
第15任總統副總統,在高雄市各村(里),高雄市,　林園區,潭頭里,73,646,1260,1979,21,2000,0,2000,693,2693,74.2666
第15任總統副總統,在高雄市各村(里),高雄市,　林園區,中厝里,63,744,1345,2152,35,2187,0,2187,668,2855,76.6025
第15任總統副總統,在高雄市各村(里),高雄市,　林園區,中門里,49,550,1241,1840,22,1862,0,1862,580,2442,76.2490
第15任總統副總統,在高雄市各村(里),高雄市,　林園區,頂厝里,91,900,2317,3308,25,3333,0,3333,1044,4377,76.1480
第15任總統副總統,在高雄市各村(里),高雄市,　林園區,港埔里,31,326,978,1335,14,1349,0,1349,419,1768,76.3009
第15任總統副總統,在高雄市各村(里),高雄市,　林園區,西溪里,82,617,1865,2564,14,2578,0,2578,777,3355,76.8405
第15任總統副總統,在高雄市各村(里),高雄市,　林園區,港嘴里,34,279,946,1259,11,1270,0,1270,361,1631,77.8663
第15任總統副總統,在高雄市各村(里),高雄市,　林園區,北汕里,25,391,705,1121,16,1137,0,1137,433,1570,72.4204
第15任總統副總統,在高雄市各村(里),高雄市,　林園區,林內里,52,562,811,1425,11,1436,0,1436,473,1909,75.2226
第15任總統副總統,在高雄市各村(里),高雄市,　林園區,王公里,88,864,2011,2963,38,3001,0,3001,917,3918,76.5952
第15任總統副總統,在高雄市各村(里),高雄市,　林園區,林家里,31,255,648,934,15,949,0,949,306,1255,75.6175
第15任總統副總統,在高雄市各村(里),高雄市,　林園區,龔厝里,45,408,1005,1458,7,1465,0,1465,409,1874,78.1750
第15任總統副總統,在高雄市各村(里),高雄市,　林園區,鳳芸里,26,304,1039,1369,7,1376,0,1376,363,1739,79.1259
第15任總統副總統,在高雄市各村(里),高雄市,　林園區,中芸里,45,295,1000,1340,11,1351,0,1351,398,1749,77.2441
第15任總統副總統,在高雄市各村(里),高雄市,　林園區,東汕里,20,167,436,623,4,627,0,627,251,878,71.4123
第15任總統副總統,在高雄市各村(里),高雄市,　林園區,西汕里,13,116,391,520,3,523,0,523,208,731,71.5458
第15任總統副總統,在高雄市各村(里),高雄市,　林園區,仁愛里,71,606,1562,2239,28,2267,0,2267,607,2874,78.8796
第15任總統副總統,在高雄市各村(里),高雄市,　林園區,文賢里,60,561,1155,1776,20,1796,0,1796,521,2317,77.5140
第15任總統副總統,在高雄市各村(里),高雄市,　林園區,廣應里,85,689,1768,2542,26,2568,0,2568,737,3305,77.7005
第15任總統副總統,在高雄市各村(里),高雄市,　林園區,五福里,43,499,1265,1807,21,1828,0,1828,679,2507,72.9158
第15任總統副總統,在高雄市各村(里),高雄市,　林園區,中汕里,35,335,1262,1632,26,1658,0,1658,597,2255,73.5255
第15任總統副總統,在高雄市各村(里),高雄市,　大寮區,拷潭里,23,243,793,1059,17,1076,0,1076,311,1387,77.5775
第15任總統副總統,在高雄市各村(里),高雄市,　大寮區,內坑里,116,1319,2484,3919,38,3957,0,3957,1667,5624,70.3592
第15任總統副總統,在高雄市各村(里),高雄市,　大寮區,大寮里,162,1313,3300,4775,55,4830,0,4830,1684,6514,74.1480
第15任總統副總統,在高雄市各村(里),高雄市,　大寮區,上寮里,55,381,1381,1817,18,1835,0,1835,494,2329,78.7892
第15任總統副總統,在高雄市各村(里),高雄市,　大寮區,三隆里,115,973,2320,3408,31,3439,0,3439,1044,4483,76.7120
第15任總統副總統,在高雄市各村(里),高雄市,　大寮區,琉球里,92,849,2431,3372,34,3406,0,3406,884,4290,79.3939
第15任總統副總統,在高雄市各村(里),高雄市,　大寮區,翁園里,95,638,2236,2969,28,2997,0,2997,746,3743,80.0695
第15任總統副總統,在高雄市各村(里),高雄市,　大寮區,前庄里,47,631,1127,1805,14,1819,0,1819,455,2274,79.9912
第15任總統副總統,在高雄市各村(里),高雄市,　大寮區,中庄里,241,2508,5170,7919,82,8001,0,8001,2421,10422,76.7703
第15任總統副總統,在高雄市各村(里),高雄市,　大寮區,後庄里,191,1928,3624,5743,47,5790,0,5790,1665,7455,77.6660
第15任總統副總統,在高雄市各村(里),高雄市,　大寮區,義仁里,34,371,941,1346,10,1356,0,1356,412,1768,76.6968
第15任總統副總統,在高雄市各村(里),高雄市,　大寮區,新厝里,31,299,883,1213,11,1224,0,1224,352,1576,77.6650
第15任總統副總統,在高雄市各村(里),高雄市,　大寮區,過溪里,45,522,1247,1814,28,1842,0,1842,558,2400,76.7500
第15任總統副總統,在高雄市各村(里),高雄市,　大寮區,潮寮里,60,534,1639,2233,29,2262,0,2262,606,2868,78.8703
第15任總統副總統,在高雄市各村(里),高雄市,　大寮區,會結里,29,315,743,1087,9,1096,0,1096,425,1521,72.0579
第15任總統副總統,在高雄市各村(里),高雄市,　大寮區,會社里,134,1502,2548,4184,46,4230,0,4230,1767,5997,70.5353
第15任總統副總統,在高雄市各村(里),高雄市,　大寮區,山頂里,164,2308,3068,5540,57,5597,0,5597,1657,7254,77.1574
第15任總統副總統,在高雄市各村(里),高雄市,　大寮區,忠義里,11,221,160,392,5,397,0,397,135,532,74.6241
第15任總統副總統,在高雄市各村(里),高雄市,　大寮區,永芳里,169,1608,3314,5091,45,5136,0,5136,1485,6621,77.5714
第15任總統副總統,在高雄市各村(里),高雄市,　大寮區,義和里,47,445,1197,1689,20,1709,0,1709,438,2147,79.5994
第15任總統副總統,在高雄市各村(里),高雄市,　大寮區,溪寮里,33,326,817,1176,18,1194,0,1194,291,1485,80.4040
第15任總統副總統,在高雄市各村(里),高雄市,　大寮區,江山里,44,407,1000,1451,13,1464,0,1464,316,1780,82.2472
第15任總統副總統,在高雄市各村(里),高雄市,　大寮區,昭明里,68,686,1956,2710,23,2733,0,2733,870,3603,75.8535
第15任總統副總統,在高雄市各村(里),高雄市,　大寮區,光武里,3,93,45,141,2,143,0,143,41,184,77.7174
第15任總統副總統,在高雄市各村(里),高雄市,　大寮區,中興里,155,2580,2228,4963,55,5018,0,5018,1555,6573,76.3426
第15任總統副總統,在高雄市各村(里),高雄市,　大樹區,竹寮里,66,722,1245,2033,19,2052,0,2052,573,2625,78.1714
第15任總統副總統,在高雄市各村(里),高雄市,　大樹區,九曲里,108,1284,2329,3721,47,3768,0,3768,1138,4906,76.8039
第15任總統副總統,在高雄市各村(里),高雄市,　大樹區,久堂里,99,1128,1934,3161,42,3203,0,3203,791,3994,80.1953
第15任總統副總統,在高雄市各村(里),高雄市,　大樹區,水安里,46,478,1215,1739,20,1759,0,1759,511,2270,77.4890
第15任總統副總統,在高雄市各村(里),高雄市,　大樹區,水寮里,40,467,1219,1726,21,1747,0,1747,425,2172,80.4328
第15任總統副總統,在高雄市各村(里),高雄市,　大樹區,檨腳里,63,720,1793,2576,34,2610,0,2610,777,3387,77.0593
第15任總統副總統,在高雄市各村(里),高雄市,　大樹區,興山里,17,144,595,756,11,767,0,767,267,1034,74.1779
第15任總統副總統,在高雄市各村(里),高雄市,　大樹區,和山里,18,156,611,785,6,791,0,791,200,991,79.8184
第15任總統副總統,在高雄市各村(里),高雄市,　大樹區,姑山里,26,170,549,745,5,750,0,750,175,925,81.0811
第15任總統副總統,在高雄市各村(里),高雄市,　大樹區,大坑里,32,286,738,1056,12,1068,0,1068,348,1416,75.4237
第15任總統副總統,在高雄市各村(里),高雄市,　大樹區,井腳里,22,260,889,1171,11,1182,0,1182,324,1506,78.4861
第15任總統副總統,在高雄市各村(里),高雄市,　大樹區,小坪里,25,291,691,1007,1,1008,0,1008,275,1283,78.5659
第15任總統副總統,在高雄市各村(里),高雄市,　大樹區,龍目里,32,222,1017,1271,14,1285,0,1285,429,1714,74.9708
第15任總統副總統,在高雄市各村(里),高雄市,　大樹區,大樹里,53,451,1322,1826,9,1835,0,1835,575,2410,76.1411
第15任總統副總統,在高雄市各村(里),高雄市,　大樹區,三和里,17,233,469,719,6,725,0,725,256,981,73.9042
第15任總統副總統,在高雄市各村(里),高雄市,　大樹區,溪埔里,21,343,845,1209,9,1218,2,1220,320,1540,79.0909
第15任總統副總統,在高雄市各村(里),高雄市,　大樹區,興田里,29,670,776,1475,9,1484,0,1484,375,1859,79.8279
第15任總統副總統,在高雄市各村(里),高雄市,　大樹區,統嶺里,10,193,328,531,5,536,0,536,149,685,78.2482
第15任總統副總統,在高雄市各村(里),高雄市,　大社區,嘉誠里,19,230,421,670,2,672,0,672,240,912,73.6842
第15任總統副總統,在高雄市各村(里),高雄市,　大社區,保社里,77,751,1598,2426,21,2447,0,2447,636,3083,79.3707
第15任總統副總統,在高雄市各村(里),高雄市,　大社區,大社里,115,1090,2451,3656,37,3693,0,3693,1152,4845,76.2229
第15任總統副總統,在高雄市各村(里),高雄市,　大社區,保安里,71,669,1687,2427,20,2447,0,2447,619,3066,79.8108
第15任總統副總統,在高雄市各村(里),高雄市,　大社區,三奶里,54,591,1396,2041,19,2060,0,2060,551,2611,78.8970
第15任總統副總統,在高雄市各村(里),高雄市,　大社區,觀音里,104,1142,2874,4120,30,4150,0,4150,1092,5242,79.1683
第15任總統副總統,在高雄市各村(里),高雄市,　大社區,神農里,116,1049,2542,3707,42,3749,0,3749,1106,4855,77.2194
第15任總統副總統,在高雄市各村(里),高雄市,　大社區,中里里,69,686,1564,2319,35,2354,0,2354,683,3037,77.5107
第15任總統副總統,在高雄市各村(里),高雄市,　大社區,翠屏里,24,333,917,1274,12,1286,0,1286,340,1626,79.0898
第15任總統副總統,在高雄市各村(里),高雄市,　仁武區,大灣里,103,900,2116,3119,28,3147,0,3147,894,4041,77.8768
第15任總統副總統,在高雄市各村(里),高雄市,　仁武區,灣內里,196,1812,3733,5741,45,5786,0,5786,1639,7425,77.9259
第15任總統副總統,在高雄市各村(里),高雄市,　仁武區,考潭里,53,699,1268,2020,18,2038,0,2038,543,2581,78.9616
第15任總統副總統,在高雄市各村(里),高雄市,　仁武區,烏林里,82,815,1813,2710,32,2742,0,2742,1000,3742,73.2763
第15任總統副總統,在高雄市各村(里),高雄市,　仁武區,仁福里,19,173,411,603,7,610,0,610,203,813,75.0308
第15任總統副總統,在高雄市各村(里),高雄市,　仁武區,仁武里,109,1119,2614,3842,42,3884,0,3884,1421,5305,73.2139
第15任總統副總統,在高雄市各村(里),高雄市,　仁武區,文武里,181,2051,4504,6736,59,6795,0,6795,1791,8586,79.1405
第15任總統副總統,在高雄市各村(里),高雄市,　仁武區,竹後里,40,353,1313,1706,10,1716,0,1716,460,2176,78.8603
第15任總統副總統,在高雄市各村(里),高雄市,　仁武區,八卦里,408,4212,7730,12350,82,12432,0,12432,3572,16004,77.6806
第15任總統副總統,在高雄市各村(里),高雄市,　仁武區,高楠里,55,511,1220,1786,8,1794,0,1794,436,2230,80.4484
第15任總統副總統,在高雄市各村(里),高雄市,　仁武區,後安里,62,476,1363,1901,15,1916,0,1916,522,2438,78.5890
第15任總統副總統,在高雄市各村(里),高雄市,　仁武區,中華里,48,395,769,1212,13,1225,0,1225,364,1589,77.0925
第15任總統副總統,在高雄市各村(里),高雄市,　仁武區,五和里,143,1077,2419,3639,34,3673,0,3673,1049,4722,77.7848
第15任總統副總統,在高雄市各村(里),高雄市,　仁武區,仁和里,84,977,1826,2887,34,2921,0,2921,739,3660,79.8087
第15任總統副總統,在高雄市各村(里),高雄市,　仁武區,赤山里,164,1562,3092,4818,45,4863,0,4863,1284,6147,79.1118
第15任總統副總統,在高雄市各村(里),高雄市,　仁武區,仁慈里,63,594,1023,1680,23,1703,0,1703,394,2097,81.2113
第15任總統副總統,在高雄市各村(里),高雄市,　鳥松區,鳥松里,254,2612,4845,7711,72,7783,0,7783,2376,10159,76.6119
第15任總統副總統,在高雄市各村(里),高雄市,　鳥松區,夢裡里,117,1253,2229,3599,40,3639,0,3639,1029,4668,77.9563
第15任總統副總統,在高雄市各村(里),高雄市,　鳥松區,大華里,245,2892,4552,7689,78,7767,0,7767,1975,9742,79.7270
第15任總統副總統,在高雄市各村(里),高雄市,　鳥松區,坔埔里,72,791,1896,2759,29,2788,0,2788,696,3484,80.0230
第15任總統副總統,在高雄市各村(里),高雄市,　鳥松區,仁美里,167,1427,3332,4926,51,4977,0,4977,1380,6357,78.2916
第15任總統副總統,在高雄市各村(里),高雄市,　鳥松區,大竹里,11,164,376,551,9,560,0,560,119,679,82.4742
第15任總統副總統,在高雄市各村(里),高雄市,　鳥松區,華美里,101,961,1917,2979,22,3001,0,3001,804,3805,78.8699
第15任總統副總統,在高雄市各村(里),高雄市,　岡山區,岡山里,94,1036,1940,3070,41,3111,0,3111,1141,4252,73.1656
第15任總統副總統,在高雄市各村(里),高雄市,　岡山區,壽天里,83,942,1448,2473,24,2497,0,2497,622,3119,80.0577
第15任總統副總統,在高雄市各村(里),高雄市,　岡山區,平安里,26,289,549,864,11,875,0,875,222,1097,79.7630
第15任總統副總統,在高雄市各村(里),高雄市,　岡山區,維仁里,20,223,489,732,9,741,0,741,239,980,75.6122
第15任總統副總統,在高雄市各村(里),高雄市,　岡山區,大遼里,20,194,794,1008,16,1024,0,1024,246,1270,80.6299
第15任總統副總統,在高雄市各村(里),高雄市,　岡山區,程香里,93,1181,1850,3124,18,3142,0,3142,818,3960,79.3434
第15任總統副總統,在高雄市各村(里),高雄市,　岡山區,後紅里,108,1178,1734,3020,32,3052,0,3052,914,3966,76.9541
第15任總統副總統,在高雄市各村(里),高雄市,　岡山區,碧紅里,87,996,1835,2918,21,2939,0,2939,844,3783,77.6897
第15任總統副總統,在高雄市各村(里),高雄市,　岡山區,竹圍里,183,1703,3244,5130,42,5172,0,5172,1355,6527,79.2401
第15任總統副總統,在高雄市各村(里),高雄市,　岡山區,台上里,152,1310,2773,4235,38,4273,0,4273,1164,5437,78.5911
第15任總統副總統,在高雄市各村(里),高雄市,　岡山區,為隨里,30,108,362,500,5,505,0,505,96,601,84.0266
第15任總統副總統,在高雄市各村(里),高雄市,　岡山區,灣裡里,62,406,929,1397,11,1408,0,1408,359,1767,79.6831
第15任總統副總統,在高雄市各村(里),高雄市,　岡山區,本洲里,42,356,912,1310,19,1329,0,1329,305,1634,81.3341
第15任總統副總統,在高雄市各村(里),高雄市,　岡山區,前峰里,78,706,1325,2109,21,2130,0,2130,572,2702,78.8305
第15任總統副總統,在高雄市各村(里),高雄市,　岡山區,壽峰里,60,627,1019,1706,16,1722,0,1722,431,2153,79.9814
第15任總統副總統,在高雄市各村(里),高雄市,　岡山區,仁壽里,79,921,1522,2522,23,2545,0,2545,683,3228,78.8414
第15任總統副總統,在高雄市各村(里),高雄市,　岡山區,後協里,165,1678,2339,4182,43,4225,0,4225,1153,5378,78.5608
第15任總統副總統,在高雄市各村(里),高雄市,　岡山區,協和里,101,1006,1678,2785,38,2823,0,2823,671,3494,80.7956
第15任總統副總統,在高雄市各村(里),高雄市,　岡山區,協榮里,52,732,832,1616,18,1634,0,1634,433,2067,79.0518
第15任總統副總統,在高雄市各村(里),高雄市,　岡山區,劉厝里,36,306,769,1111,9,1120,0,1120,256,1376,81.3953
第15任總統副總統,在高雄市各村(里),高雄市,　岡山區,白米里,62,471,861,1394,10,1404,0,1404,340,1744,80.5046
第15任總統副總統,在高雄市各村(里),高雄市,　岡山區,石潭里,41,438,1011,1490,9,1499,0,1499,316,1815,82.5895
第15任總統副總統,在高雄市各村(里),高雄市,　岡山區,福興里,31,278,527,836,7,843,0,843,186,1029,81.9242
第15任總統副總統,在高雄市各村(里),高雄市,　岡山區,嘉興里,90,609,1899,2598,19,2617,0,2617,697,3314,78.9680
第15任總統副總統,在高雄市各村(里),高雄市,　岡山區,嘉峰里,42,361,945,1348,19,1367,0,1367,343,1710,79.9415
第15任總統副總統,在高雄市各村(里),高雄市,　岡山區,潭底里,20,143,453,616,2,618,0,618,130,748,82.6203
第15任總統副總統,在高雄市各村(里),高雄市,　岡山區,華崗里,38,198,1005,1241,10,1251,0,1251,284,1535,81.4984
第15任總統副總統,在高雄市各村(里),高雄市,　岡山區,三和里,25,149,506,680,15,695,0,695,167,862,80.6265
第15任總統副總統,在高雄市各村(里),高雄市,　岡山區,大莊里,35,263,449,747,14,761,0,761,189,950,80.1053
第15任總統副總統,在高雄市各村(里),高雄市,　岡山區,忠孝里,70,1582,582,2234,20,2254,0,2254,602,2856,78.9216
第15任總統副總統,在高雄市各村(里),高雄市,　岡山區,仁義里,52,1179,266,1497,20,1517,0,1517,325,1842,82.3561
第15任總統副總統,在高雄市各村(里),高雄市,　岡山區,信義里,44,603,578,1225,10,1235,0,1235,330,1565,78.9137
第15任總統副總統,在高雄市各村(里),高雄市,　岡山區,和平里,9,85,149,243,5,248,0,248,62,310,80.0000
第15任總統副總統,在高雄市各村(里),高雄市,　橋頭區,橋頭里,57,463,1085,1605,14,1619,0,1619,404,2023,80.0297
第15任總統副總統,在高雄市各村(里),高雄市,　橋頭區,橋南里,24,246,573,843,7,850,0,850,214,1064,79.8872
第15任總統副總統,在高雄市各村(里),高雄市,　橋頭區,仕隆里,50,478,1230,1758,21,1779,0,1779,459,2238,79.4906
第15任總統副總統,在高雄市各村(里),高雄市,　橋頭區,仕豐里,57,591,1353,2001,21,2022,0,2022,487,2509,80.5899
第15任總統副總統,在高雄市各村(里),高雄市,　橋頭區,芋寮里,28,225,703,956,8,964,0,964,220,1184,81.4189
第15任總統副總統,在高雄市各村(里),高雄市,　橋頭區,東林里,46,407,1347,1800,27,1827,0,1827,438,2265,80.6623
第15任總統副總統,在高雄市各村(里),高雄市,　橋頭區,西林里,35,223,857,1115,12,1127,0,1127,242,1369,82.3229
第15任總統副總統,在高雄市各村(里),高雄市,　橋頭區,白樹里,86,706,1683,2475,18,2493,0,2493,676,3169,78.6683
第15任總統副總統,在高雄市各村(里),高雄市,　橋頭區,筆秀里,33,270,916,1219,12,1231,0,1231,278,1509,81.5772
第15任總統副總統,在高雄市各村(里),高雄市,　橋頭區,新莊里,91,787,1567,2445,17,2462,0,2462,632,3094,79.5734
第15任總統副總統,在高雄市各村(里),高雄市,　橋頭區,甲北里,53,404,1084,1541,21,1562,0,1562,397,1959,79.7346
第15任總統副總統,在高雄市各村(里),高雄市,　橋頭區,甲南里,61,553,1282,1896,22,1918,0,1918,444,2362,81.2024
第15任總統副總統,在高雄市各村(里),高雄市,　橋頭區,頂鹽里,21,298,739,1058,14,1072,0,1072,245,1317,81.3971
第15任總統副總統,在高雄市各村(里),高雄市,　橋頭區,中崎里,15,116,392,523,4,527,0,527,115,642,82.0872
第15任總統副總統,在高雄市各村(里),高雄市,　橋頭區,仕和里,90,757,2026,2873,35,2908,0,2908,660,3568,81.5022
第15任總統副總統,在高雄市各村(里),高雄市,　橋頭區,德松里,38,288,768,1094,19,1113,0,1113,234,1347,82.6281
第15任總統副總統,在高雄市各村(里),高雄市,　橋頭區,三德里,15,101,472,588,10,598,0,598,150,748,79.9465
第15任總統副總統,在高雄市各村(里),高雄市,　燕巢區,尖山里,24,236,564,824,9,833,0,833,264,1097,75.9344
第15任總統副總統,在高雄市各村(里),高雄市,　燕巢區,瓊林里,53,412,1139,1604,15,1619,0,1619,402,2021,80.1089
第15任總統副總統,在高雄市各村(里),高雄市,　燕巢區,安招里,58,722,1710,2490,31,2521,0,2521,723,3244,77.7127
第15任總統副總統,在高雄市各村(里),高雄市,　燕巢區,角宿里,60,687,1339,2086,22,2108,0,2108,502,2610,80.7663
第15任總統副總統,在高雄市各村(里),高雄市,　燕巢區,鳳雄里,52,566,1203,1821,21,1842,0,1842,562,2404,76.6223
第15任總統副總統,在高雄市各村(里),高雄市,　燕巢區,金山里,12,137,209,358,1,359,0,359,99,458,78.3843
第15任總統副總統,在高雄市各村(里),高雄市,　燕巢區,東燕里,59,530,1167,1756,20,1776,0,1776,476,2252,78.8632
第15任總統副總統,在高雄市各村(里),高雄市,　燕巢區,南燕里,79,940,1642,2661,31,2692,0,2692,1037,3729,72.1909
第15任總統副總統,在高雄市各村(里),高雄市,　燕巢區,西燕里,82,797,1648,2527,29,2556,0,2556,707,3263,78.3328
第15任總統副總統,在高雄市各村(里),高雄市,　燕巢區,橫山里,37,432,849,1318,12,1330,0,1330,528,1858,71.5823
第15任總統副總統,在高雄市各村(里),高雄市,　燕巢區,深水里,41,595,1116,1752,24,1776,0,1776,615,2391,74.2785
第15任總統副總統,在高雄市各村(里),高雄市,　田寮區,鹿埔里,4,95,173,272,4,276,0,276,74,350,78.8571
第15任總統副總統,在高雄市各村(里),高雄市,　田寮區,南安里,16,206,504,726,8,734,0,734,292,1026,71.5400
第15任總統副總統,在高雄市各村(里),高雄市,　田寮區,大同里,4,67,198,269,2,271,0,271,89,360,75.2778
第15任總統副總統,在高雄市各村(里),高雄市,　田寮區,田寮里,12,86,179,277,2,279,0,279,96,375,74.4000
第15任總統副總統,在高雄市各村(里),高雄市,　田寮區,七星里,15,109,336,460,9,469,0,469,146,615,76.2602
第15任總統副總統,在高雄市各村(里),高雄市,　田寮區,崇德里,26,242,452,720,7,727,0,727,191,918,79.1939
第15任總統副總統,在高雄市各村(里),高雄市,　田寮區,西德里,18,194,382,594,7,601,0,601,177,778,77.2494
第15任總統副總統,在高雄市各村(里),高雄市,　田寮區,三和里,6,99,144,249,1,250,0,250,115,365,68.4932
第15任總統副總統,在高雄市各村(里),高雄市,　田寮區,古亭里,6,96,224,326,3,329,0,329,155,484,67.9752
第15任總統副總統,在高雄市各村(里),高雄市,　田寮區,新興里,17,203,689,909,6,915,0,915,254,1169,78.2720
第15任總統副總統,在高雄市各村(里),高雄市,　阿蓮區,石安里,30,196,706,932,10,942,0,942,334,1276,73.8245
第15任總統副總統,在高雄市各村(里),高雄市,　阿蓮區,中路里,27,302,1148,1477,9,1486,0,1486,457,1943,76.4797
第15任總統副總統,在高雄市各村(里),高雄市,　阿蓮區,峯山里,23,256,670,949,11,960,0,960,251,1211,79.2733
第15任總統副總統,在高雄市各村(里),高雄市,　阿蓮區,港後里,42,508,1053,1603,26,1629,0,1629,459,2088,78.0172
第15任總統副總統,在高雄市各村(里),高雄市,　阿蓮區,崗山里,12,161,408,581,5,586,0,586,177,763,76.8021
第15任總統副總統,在高雄市各村(里),高雄市,　阿蓮區,阿蓮里,98,1049,2449,3596,43,3639,0,3639,1153,4792,75.9391
第15任總統副總統,在高雄市各村(里),高雄市,　阿蓮區,清蓮里,64,526,1328,1918,15,1933,0,1933,619,2552,75.7445
第15任總統副總統,在高雄市各村(里),高雄市,　阿蓮區,和蓮里,52,432,1295,1779,10,1789,0,1789,435,2224,80.4406
第15任總統副總統,在高雄市各村(里),高雄市,　阿蓮區,青旗里,40,332,698,1070,13,1083,0,1083,359,1442,75.1040
第15任總統副總統,在高雄市各村(里),高雄市,　阿蓮區,復安里,44,392,826,1262,12,1274,0,1274,338,1612,79.0323
第15任總統副總統,在高雄市各村(里),高雄市,　阿蓮區,玉庫里,19,174,596,789,8,797,0,797,212,1009,78.9891
第15任總統副總統,在高雄市各村(里),高雄市,　阿蓮區,南蓮里,79,723,1381,2183,20,2203,0,2203,684,2887,76.3076
第15任總統副總統,在高雄市各村(里),高雄市,　路竹區,竹滬里,99,707,1539,2345,31,2376,0,2376,775,3151,75.4046
第15任總統副總統,在高雄市各村(里),高雄市,　路竹區,頂寮里,28,267,584,879,7,886,0,886,258,1144,77.4476
第15任總統副總統,在高雄市各村(里),高雄市,　路竹區,新達里,23,283,626,932,17,949,0,949,244,1193,79.5474
第15任總統副總統,在高雄市各村(里),高雄市,　路竹區,後鄉里,24,219,601,844,14,858,0,858,218,1076,79.7398
第15任總統副總統,在高雄市各村(里),高雄市,　路竹區,北嶺里,29,253,657,939,13,952,0,952,248,1200,79.3333
第15任總統副總統,在高雄市各村(里),高雄市,　路竹區,社西里,68,547,1080,1695,32,1727,0,1727,497,2224,77.6529
第15任總統副總統,在高雄市各村(里),高雄市,　路竹區,甲北里,61,446,1019,1526,19,1545,0,1545,481,2026,76.2586
第15任總統副總統,在高雄市各村(里),高雄市,　路竹區,甲南里,90,791,1430,2311,32,2343,0,2343,865,3208,73.0362
第15任總統副總統,在高雄市各村(里),高雄市,　路竹區,下坑里,103,578,1314,1995,36,2031,0,2031,558,2589,78.4473
第15任總統副總統,在高雄市各村(里),高雄市,　路竹區,竹園里,48,321,948,1317,17,1334,0,1334,430,1764,75.6236
第15任總統副總統,在高雄市各村(里),高雄市,　路竹區,竹東里,101,878,1646,2625,25,2650,0,2650,691,3341,79.3176
第15任總統副總統,在高雄市各村(里),高雄市,　路竹區,竹西里,61,570,1030,1661,19,1680,0,1680,486,2166,77.5623
第15任總統副總統,在高雄市各村(里),高雄市,　路竹區,文北里,85,635,1505,2225,29,2254,0,2254,655,2909,77.4837
第15任總統副總統,在高雄市各村(里),高雄市,　路竹區,文南里,81,595,1118,1794,20,1814,0,1814,459,2273,79.8064
第15任總統副總統,在高雄市各村(里),高雄市,　路竹區,三爺里,25,178,455,658,6,664,0,664,165,829,80.0965
第15任總統副總統,在高雄市各村(里),高雄市,　路竹區,鴨寮里,57,431,954,1442,16,1458,0,1458,391,1849,78.8534
第15任總統副總統,在高雄市各村(里),高雄市,　路竹區,社東里,45,375,905,1325,15,1340,0,1340,329,1669,80.2876
第15任總統副總統,在高雄市各村(里),高雄市,　路竹區,社中里,17,191,408,616,6,622,0,622,229,851,73.0905
第15任總統副總統,在高雄市各村(里),高雄市,　路竹區,竹南里,78,692,1262,2032,21,2053,0,2053,583,2636,77.8832
第15任總統副總統,在高雄市各村(里),高雄市,　路竹區,社南里,143,1105,2193,3441,33,3474,0,3474,905,4379,79.3332
第15任總統副總統,在高雄市各村(里),高雄市,　湖內區,海山里,21,243,550,814,13,827,0,827,242,1069,77.3620
第15任總統副總統,在高雄市各村(里),高雄市,　湖內區,劉家里,23,173,545,741,10,751,0,751,214,965,77.8238
第15任總統副總統,在高雄市各村(里),高雄市,　湖內區,太爺里,26,185,412,623,8,631,0,631,144,775,81.4194
第15任總統副總統,在高雄市各村(里),高雄市,　湖內區,公舘里,71,475,1120,1666,22,1688,0,1688,440,2128,79.3233
第15任總統副總統,在高雄市各村(里),高雄市,　湖內區,葉厝里,61,418,1516,1995,24,2019,0,2019,555,2574,78.4382
第15任總統副總統,在高雄市各村(里),高雄市,　湖內區,大湖里,111,922,1676,2709,23,2732,0,2732,814,3546,77.0446
第15任總統副總統,在高雄市各村(里),高雄市,　湖內區,田尾里,21,241,484,746,12,758,0,758,199,957,79.2059
第15任總統副總統,在高雄市各村(里),高雄市,　湖內區,湖內里,114,857,1774,2745,29,2774,0,2774,833,3607,76.9060
第15任總統副總統,在高雄市各村(里),高雄市,　湖內區,海埔里,28,310,967,1305,16,1321,0,1321,438,1759,75.0995
第15任總統副總統,在高雄市各村(里),高雄市,　湖內區,文賢里,17,235,628,880,6,886,0,886,254,1140,77.7193
第15任總統副總統,在高雄市各村(里),高雄市,　湖內區,中賢里,49,393,1074,1516,28,1544,0,1544,591,2135,72.3185
第15任總統副總統,在高雄市各村(里),高雄市,　湖內區,逸賢里,24,210,583,817,14,831,0,831,259,1090,76.2385
第15任總統副總統,在高雄市各村(里),高雄市,　湖內區,忠興里,10,165,359,534,11,545,0,545,128,673,80.9807
第15任總統副總統,在高雄市各村(里),高雄市,　湖內區,湖東里,89,726,1099,1914,17,1931,0,1931,697,2628,73.4779
第15任總統副總統,在高雄市各村(里),高雄市,　茄萣區,福德里,12,168,581,761,11,772,0,772,184,956,80.7531
第15任總統副總統,在高雄市各村(里),高雄市,　茄萣區,萬福里,15,165,453,633,10,643,0,643,219,862,74.5940
第15任總統副總統,在高雄市各村(里),高雄市,　茄萣區,白雲里,33,430,798,1261,13,1274,0,1274,396,1670,76.2874
第15任總統副總統,在高雄市各村(里),高雄市,　茄萣區,嘉賜里,105,737,1919,2761,32,2793,0,2793,873,3666,76.1866
第15任總統副總統,在高雄市各村(里),高雄市,　茄萣區,嘉安里,44,367,881,1292,15,1307,0,1307,430,1737,75.2447
第15任總統副總統,在高雄市各村(里),高雄市,　茄萣區,嘉樂里,41,486,1038,1565,16,1581,0,1581,450,2031,77.8434
第15任總統副總統,在高雄市各村(里),高雄市,　茄萣區,嘉泰里,34,209,555,798,16,814,0,814,261,1075,75.7209
第15任總統副總統,在高雄市各村(里),高雄市,　茄萣區,嘉福里,21,189,466,676,13,689,0,689,262,951,72.4501
第15任總統副總統,在高雄市各村(里),高雄市,　茄萣區,和協里,17,218,560,795,7,802,0,802,297,1099,72.9754
第15任總統副總統,在高雄市各村(里),高雄市,　茄萣區,嘉定里,20,196,571,787,5,792,0,792,305,1097,72.1969
第15任總統副總統,在高雄市各村(里),高雄市,　茄萣區,保定里,71,567,1512,2150,30,2180,1,2181,695,2876,75.7997
第15任總統副總統,在高雄市各村(里),高雄市,　茄萣區,大定里,27,276,500,803,7,810,0,810,279,1089,74.3802
第15任總統副總統,在高雄市各村(里),高雄市,　茄萣區,光定里,21,194,434,649,7,656,0,656,257,913,71.8510
第15任總統副總統,在高雄市各村(里),高雄市,　茄萣區,吉定里,20,194,622,836,9,845,0,845,250,1095,77.1689
第15任總統副總統,在高雄市各村(里),高雄市,　茄萣區,崎漏里,87,1062,2101,3250,35,3285,0,3285,1139,4424,74.2541
第15任總統副總統,在高雄市各村(里),高雄市,　永安區,永安里,34,403,716,1153,8,1161,0,1161,368,1529,75.9320
第15任總統副總統,在高雄市各村(里),高雄市,　永安區,永華里,37,456,887,1380,13,1393,0,1393,360,1753,79.4638
第15任總統副總統,在高雄市各村(里),高雄市,　永安區,新港里,43,473,1204,1720,12,1732,0,1732,542,2274,76.1653
第15任總統副總統,在高雄市各村(里),高雄市,　永安區,鹽田里,5,56,202,263,2,265,0,265,108,373,71.0456
第15任總統副總統,在高雄市各村(里),高雄市,　永安區,保寧里,67,632,1216,1915,25,1940,0,1940,527,2467,78.6380
第15任總統副總統,在高雄市各村(里),高雄市,　永安區,維新里,107,668,1719,2494,28,2522,0,2522,777,3299,76.4474
第15任總統副總統,在高雄市各村(里),高雄市,　彌陀區,光和里,33,304,619,956,18,974,0,974,244,1218,79.9672
第15任總統副總統,在高雄市各村(里),高雄市,　彌陀區,彌靖里,54,428,904,1386,18,1404,0,1404,389,1793,78.3045
第15任總統副總統,在高雄市各村(里),高雄市,　彌陀區,彌仁里,14,148,233,395,2,397,0,397,132,529,75.0473
第15任總統副總統,在高雄市各村(里),高雄市,　彌陀區,彌壽里,19,239,330,588,6,594,0,594,120,714,83.1933
第15任總統副總統,在高雄市各村(里),高雄市,　彌陀區,彌陀里,45,490,806,1341,20,1361,0,1361,334,1695,80.2950
第15任總統副總統,在高雄市各村(里),高雄市,　彌陀區,舊港里,38,379,775,1192,20,1212,0,1212,317,1529,79.2675
第15任總統副總統,在高雄市各村(里),高雄市,　彌陀區,文安里,51,387,843,1281,20,1301,0,1301,366,1667,78.0444
第15任總統副總統,在高雄市各村(里),高雄市,　彌陀區,過港里,25,225,444,694,11,705,0,705,206,911,77.3875
第15任總統副總統,在高雄市各村(里),高雄市,　彌陀區,鹽埕里,68,453,1037,1558,32,1590,0,1590,390,1980,80.3030
第15任總統副總統,在高雄市各村(里),高雄市,　彌陀區,海尾里,23,248,357,628,9,637,0,637,168,805,79.1304
第15任總統副總統,在高雄市各村(里),高雄市,　彌陀區,漯底里,40,320,533,893,8,901,0,901,212,1113,80.9524
第15任總統副總統,在高雄市各村(里),高雄市,　彌陀區,南寮里,43,530,981,1554,21,1575,0,1575,436,2011,78.3192
第15任總統副總統,在高雄市各村(里),高雄市,　梓官區,梓信里,53,408,1161,1622,21,1643,0,1643,394,2037,80.6578
第15任總統副總統,在高雄市各村(里),高雄市,　梓官區,梓義里,46,380,1068,1494,16,1510,0,1510,471,1981,76.2241
第15任總統副總統,在高雄市各村(里),高雄市,　梓官區,梓和里,50,446,1258,1754,17,1771,0,1771,428,2199,80.5366
第15任總統副總統,在高雄市各村(里),高雄市,　梓官區,梓平里,33,267,834,1134,16,1150,0,1150,261,1411,81.5025
第15任總統副總統,在高雄市各村(里),高雄市,　梓官區,中崙里,34,231,619,884,7,891,0,891,247,1138,78.2953
第15任總統副總統,在高雄市各村(里),高雄市,　梓官區,同安里,15,199,532,746,4,750,0,750,204,954,78.6164
第15任總統副總統,在高雄市各村(里),高雄市,　梓官區,大舍里,91,743,1913,2747,30,2777,0,2777,750,3527,78.7355
第15任總統副總統,在高雄市各村(里),高雄市,　梓官區,赤崁里,37,333,984,1354,12,1366,0,1366,407,1773,77.0446
第15任總統副總統,在高雄市各村(里),高雄市,　梓官區,赤東里,39,424,1220,1683,19,1702,0,1702,485,2187,77.8235
第15任總統副總統,在高雄市各村(里),高雄市,　梓官區,赤西里,27,217,365,609,8,617,0,617,163,780,79.1026
第15任總統副總統,在高雄市各村(里),高雄市,　梓官區,禮蚵里,43,388,1143,1574,26,1600,0,1600,420,2020,79.2079
第15任總統副總統,在高雄市各村(里),高雄市,　梓官區,智蚵里,60,679,1445,2184,19,2203,0,2203,608,2811,78.3707
第15任總統副總統,在高雄市各村(里),高雄市,　梓官區,信蚵里,56,528,1181,1765,13,1778,0,1778,489,2267,78.4296
第15任總統副總統,在高雄市各村(里),高雄市,　梓官區,茄苳里,61,532,1149,1742,11,1753,0,1753,510,2263,77.4635
第15任總統副總統,在高雄市各村(里),高雄市,　梓官區,典寶里,71,696,1419,2186,28,2214,0,2214,638,2852,77.6297
第15任總統副總統,在高雄市各村(里),高雄市,　旗山區,太平里,69,552,952,1573,17,1590,0,1590,543,2133,74.5429
第15任總統副總統,在高雄市各村(里),高雄市,　旗山區,大德里,77,670,975,1722,29,1751,0,1751,501,2252,77.7531
第15任總統副總統,在高雄市各村(里),高雄市,　旗山區,湄洲里,34,455,674,1163,6,1169,0,1169,434,1603,72.9258
第15任總統副總統,在高雄市各村(里),高雄市,　旗山區,圓富里,35,449,749,1233,6,1239,0,1239,509,1748,70.8810
第15任總統副總統,在高雄市各村(里),高雄市,　旗山區,中正里,28,416,551,995,6,1001,0,1001,413,1414,70.7921
第15任總統副總統,在高雄市各村(里),高雄市,　旗山區,大林里,25,381,537,943,12,955,0,955,391,1346,70.9510
第15任總統副總統,在高雄市各村(里),高雄市,　旗山區,上洲里,24,185,561,770,7,777,0,777,232,1009,77.0069
第15任總統副總統,在高雄市各村(里),高雄市,　旗山區,新光里,16,202,353,571,7,578,0,578,176,754,76.6578
第15任總統副總統,在高雄市各村(里),高雄市,　旗山區,南勝里,32,476,1090,1598,15,1613,0,1613,474,2087,77.2880
第15任總統副總統,在高雄市各村(里),高雄市,　旗山區,中寮里,4,29,98,131,7,138,0,138,41,179,77.0950
第15任總統副總統,在高雄市各村(里),高雄市,　旗山區,東昌里,15,303,421,739,5,744,0,744,242,986,75.4564
第15任總統副總統,在高雄市各村(里),高雄市,　旗山區,東平里,44,542,882,1468,9,1477,0,1477,431,1908,77.4109
第15任總統副總統,在高雄市各村(里),高雄市,　旗山區,竹峰里,42,415,687,1144,8,1152,0,1152,373,1525,75.5410
第15任總統副總統,在高雄市各村(里),高雄市,　旗山區,瑞吉里,40,468,948,1456,12,1468,0,1468,493,1961,74.8598
第15任總統副總統,在高雄市各村(里),高雄市,　旗山區,永和里,73,743,1489,2305,15,2320,0,2320,867,3187,72.7957
第15任總統副總統,在高雄市各村(里),高雄市,　旗山區,三協里,69,574,929,1572,20,1592,0,1592,563,2155,73.8747
第15任總統副總統,在高雄市各村(里),高雄市,　旗山區,鯤洲里,16,111,416,543,5,548,0,548,171,719,76.2170
第15任總統副總統,在高雄市各村(里),高雄市,　旗山區,大山里,22,295,643,960,3,963,0,963,302,1265,76.1265
第15任總統副總統,在高雄市各村(里),高雄市,　旗山區,中洲里,13,163,438,614,5,619,0,619,188,807,76.7038
第15任總統副總統,在高雄市各村(里),高雄市,　旗山區,南洲里,30,317,662,1009,9,1018,0,1018,259,1277,79.7181
第15任總統副總統,在高雄市各村(里),高雄市,　旗山區,廣福里,14,216,230,460,4,464,0,464,136,600,77.3333
第15任總統副總統,在高雄市各村(里),高雄市,　美濃區,福安里,44,804,977,1825,16,1841,0,1841,703,2544,72.3664
第15任總統副總統,在高雄市各村(里),高雄市,　美濃區,合和里,41,809,775,1625,18,1643,0,1643,672,2315,70.9719
第15任總統副總統,在高雄市各村(里),高雄市,　美濃區,祿興里,37,823,972,1832,13,1845,0,1845,655,2500,73.8000
第15任總統副總統,在高雄市各村(里),高雄市,　美濃區,中壇里,37,736,688,1461,11,1472,0,1472,523,1995,73.7845
第15任總統副總統,在高雄市各村(里),高雄市,　美濃區,德興里,31,570,473,1074,16,1090,0,1090,353,1443,75.5371
第15任總統副總統,在高雄市各村(里),高雄市,　美濃區,龍山里,44,702,775,1521,13,1534,0,1534,566,2100,73.0476
第15任總統副總統,在高雄市各村(里),高雄市,　美濃區,獅山里,44,705,1040,1789,16,1805,0,1805,622,2427,74.3717
第15任總統副總統,在高雄市各村(里),高雄市,　美濃區,龍肚里,21,488,527,1036,7,1043,0,1043,355,1398,74.6066
第15任總統副總統,在高雄市各村(里),高雄市,　美濃區,廣德里,23,364,529,916,10,926,0,926,368,1294,71.5611
第15任總統副總統,在高雄市各村(里),高雄市,　美濃區,興隆里,21,315,495,831,10,841,0,841,309,1150,73.1304
第15任總統副總統,在高雄市各村(里),高雄市,　美濃區,中圳里,39,672,773,1484,9,1493,0,1493,549,2042,73.1146
第15任總統副總統,在高雄市各村(里),高雄市,　美濃區,東門里,18,360,462,840,11,851,0,851,355,1206,70.5638
第15任總統副總統,在高雄市各村(里),高雄市,　美濃區,泰安里,22,555,540,1117,8,1125,0,1125,398,1523,73.8674
第15任總統副總統,在高雄市各村(里),高雄市,　美濃區,瀰濃里,45,694,778,1517,12,1529,0,1529,651,2180,70.1376
第15任總統副總統,在高雄市各村(里),高雄市,　美濃區,清水里,31,536,689,1256,11,1267,0,1267,461,1728,73.3218
第15任總統副總統,在高雄市各村(里),高雄市,　美濃區,吉洋里,24,580,714,1318,17,1335,0,1335,485,1820,73.3516
第15任總統副總統,在高雄市各村(里),高雄市,　美濃區,吉和里,27,469,498,994,7,1001,0,1001,312,1313,76.2376
第15任總統副總統,在高雄市各村(里),高雄市,　美濃區,吉東里,33,536,742,1311,7,1318,0,1318,459,1777,74.1699
第15任總統副總統,在高雄市各村(里),高雄市,　美濃區,廣林里,25,428,560,1013,12,1025,0,1025,432,1457,70.3500
第15任總統副總統,在高雄市各村(里),高雄市,　六龜區,新威里,11,189,299,499,5,504,0,504,212,716,70.3911
第15任總統副總統,在高雄市各村(里),高雄市,　六龜區,新興里,10,160,265,435,5,440,0,440,203,643,68.4292
第15任總統副總統,在高雄市各村(里),高雄市,　六龜區,新寮里,15,160,284,459,1,460,0,460,166,626,73.4824
第15任總統副總統,在高雄市各村(里),高雄市,　六龜區,新發里,19,189,363,571,5,576,0,576,395,971,59.3203
第15任總統副總統,在高雄市各村(里),高雄市,　六龜區,荖濃里,28,268,464,760,6,766,0,766,576,1342,57.0790
第15任總統副總統,在高雄市各村(里),高雄市,　六龜區,六龜里,18,214,325,557,7,564,0,564,365,929,60.7104
第15任總統副總統,在高雄市各村(里),高雄市,　六龜區,義寶里,23,257,427,707,7,714,0,714,303,1017,70.2065
第15任總統副總統,在高雄市各村(里),高雄市,　六龜區,興龍里,6,155,317,478,5,483,0,483,299,782,61.7647
第15任總統副總統,在高雄市各村(里),高雄市,　六龜區,中興里,22,468,405,895,7,902,0,902,470,1372,65.7434
第15任總統副總統,在高雄市各村(里),高雄市,　六龜區,寶來里,11,255,329,595,4,599,0,599,288,887,67.5310
第15任總統副總統,在高雄市各村(里),高雄市,　六龜區,文武里,22,316,499,837,9,846,0,846,542,1388,60.9510
第15任總統副總統,在高雄市各村(里),高雄市,　六龜區,大津里,6,74,140,220,6,226,0,226,84,310,72.9032
第15任總統副總統,在高雄市各村(里),高雄市,　甲仙區,東安里,9,130,140,279,5,284,0,284,171,455,62.4176
第15任總統副總統,在高雄市各村(里),高雄市,　甲仙區,西安里,17,368,241,626,5,631,0,631,222,853,73.9742
第15任總統副總統,在高雄市各村(里),高雄市,　甲仙區,和安里,14,251,186,451,3,454,0,454,191,645,70.3876
第15任總統副總統,在高雄市各村(里),高雄市,　甲仙區,大田里,21,485,526,1032,4,1036,0,1036,491,1527,67.8454
第15任總統副總統,在高雄市各村(里),高雄市,　甲仙區,寶隆里,8,168,274,450,13,463,0,463,186,649,71.3405
第15任總統副總統,在高雄市各村(里),高雄市,　甲仙區,關山里,13,182,211,406,3,409,0,409,179,588,69.5578
第15任總統副總統,在高雄市各村(里),高雄市,　甲仙區,小林里,14,114,177,305,4,309,0,309,206,515,60.0000
第15任總統副總統,在高雄市各村(里),高雄市,　杉林區,杉林里,5,123,256,384,1,385,0,385,241,626,61.5016
第15任總統副總統,在高雄市各村(里),高雄市,　杉林區,木梓里,7,148,250,405,5,410,0,410,256,666,61.5616
第15任總統副總統,在高雄市各村(里),高雄市,　杉林區,集來里,15,259,481,755,11,766,0,766,474,1240,61.7742
第15任總統副總統,在高雄市各村(里),高雄市,　杉林區,新庄里,21,456,493,970,11,981,0,981,495,1476,66.4634
第15任總統副總統,在高雄市各村(里),高雄市,　杉林區,上平里,29,479,540,1048,8,1056,0,1056,517,1573,67.1329
第15任總統副總統,在高雄市各村(里),高雄市,　杉林區,月眉里,27,508,574,1109,8,1117,0,1117,482,1599,69.8562
第15任總統副總統,在高雄市各村(里),高雄市,　杉林區,大愛里,32,513,637,1182,10,1192,0,1192,717,1909,62.4411
第15任總統副總統,在高雄市各村(里),高雄市,　杉林區,月美里,18,334,488,840,8,848,0,848,364,1212,69.9670
第15任總統副總統,在高雄市各村(里),高雄市,　內門區,溝坪里,18,249,349,616,6,622,1,623,320,943,65.9597
第15任總統副總統,在高雄市各村(里),高雄市,　內門區,金竹里,3,145,310,458,3,461,0,461,168,629,73.2909
第15任總統副總統,在高雄市各村(里),高雄市,　內門區,永富里,15,259,382,656,13,669,0,669,272,941,71.0946
第15任總統副總統,在高雄市各村(里),高雄市,　內門區,永吉里,5,116,177,298,4,302,0,302,110,412,73.3010
第15任總統副總統,在高雄市各村(里),高雄市,　內門區,永興里,6,113,144,263,6,269,0,269,125,394,68.2741
第15任總統副總統,在高雄市各村(里),高雄市,　內門區,石坑里,9,116,219,344,3,347,0,347,137,484,71.6942
第15任總統副總統,在高雄市各村(里),高雄市,　內門區,內門里,19,286,399,704,4,708,0,708,230,938,75.4797
第15任總統副總統,在高雄市各村(里),高雄市,　內門區,內豊里,24,360,491,875,5,880,0,880,306,1186,74.1990
第15任總統副總統,在高雄市各村(里),高雄市,　內門區,觀亭里,34,468,709,1211,12,1223,0,1223,428,1651,74.0763
第15任總統副總統,在高雄市各村(里),高雄市,　內門區,中埔里,16,185,193,394,5,399,0,399,136,535,74.5794
第15任總統副總統,在高雄市各村(里),高雄市,　內門區,內東里,17,208,367,592,4,596,0,596,166,762,78.2152
第15任總統副總統,在高雄市各村(里),高雄市,　內門區,內南里,14,126,139,279,2,281,0,281,125,406,69.2118
第15任總統副總統,在高雄市各村(里),高雄市,　內門區,東埔里,18,108,222,348,3,351,0,351,130,481,72.9730
第15任總統副總統,在高雄市各村(里),高雄市,　內門區,三平里,12,148,274,434,10,444,0,444,195,639,69.4836
第15任總統副總統,在高雄市各村(里),高雄市,　內門區,木柵里,7,132,272,411,4,415,0,415,164,579,71.6753
第15任總統副總統,在高雄市各村(里),高雄市,　內門區,內興里,8,82,322,412,0,412,0,412,173,585,70.4274
第15任總統副總統,在高雄市各村(里),高雄市,　內門區,瑞山里,10,111,116,237,0,237,0,237,89,326,72.6994
第15任總統副總統,在高雄市各村(里),高雄市,　內門區,光興里,10,188,293,491,6,497,0,497,151,648,76.6975
第15任總統副總統,在高雄市各村(里),高雄市,　茂林區,多納里,8,279,63,350,4,354,0,354,122,476,74.3697
第15任總統副總統,在高雄市各村(里),高雄市,　茂林區,萬山里,5,199,79,283,2,285,0,285,79,364,78.2967
第15任總統副總統,在高雄市各村(里),高雄市,　茂林區,茂林里,7,399,125,531,3,534,0,534,148,682,78.2991
第15任總統副總統,在高雄市各村(里),高雄市,　桃源區,梅山里,3,127,52,182,2,184,0,184,64,248,74.1935
第15任總統副總統,在高雄市各村(里),高雄市,　桃源區,拉芙蘭里,8,104,67,179,2,181,0,181,56,237,76.3713
第15任總統副總統,在高雄市各村(里),高雄市,　桃源區,復興里,3,146,49,198,1,199,0,199,70,269,73.9777
第15任總統副總統,在高雄市各村(里),高雄市,　桃源區,勤和里,3,115,33,151,4,155,0,155,54,209,74.1627
第15任總統副總統,在高雄市各村(里),高雄市,　桃源區,桃源里,16,357,101,474,4,478,0,478,257,735,65.0340
第15任總統副總統,在高雄市各村(里),高雄市,　桃源區,高中里,11,288,114,413,5,418,0,418,194,612,68.3007
第15任總統副總統,在高雄市各村(里),高雄市,　桃源區,建山里,14,304,70,388,3,391,0,391,188,579,67.5302
第15任總統副總統,在高雄市各村(里),高雄市,　桃源區,寶山里,6,233,59,298,3,301,0,301,154,455,66.1538
第15任總統副總統,在高雄市各村(里),高雄市,　那瑪夏區,達卡努瓦里,12,606,190,808,7,815,0,815,459,1274,63.9717
第15任總統副總統,在高雄市各村(里),高雄市,　那瑪夏區,瑪雅里,6,354,73,433,3,436,1,437,146,583,74.7856
第15任總統副總統,在高雄市各村(里),高雄市,　那瑪夏區,南沙魯里,9,185,167,361,2,363,0,363,118,481,75.4678
第15任總統副總統,在基隆市各村(里),基隆市,　中正區,長潭里,14,99,234,347,6,353,0,353,95,448,78.7946
第15任總統副總統,在基隆市各村(里),基隆市,　中正區,砂子里,195,1564,1755,3514,40,3554,0,3554,1723,5277,67.3489
第15任總統副總統,在基隆市各村(里),基隆市,　中正區,八斗里,36,257,728,1021,12,1033,0,1033,380,1413,73.1069
第15任總統副總統,在基隆市各村(里),基隆市,　中正區,碧砂里,38,273,513,824,8,832,0,832,387,1219,68.2527
第15任總統副總統,在基隆市各村(里),基隆市,　中正區,新富里,187,1537,1625,3349,30,3379,0,3379,1540,4919,68.6928
第15任總統副總統,在基隆市各村(里),基隆市,　中正區,新豐里,214,1792,1790,3796,43,3839,0,3839,1524,5363,71.5831
第15任總統副總統,在基隆市各村(里),基隆市,　中正區,平寮里,40,314,480,834,18,852,0,852,364,1216,70.0658
第15任總統副總統,在基隆市各村(里),基隆市,　中正區,社寮里,60,447,675,1182,11,1193,0,1193,488,1681,70.9697
第15任總統副總統,在基隆市各村(里),基隆市,　中正區,和憲里,22,332,261,615,4,619,0,619,329,948,65.2954
第15任總統副總統,在基隆市各村(里),基隆市,　中正區,海濱里,46,417,308,771,6,777,0,777,349,1126,69.0053
第15任總統副總統,在基隆市各村(里),基隆市,　中正區,正濱里,31,302,330,663,9,672,0,672,263,935,71.8717
第15任總統副總統,在基隆市各村(里),基隆市,　中正區,中正里,51,493,617,1161,12,1173,0,1173,456,1629,72.0074
第15任總統副總統,在基隆市各村(里),基隆市,　中正區,中濱里,39,433,443,915,11,926,0,926,327,1253,73.9026
第15任總統副總統,在基隆市各村(里),基隆市,　中正區,建國里,82,742,529,1353,12,1365,0,1365,532,1897,71.9557
第15任總統副總統,在基隆市各村(里),基隆市,　中正區,砂灣里,73,698,573,1344,20,1364,0,1364,575,1939,70.3455
第15任總統副總統,在基隆市各村(里),基隆市,　中正區,真砂里,52,443,476,971,13,984,0,984,308,1292,76.1610
第15任總統副總統,在基隆市各村(里),基隆市,　中正區,正砂里,86,827,735,1648,25,1673,1,1674,591,2265,73.8631
第15任總統副總統,在基隆市各村(里),基隆市,　中正區,中砂里,45,412,460,917,10,927,0,927,636,1563,59.3090
第15任總統副總統,在基隆市各村(里),基隆市,　中正區,入船里,26,231,287,544,14,558,0,558,201,759,73.5178
第15任總統副總統,在基隆市各村(里),基隆市,　中正區,正船里,44,439,428,911,10,921,0,921,308,1229,74.9390
第15任總統副總統,在基隆市各村(里),基隆市,　中正區,中船里,53,346,411,810,15,825,0,825,312,1137,72.5594
第15任總統副總統,在基隆市各村(里),基隆市,　中正區,港通里,43,345,472,860,14,874,0,874,274,1148,76.1324
第15任總統副總統,在基隆市各村(里),基隆市,　中正區,義重里,45,331,363,739,11,750,0,750,260,1010,74.2574
第15任總統副總統,在基隆市各村(里),基隆市,　中正區,正義里,33,363,445,841,14,855,0,855,327,1182,72.3350
第15任總統副總統,在基隆市各村(里),基隆市,　中正區,信義里,38,253,332,623,12,635,0,635,235,870,72.9885
第15任總統副總統,在基隆市各村(里),基隆市,　中正區,德義里,25,197,270,492,3,495,0,495,180,675,73.3333
第15任總統副總統,在基隆市各村(里),基隆市,　七堵區,長興里,150,1163,1324,2637,31,2668,0,2668,957,3625,73.6000
第15任總統副總統,在基隆市各村(里),基隆市,　七堵區,正光里,86,748,892,1726,17,1743,0,1743,698,2441,71.4052
第15任總統副總統,在基隆市各村(里),基隆市,　七堵區,正明里,80,581,742,1403,13,1416,0,1416,439,1855,76.3342
第15任總統副總統,在基隆市各村(里),基隆市,　七堵區,富民里,151,1207,1199,2557,40,2597,0,2597,825,3422,75.8913
第15任總統副總統,在基隆市各村(里),基隆市,　七堵區,永平里,69,633,710,1412,9,1421,0,1421,422,1843,77.1026
第15任總統副總統,在基隆市各村(里),基隆市,　七堵區,永安里,108,713,791,1612,9,1621,0,1621,518,2139,75.7831
第15任總統副總統,在基隆市各村(里),基隆市,　七堵區,八德里,65,412,564,1041,8,1049,0,1049,421,1470,71.3605
第15任總統副總統,在基隆市各村(里),基隆市,　七堵區,自強里,50,343,400,793,13,806,0,806,303,1109,72.6781
第15任總統副總統,在基隆市各村(里),基隆市,　七堵區,泰安里,193,1225,1587,3005,35,3040,0,3040,1139,4179,72.7447
第15任總統副總統,在基隆市各村(里),基隆市,　七堵區,六堵里,94,691,888,1673,22,1695,0,1695,543,2238,75.7373
第15任總統副總統,在基隆市各村(里),基隆市,　七堵區,堵南里,61,520,790,1371,12,1383,0,1383,600,1983,69.7428
第15任總統副總統,在基隆市各村(里),基隆市,　七堵區,長安里,78,702,913,1693,15,1708,0,1708,721,2429,70.3170
第15任總統副總統,在基隆市各村(里),基隆市,　七堵區,堵北里,135,891,1518,2544,25,2569,0,2569,877,3446,74.5502
第15任總統副總統,在基隆市各村(里),基隆市,　七堵區,百福里,237,1602,2440,4279,31,4310,0,4310,1530,5840,73.8014
第15任總統副總統,在基隆市各村(里),基隆市,　七堵區,實踐里,144,1034,1484,2662,28,2690,0,2690,1018,3708,72.5458
第15任總統副總統,在基隆市各村(里),基隆市,　七堵區,瑪南里,24,106,173,303,3,306,0,306,97,403,75.9305
第15任總統副總統,在基隆市各村(里),基隆市,　七堵區,瑪東里,8,100,126,234,5,239,0,239,90,329,72.6444
第15任總統副總統,在基隆市各村(里),基隆市,　七堵區,瑪西里,10,102,141,253,3,256,0,256,84,340,75.2941
第15任總統副總統,在基隆市各村(里),基隆市,　七堵區,友一里,67,711,640,1418,13,1431,0,1431,445,1876,76.2793
第15任總統副總統,在基隆市各村(里),基隆市,　七堵區,友二里,5,134,194,333,5,338,0,338,104,442,76.4706
第15任總統副總統,在基隆市各村(里),基隆市,　暖暖區,八西里,51,408,526,985,7,992,0,992,388,1380,71.8841
第15任總統副總統,在基隆市各村(里),基隆市,　暖暖區,八中里,18,119,173,310,1,311,0,311,131,442,70.3620
第15任總統副總統,在基隆市各村(里),基隆市,　暖暖區,八堵里,19,188,271,478,4,482,0,482,158,640,75.3125
第15任總統副總統,在基隆市各村(里),基隆市,　暖暖區,八南里,19,199,295,513,8,521,0,521,212,733,71.0778
第15任總統副總統,在基隆市各村(里),基隆市,　暖暖區,過港里,149,1194,1234,2577,35,2612,0,2612,956,3568,73.2063
第15任總統副總統,在基隆市各村(里),基隆市,　暖暖區,暖暖里,100,811,964,1875,35,1910,0,1910,635,2545,75.0491
第15任總統副總統,在基隆市各村(里),基隆市,　暖暖區,暖同里,87,797,816,1700,24,1724,0,1724,773,2497,69.0429
第15任總統副總統,在基隆市各村(里),基隆市,　暖暖區,暖東里,13,115,155,283,4,287,3,290,116,406,70.6897
第15任總統副總統,在基隆市各村(里),基隆市,　暖暖區,暖西里,172,1421,1731,3324,46,3370,0,3370,1124,4494,74.9889
第15任總統副總統,在基隆市各村(里),基隆市,　暖暖區,碇內里,102,916,891,1909,16,1925,0,1925,647,2572,74.8445
第15任總統副總統,在基隆市各村(里),基隆市,　暖暖區,碇和里,97,1154,865,2116,18,2134,0,2134,687,2821,75.6469
第15任總統副總統,在基隆市各村(里),基隆市,　暖暖區,碇祥里,256,1827,1868,3951,38,3989,0,3989,1645,5634,70.8023
第15任總統副總統,在基隆市各村(里),基隆市,　暖暖區,碇安里,223,1511,1748,3482,40,3522,0,3522,1187,4709,74.7929
第15任總統副總統,在基隆市各村(里),基隆市,　仁愛區,林泉里,77,477,642,1196,15,1211,0,1211,507,1718,70.4889
第15任總統副總統,在基隆市各村(里),基隆市,　仁愛區,花崗里,33,315,425,773,9,782,0,782,239,1021,76.5916
第15任總統副總統,在基隆市各村(里),基隆市,　仁愛區,虹橋里,58,496,537,1091,12,1103,0,1103,402,1505,73.2890
第15任總統副總統,在基隆市各村(里),基隆市,　仁愛區,水錦里,63,561,569,1193,11,1204,0,1204,477,1681,71.6240
第15任總統副總統,在基隆市各村(里),基隆市,　仁愛區,智仁里,71,727,860,1658,15,1673,0,1673,604,2277,73.4739
第15任總統副總統,在基隆市各村(里),基隆市,　仁愛區,和明里,82,523,601,1206,16,1222,1,1223,404,1627,75.1076
第15任總統副總統,在基隆市各村(里),基隆市,　仁愛區,忠勇里,28,269,370,667,6,673,0,673,233,906,74.2826
第15任總統副總統,在基隆市各村(里),基隆市,　仁愛區,玉田里,26,284,401,711,4,715,0,715,239,954,74.9476
第15任總統副總統,在基隆市各村(里),基隆市,　仁愛區,仁德里,33,249,367,649,6,655,0,655,207,862,75.9861
第15任總統副總統,在基隆市各村(里),基隆市,　仁愛區,博愛里,56,449,594,1099,15,1114,0,1114,325,1439,77.4149
第15任總統副總統,在基隆市各村(里),基隆市,　仁愛區,福仁里,26,197,334,557,7,564,0,564,179,743,75.9085
第15任總統副總統,在基隆市各村(里),基隆市,　仁愛區,誠仁里,39,249,397,685,6,691,0,691,229,920,75.1087
第15任總統副總統,在基隆市各村(里),基隆市,　仁愛區,吉仁里,95,695,989,1779,21,1800,0,1800,770,2570,70.0389
第15任總統副總統,在基隆市各村(里),基隆市,　仁愛區,育仁里,21,166,331,518,2,520,0,520,218,738,70.4607
第15任總統副總統,在基隆市各村(里),基隆市,　仁愛區,英仁里,50,351,502,903,4,907,0,907,357,1264,71.7563
第15任總統副總統,在基隆市各村(里),基隆市,　仁愛區,龍門里,32,184,347,563,4,567,0,567,192,759,74.7036
第15任總統副總統,在基隆市各村(里),基隆市,　仁愛區,德厚里,78,528,629,1235,20,1255,0,1255,424,1679,74.7469
第15任總統副總統,在基隆市各村(里),基隆市,　仁愛區,曲水里,26,211,336,573,6,579,0,579,227,806,71.8362
第15任總統副總統,在基隆市各村(里),基隆市,　仁愛區,崇文里,40,253,339,632,7,639,0,639,193,832,76.8029
第15任總統副總統,在基隆市各村(里),基隆市,　仁愛區,文安里,13,241,334,588,7,595,0,595,233,828,71.8599
第15任總統副總統,在基隆市各村(里),基隆市,　仁愛區,兆連里,27,245,241,513,5,518,0,518,162,680,76.1765
第15任總統副總統,在基隆市各村(里),基隆市,　仁愛區,獅球里,42,295,355,692,7,699,0,699,268,967,72.2854
第15任總統副總統,在基隆市各村(里),基隆市,　仁愛區,書院里,38,292,396,726,14,740,0,740,298,1038,71.2909
第15任總統副總統,在基隆市各村(里),基隆市,　仁愛區,朝棟里,94,1028,834,1956,21,1977,0,1977,683,2660,74.3233
第15任總統副總統,在基隆市各村(里),基隆市,　仁愛區,光華里,73,717,873,1663,15,1678,0,1678,741,2419,69.3675
第15任總統副總統,在基隆市各村(里),基隆市,　仁愛區,明德里,25,210,267,502,6,508,0,508,182,690,73.6232
第15任總統副總統,在基隆市各村(里),基隆市,　仁愛區,同風里,19,163,245,427,3,430,0,430,127,557,77.1993
第15任總統副總統,在基隆市各村(里),基隆市,　仁愛區,文昌里,27,181,350,558,6,564,0,564,180,744,75.8065
第15任總統副總統,在基隆市各村(里),基隆市,　仁愛區,新店里,13,186,236,435,3,438,0,438,148,586,74.7440
第15任總統副總統,在基隆市各村(里),基隆市,　中山區,新建里,27,225,315,567,6,573,0,573,216,789,72.6236
第15任總統副總統,在基隆市各村(里),基隆市,　中山區,安民里,39,329,421,789,11,800,0,800,213,1013,78.9733
第15任總統副總統,在基隆市各村(里),基隆市,　中山區,安平里,38,222,289,549,10,559,0,559,182,741,75.4386
第15任總統副總統,在基隆市各村(里),基隆市,　中山區,中山里,34,241,405,680,18,698,0,698,242,940,74.2553
第15任總統副總統,在基隆市各村(里),基隆市,　中山區,民治里,28,271,286,585,9,594,0,594,177,771,77.0428
第15任總統副總統,在基隆市各村(里),基隆市,　中山區,中興里,37,446,434,917,15,932,0,932,298,1230,75.7724
第15任總統副總統,在基隆市各村(里),基隆市,　中山區,仁正里,34,244,269,547,9,556,0,556,202,758,73.3509
第15任總統副總統,在基隆市各村(里),基隆市,　中山區,健民里,39,339,434,812,8,820,0,820,316,1136,72.1831
第15任總統副總統,在基隆市各村(里),基隆市,　中山區,通化里,44,340,309,693,10,703,0,703,262,965,72.8497
第15任總統副總統,在基隆市各村(里),基隆市,　中山區,居仁里,62,406,405,873,17,890,0,890,397,1287,69.1531
第15任總統副總統,在基隆市各村(里),基隆市,　中山區,通明里,63,508,667,1238,13,1251,0,1251,455,1706,73.3294
第15任總統副總統,在基隆市各村(里),基隆市,　中山區,和平里,10,173,139,322,6,328,0,328,113,441,74.3764
第15任總統副總統,在基隆市各村(里),基隆市,　中山區,仙洞里,15,172,210,397,3,400,0,400,156,556,71.9424
第15任總統副總統,在基隆市各村(里),基隆市,　中山區,太白里,40,246,300,586,10,596,0,596,256,852,69.9531
第15任總統副總統,在基隆市各村(里),基隆市,　中山區,協和里,68,414,560,1042,10,1052,0,1052,470,1522,69.1196
第15任總統副總統,在基隆市各村(里),基隆市,　中山區,文化里,38,293,374,705,6,711,0,711,543,1254,56.6986
第15任總統副總統,在基隆市各村(里),基隆市,　中山區,德安里,120,1095,1460,2675,28,2703,0,2703,1012,3715,72.7591
第15任總統副總統,在基隆市各村(里),基隆市,　中山區,德和里,216,1841,1952,4009,39,4048,0,4048,1156,5204,77.7863
第15任總統副總統,在基隆市各村(里),基隆市,　中山區,中和里,197,1782,1885,3864,46,3910,0,3910,1465,5375,72.7442
第15任總統副總統,在基隆市各村(里),基隆市,　中山區,和慶里,271,1784,2339,4394,60,4454,0,4454,1816,6270,71.0367
第15任總統副總統,在基隆市各村(里),基隆市,　中山區,西康里,67,433,596,1096,6,1102,0,1102,476,1578,69.8352
第15任總統副總統,在基隆市各村(里),基隆市,　中山區,西定里,33,246,353,632,4,636,0,636,265,901,70.5882
第15任總統副總統,在基隆市各村(里),基隆市,　中山區,西華里,32,239,345,616,5,621,0,621,204,825,75.2727
第15任總統副總統,在基隆市各村(里),基隆市,　中山區,西榮里,27,179,285,491,3,494,0,494,187,681,72.5404
第15任總統副總統,在基隆市各村(里),基隆市,　安樂區,新西里,55,399,470,924,14,938,0,938,392,1330,70.5263
第15任總統副總統,在基隆市各村(里),基隆市,　安樂區,西川里,38,379,389,806,7,813,0,813,358,1171,69.4278
第15任總統副總統,在基隆市各村(里),基隆市,　安樂區,定國里,39,297,379,715,6,721,0,721,278,999,72.1722
第15任總統副總統,在基隆市各村(里),基隆市,　安樂區,定邦里,35,330,378,743,14,757,0,757,220,977,77.4821
第15任總統副總統,在基隆市各村(里),基隆市,　安樂區,慈仁里,29,220,400,649,8,657,0,657,228,885,74.2373
第15任總統副總統,在基隆市各村(里),基隆市,　安樂區,干城里,66,577,721,1364,10,1374,0,1374,611,1985,69.2191
第15任總統副總統,在基隆市各村(里),基隆市,　安樂區,永康里,60,508,763,1331,18,1349,0,1349,545,1894,71.2249
第15任總統副總統,在基隆市各村(里),基隆市,　安樂區,安和里,26,219,392,637,7,644,0,644,184,828,77.7778
第15任總統副總統,在基隆市各村(里),基隆市,　安樂區,樂一里,25,146,236,407,4,411,0,411,145,556,73.9209
第15任總統副總統,在基隆市各村(里),基隆市,　安樂區,嘉仁里,116,830,1333,2279,28,2307,0,2307,835,3142,73.4246
第15任總統副總統,在基隆市各村(里),基隆市,　安樂區,三民里,100,851,842,1793,18,1811,0,1811,654,2465,73.4686
第15任總統副總統,在基隆市各村(里),基隆市,　安樂區,壯觀里,147,1472,1417,3036,30,3066,0,3066,922,3988,76.8806
第15任總統副總統,在基隆市各村(里),基隆市,　安樂區,四維里,199,1565,1781,3545,36,3581,0,3581,1024,4605,77.7633
第15任總統副總統,在基隆市各村(里),基隆市,　安樂區,五福里,134,1112,1270,2516,23,2539,0,2539,824,3363,75.4981
第15任總統副總統,在基隆市各村(里),基隆市,　安樂區,六合里,155,1383,1447,2985,24,3009,0,3009,854,3863,77.8928
第15任總統副總統,在基隆市各村(里),基隆市,　安樂區,七賢里,88,786,939,1813,16,1829,0,1829,605,2434,75.1438
第15任總統副總統,在基隆市各村(里),基隆市,　安樂區,長樂里,142,1205,1169,2516,34,2550,0,2550,647,3197,79.7623
第15任總統副總統,在基隆市各村(里),基隆市,　安樂區,鶯歌里,74,858,953,1885,14,1899,0,1899,998,2897,65.5506
第15任總統副總統,在基隆市各村(里),基隆市,　安樂區,鶯安里,188,1671,1609,3468,43,3511,0,3511,1080,4591,76.4757
第15任總統副總統,在基隆市各村(里),基隆市,　安樂區,興寮里,159,1452,1661,3272,30,3302,0,3302,1250,4552,72.5395
第15任總統副總統,在基隆市各村(里),基隆市,　安樂區,外寮里,124,1167,1416,2707,20,2727,0,2727,1044,3771,72.3150
第15任總統副總統,在基隆市各村(里),基隆市,　安樂區,新崙里,136,1189,1455,2780,29,2809,0,2809,1060,3869,72.6027
第15任總統副總統,在基隆市各村(里),基隆市,　安樂區,武崙里,189,1498,1756,3443,26,3469,0,3469,1106,4575,75.8251
第15任總統副總統,在基隆市各村(里),基隆市,　安樂區,中崙里,53,492,651,1196,13,1209,0,1209,415,1624,74.4458
第15任總統副總統,在基隆市各村(里),基隆市,　安樂區,內寮里,183,1594,1908,3685,37,3722,0,3722,1435,5157,72.1737
第15任總統副總統,在基隆市各村(里),基隆市,　信義區,仁壽里,39,339,409,787,12,799,0,799,237,1036,77.1236
第15任總統副總統,在基隆市各村(里),基隆市,　信義區,仁義里,45,484,419,948,10,958,0,958,233,1191,80.4366
第15任總統副總統,在基隆市各村(里),基隆市,　信義區,義昭里,27,421,418,866,16,882,0,882,275,1157,76.2316
第15任總統副總統,在基隆市各村(里),基隆市,　信義區,義幸里,70,877,780,1727,19,1746,0,1746,514,2260,77.2566
第15任總統副總統,在基隆市各村(里),基隆市,　信義區,義民里,20,240,284,544,3,547,0,547,157,704,77.6989
第15任總統副總統,在基隆市各村(里),基隆市,　信義區,義和里,51,461,382,894,3,897,0,897,568,1465,61.2287
第15任總統副總統,在基隆市各村(里),基隆市,　信義區,智慧里,45,235,252,532,13,545,0,545,161,706,77.1955
第15任總統副總統,在基隆市各村(里),基隆市,　信義區,智誠里,52,416,589,1057,16,1073,0,1073,419,1492,71.9169
第15任總統副總統,在基隆市各村(里),基隆市,　信義區,禮儀里,61,572,559,1192,11,1203,0,1203,373,1576,76.3325
第15任總統副總統,在基隆市各村(里),基隆市,　信義區,禮東里,59,553,494,1106,19,1125,0,1125,340,1465,76.7918
第15任總統副總統,在基隆市各村(里),基隆市,　信義區,信綠里,75,705,734,1514,9,1523,0,1523,504,2027,75.1357
第15任總統副總統,在基隆市各村(里),基隆市,　信義區,東信里,155,1548,1391,3094,30,3124,0,3124,934,4058,76.9837
第15任總統副總統,在基隆市各村(里),基隆市,　信義區,東光里,59,620,621,1300,11,1311,0,1311,425,1736,75.5184
第15任總統副總統,在基隆市各村(里),基隆市,　信義區,東明里,132,1299,1130,2561,20,2581,0,2581,846,3427,75.3137
第15任總統副總統,在基隆市各村(里),基隆市,　信義區,東安里,87,980,937,2004,21,2025,0,2025,687,2712,74.6681
第15任總統副總統,在基隆市各村(里),基隆市,　信義區,孝賢里,139,1263,1161,2563,28,2591,0,2591,752,3343,77.5052
第15任總統副總統,在基隆市各村(里),基隆市,　信義區,孝忠里,308,2364,2580,5252,42,5294,1,5295,1758,7053,75.0603
第15任總統副總統,在基隆市各村(里),基隆市,　信義區,孝德里,74,764,860,1698,16,1714,0,1714,711,2425,70.6804
第15任總統副總統,在基隆市各村(里),基隆市,　信義區,孝深里,148,1230,1412,2790,20,2810,0,2810,1228,4038,69.5889
第15任總統副總統,在基隆市各村(里),基隆市,　信義區,孝岡里,49,414,493,956,9,965,0,965,316,1281,75.3318
