Header1,Header2,By,Region,Village,(1) 鄭正鈐 中國國民黨,(2) 鄭宏輝 民主進步黨,(3) 廖蓓瑩 國會政黨聯盟,(4) 王榮德 無,(5) 高鈺婷 時代力量,(6) 曾楷耀 台灣維新,有效票數A A=1+2+...+N,無效票數B,投票數C C=A+B,已領未投票數 D D=E-C,發出票數E E=C+D,用餘票數F,選舉人數G G=E+F,投票率H H=C÷G
第10屆區域立法委員選舉新竹市,在各村(里),新竹市選舉區,　東區,育賢里,241,207,21,4,193,1,667,9,676,0,676,831,1507,44.86
第10屆區域立法委員選舉新竹市,在各村(里),新竹市選舉區,　東區,親仁里,302,176,14,2,196,0,690,6,696,0,696,197,893,77.94
第10屆區域立法委員選舉新竹市,在各村(里),新竹市選舉區,　東區,榮光里、親仁里,313,208,11,1,171,1,705,13,718,0,718,279,997,72.02
第10屆區域立法委員選舉新竹市,在各村(里),新竹市選舉區,　東區,東門里,121,181,8,2,99,1,412,2,414,0,414,117,531,77.97
第10屆區域立法委員選舉新竹市,在各村(里),新竹市選舉區,　東區,成功里,154,191,7,2,86,1,441,10,451,0,451,160,611,73.81
第10屆區域立法委員選舉新竹市,在各村(里),新竹市選舉區,　東區,中正里,128,168,10,1,112,0,419,3,422,0,422,114,536,78.73
第10屆區域立法委員選舉新竹市,在各村(里),新竹市選舉區,　東區,錦華里,529,370,26,7,387,0,1319,17,1336,1,1337,402,1739,76.83
第10屆區域立法委員選舉新竹市,在各村(里),新竹市選舉區,　東區,文華里,1372,968,44,10,933,10,3337,33,3370,0,3370,929,4299,78.39
第10屆區域立法委員選舉新竹市,在各村(里),新竹市選舉區,　東區,復中里,1212,968,47,7,833,5,3072,37,3109,0,3109,880,3989,77.94
第10屆區域立法委員選舉新竹市,在各村(里),新竹市選舉區,　東區,復興里,1254,1126,47,11,1085,7,3530,45,3575,1,3576,1074,4650,76.88
第10屆區域立法委員選舉新竹市,在各村(里),新竹市選舉區,　東區,三民里,1251,1171,59,9,922,9,3421,35,3456,0,3456,1009,4465,77.40
第10屆區域立法委員選舉新竹市,在各村(里),新竹市選舉區,　東區,東園里,1405,1197,81,7,1604,6,4300,53,4353,0,4353,1089,5442,79.99
第10屆區域立法委員選舉新竹市,在各村(里),新竹市選舉區,　東區,公園里,936,636,45,9,634,3,2263,36,2299,0,2299,701,3000,76.63
第10屆區域立法委員選舉新竹市,在各村(里),新竹市選舉區,　東區,建華里,637,559,50,7,470,5,1728,32,1760,0,1760,540,2300,76.52
第10屆區域立法委員選舉新竹市,在各村(里),新竹市選舉區,　東區,東山里,1040,583,62,5,666,4,2360,39,2399,0,2399,622,3021,79.41
第10屆區域立法委員選舉新竹市,在各村(里),新竹市選舉區,　東區,綠水里,1756,1120,118,16,1449,9,4468,62,4530,0,4530,1281,5811,77.96
第10屆區域立法委員選舉新竹市,在各村(里),新竹市選舉區,　東區,東勢里,629,504,39,7,562,1,1742,19,1761,0,1761,455,2216,79.47
第10屆區域立法委員選舉新竹市,在各村(里),新竹市選舉區,　東區,光復里,688,642,19,6,612,5,1972,34,2006,0,2006,531,2537,79.07
第10屆區域立法委員選舉新竹市,在各村(里),新竹市選舉區,　東區,前溪里,619,848,34,14,500,5,2020,26,2046,0,2046,596,2642,77.44
第10屆區域立法委員選舉新竹市,在各村(里),新竹市選舉區,　東區,水源里,800,956,49,7,618,6,2436,38,2474,0,2474,711,3185,77.68
第10屆區域立法委員選舉新竹市,在各村(里),新竹市選舉區,　東區,千甲里,630,480,21,6,362,4,1503,38,1541,0,1541,422,1963,78.50
第10屆區域立法委員選舉新竹市,在各村(里),新竹市選舉區,　東區,豐功里,1434,770,72,11,955,8,3250,43,3293,0,3293,827,4120,79.93
第10屆區域立法委員選舉新竹市,在各村(里),新竹市選舉區,　東區,武功里,1839,347,56,13,768,4,3027,33,3060,2,3062,763,3825,80.00
第10屆區域立法委員選舉新竹市,在各村(里),新竹市選舉區,　東區,軍功里,1047,398,43,2,508,4,2002,28,2030,0,2030,585,2615,77.63
第10屆區域立法委員選舉新竹市,在各村(里),新竹市選舉區,　東區,立功里,389,105,7,1,110,0,612,14,626,0,626,221,847,73.91
第10屆區域立法委員選舉新竹市,在各村(里),新竹市選舉區,　東區,建功里,1637,376,60,10,647,5,2735,42,2777,1,2778,708,3486,79.66
第10屆區域立法委員選舉新竹市,在各村(里),新竹市選舉區,　東區,光明里,1017,428,46,10,675,9,2185,40,2225,0,2225,638,2863,77.72
第10屆區域立法委員選舉新竹市,在各村(里),新竹市選舉區,　東區,龍山里,1934,1442,187,12,2966,17,6558,77,6635,1,6636,1524,8160,81.31
第10屆區域立法委員選舉新竹市,在各村(里),新竹市選舉區,　東區,科園里,2052,1152,92,17,1553,13,4879,60,4939,0,4939,1092,6031,81.89
第10屆區域立法委員選舉新竹市,在各村(里),新竹市選舉區,　東區,埔頂里,1104,1072,89,7,1527,5,3804,67,3871,0,3871,952,4823,80.26
第10屆區域立法委員選舉新竹市,在各村(里),新竹市選舉區,　東區,新莊里,1516,962,126,14,1286,11,3915,46,3961,1,3962,1104,5066,78.19
第10屆區域立法委員選舉新竹市,在各村(里),新竹市選舉區,　東區,關新里,779,647,77,8,1434,6,2951,41,2992,0,2992,646,3638,82.24
第10屆區域立法委員選舉新竹市,在各村(里),新竹市選舉區,　東區,關東里,1455,871,86,8,1043,11,3474,40,3514,0,3514,992,4506,77.98
第10屆區域立法委員選舉新竹市,在各村(里),新竹市選舉區,　東區,金山里,1575,862,85,14,1011,12,3559,57,3616,0,3616,1192,4808,75.21
第10屆區域立法委員選舉新竹市,在各村(里),新竹市選舉區,　東區,仙水里,1192,770,88,13,1121,13,3197,51,3248,0,3248,846,4094,79.34
第10屆區域立法委員選舉新竹市,在各村(里),新竹市選舉區,　東區,仙宮里,314,264,38,5,324,1,946,15,961,0,961,231,1192,80.62
第10屆區域立法委員選舉新竹市,在各村(里),新竹市選舉區,　東區,關帝里,101,173,8,2,82,1,367,5,372,0,372,108,480,77.50
第10屆區域立法委員選舉新竹市,在各村(里),新竹市選舉區,　東區,南門里,166,217,7,6,117,1,514,12,526,0,526,159,685,76.79
第10屆區域立法委員選舉新竹市,在各村(里),新竹市選舉區,　東區,南市里,182,292,10,3,138,4,629,12,641,0,641,214,855,74.97
第10屆區域立法委員選舉新竹市,在各村(里),新竹市選舉區,　東區,福德里,416,347,18,4,264,1,1050,14,1064,0,1064,315,1379,77.16
第10屆區域立法委員選舉新竹市,在各村(里),新竹市選舉區,　東區,振興里,1418,1240,75,18,1115,10,3876,43,3919,0,3919,1352,5271,74.35
第10屆區域立法委員選舉新竹市,在各村(里),新竹市選舉區,　東區,新興里,798,775,46,8,585,3,2215,28,2243,0,2243,630,2873,78.07
第10屆區域立法委員選舉新竹市,在各村(里),新竹市選舉區,　東區,下竹里、寺前里,308,319,12,3,188,3,833,13,846,0,846,296,1142,74.08
第10屆區域立法委員選舉新竹市,在各村(里),新竹市選舉區,　東區,竹蓮里,154,227,16,2,128,1,528,11,539,0,539,173,712,75.70
第10屆區域立法委員選舉新竹市,在各村(里),新竹市選舉區,　東區,頂竹里,701,755,51,7,581,4,2099,27,2126,0,2126,629,2755,77.17
第10屆區域立法委員選舉新竹市,在各村(里),新竹市選舉區,　東區,南大里,351,397,32,5,272,4,1061,19,1080,0,1080,306,1386,77.92
第10屆區域立法委員選舉新竹市,在各村(里),新竹市選舉區,　東區,新光里,856,830,55,12,661,9,2423,34,2457,0,2457,828,3285,74.79
第10屆區域立法委員選舉新竹市,在各村(里),新竹市選舉區,　東區,光鎮里,927,831,58,9,662,8,2495,34,2529,0,2529,764,3293,76.80
第10屆區域立法委員選舉新竹市,在各村(里),新竹市選舉區,　東區,高峰里,1571,1264,90,10,1114,11,4060,54,4114,0,4114,1339,5453,75.44
第10屆區域立法委員選舉新竹市,在各村(里),新竹市選舉區,　東區,湖濱里,982,873,48,9,744,10,2666,28,2694,0,2694,692,3386,79.56
第10屆區域立法委員選舉新竹市,在各村(里),新竹市選舉區,　東區,柴橋里,1430,1094,65,9,1111,8,3717,63,3780,0,3780,1089,4869,77.63
第10屆區域立法委員選舉新竹市,在各村(里),新竹市選舉區,　東區,明湖里,1362,886,82,9,970,8,3317,65,3382,0,3382,1289,4671,72.40
第10屆區域立法委員選舉新竹市,在各村(里),新竹市選舉區,　北區,西門里、中央里,221,328,10,3,173,0,735,12,747,0,747,244,991,75.38
第10屆區域立法委員選舉新竹市,在各村(里),新竹市選舉區,　北區,潛園里,190,238,7,0,116,3,554,4,558,0,558,165,723,77.18
第10屆區域立法委員選舉新竹市,在各村(里),新竹市選舉區,　北區,石坊里、興南里,175,212,9,2,120,3,521,8,529,0,529,157,686,77.11
第10屆區域立法委員選舉新竹市,在各村(里),新竹市選舉區,　北區,仁德里,166,221,6,7,130,1,531,9,540,0,540,142,682,79.18
第10屆區域立法委員選舉新竹市,在各村(里),新竹市選舉區,　北區,崇禮里,234,343,14,4,214,0,809,15,824,0,824,277,1101,74.84
第10屆區域立法委員選舉新竹市,在各村(里),新竹市選舉區,　北區,興南里,260,333,9,3,245,2,852,10,862,0,862,276,1138,75.75
第10屆區域立法委員選舉新竹市,在各村(里),新竹市選舉區,　北區,育英里,823,931,62,12,764,6,2598,39,2637,0,2637,778,3415,77.22
第10屆區域立法委員選舉新竹市,在各村(里),新竹市選舉區,　北區,台溪里,403,376,16,5,266,3,1069,17,1086,0,1086,465,1551,70.02
第10屆區域立法委員選舉新竹市,在各村(里),新竹市選舉區,　北區,曲溪里,1390,1149,62,15,866,3,3485,50,3535,0,3535,1354,4889,72.31
第10屆區域立法委員選舉新竹市,在各村(里),新竹市選舉區,　北區,西雅里,646,857,49,12,570,5,2139,34,2173,0,2173,620,2793,77.80
第10屆區域立法委員選舉新竹市,在各村(里),新竹市選舉區,　北區,客雅里,407,493,25,4,339,4,1272,21,1293,0,1293,394,1687,76.64
第10屆區域立法委員選舉新竹市,在各村(里),新竹市選舉區,　北區,中雅里,1237,559,29,8,605,2,2440,32,2472,0,2472,703,3175,77.86
第10屆區域立法委員選舉新竹市,在各村(里),新竹市選舉區,　北區,南勢里,659,1118,43,16,734,6,2576,42,2618,0,2618,653,3271,80.04
第10屆區域立法委員選舉新竹市,在各村(里),新竹市選舉區,　北區,南勢里、大鵬里,256,259,10,2,171,1,699,12,711,0,711,277,988,71.96
第10屆區域立法委員選舉新竹市,在各村(里),新竹市選舉區,　北區,大同里,209,198,6,4,162,0,579,7,586,0,586,159,745,78.66
第10屆區域立法委員選舉新竹市,在各村(里),新竹市選舉區,　北區,中山里,147,238,10,2,192,0,589,11,600,0,600,175,775,77.42
第10屆區域立法委員選舉新竹市,在各村(里),新竹市選舉區,　北區,中興里,163,203,14,5,168,1,554,8,562,0,562,151,713,78.82
第10屆區域立法委員選舉新竹市,在各村(里),新竹市選舉區,　北區,新民里,369,407,30,5,305,1,1117,23,1140,0,1140,356,1496,76.20
第10屆區域立法委員選舉新竹市,在各村(里),新竹市選舉區,　北區,長和里,324,410,21,6,250,1,1012,15,1027,0,1027,325,1352,75.96
第10屆區域立法委員選舉新竹市,在各村(里),新竹市選舉區,　北區,北門里,217,265,14,2,199,1,698,12,710,0,710,228,938,75.69
第10屆區域立法委員選舉新竹市,在各村(里),新竹市選舉區,　北區,民富里,1089,1302,58,17,881,6,3353,51,3404,0,3404,1270,4674,72.83
第10屆區域立法委員選舉新竹市,在各村(里),新竹市選舉區,　北區,磐石里,1311,1407,59,19,1119,3,3918,47,3965,0,3965,1176,5141,77.13
第10屆區域立法委員選舉新竹市,在各村(里),新竹市選舉區,　北區,新雅里,1018,1198,73,11,885,1,3186,34,3220,0,3220,1079,4299,74.90
第10屆區域立法委員選舉新竹市,在各村(里),新竹市選舉區,　北區,文雅里,1040,1038,44,17,815,8,2962,31,2993,0,2993,837,3830,78.15
第10屆區域立法委員選舉新竹市,在各村(里),新竹市選舉區,　北區,水田里,799,739,29,9,581,5,2162,23,2185,0,2185,670,2855,76.53
第10屆區域立法委員選舉新竹市,在各村(里),新竹市選舉區,　北區,光田里,599,536,30,8,402,2,1577,21,1598,0,1598,462,2060,77.57
第10屆區域立法委員選舉新竹市,在各村(里),新竹市選舉區,　北區,光華里,1047,764,36,7,713,6,2573,43,2616,0,2616,1365,3981,65.71
第10屆區域立法委員選舉新竹市,在各村(里),新竹市選舉區,　北區,金華里,1301,1105,55,19,1046,10,3536,45,3581,0,3581,1052,4633,77.29
第10屆區域立法委員選舉新竹市,在各村(里),新竹市選舉區,　北區,湳雅里,797,606,28,4,561,1,1997,38,2035,0,2035,568,2603,78.18
第10屆區域立法委員選舉新竹市,在各村(里),新竹市選舉區,　北區,金雅里,593,579,27,6,501,2,1708,20,1728,0,1728,387,2115,81.70
第10屆區域立法委員選舉新竹市,在各村(里),新竹市選舉區,　北區,湳中里,1884,1226,89,22,1580,14,4815,60,4875,1,4876,1337,6213,78.46
第10屆區域立法委員選舉新竹市,在各村(里),新竹市選舉區,　北區,舊社里,1564,1299,76,13,1328,13,4293,76,4369,0,4369,1322,5691,76.77
第10屆區域立法委員選舉新竹市,在各村(里),新竹市選舉區,　北區,金竹里,1632,1194,70,21,1294,8,4219,47,4266,0,4266,1294,5560,76.73
第10屆區域立法委員選舉新竹市,在各村(里),新竹市選舉區,　北區,武陵里,2238,472,67,7,655,9,3448,40,3488,0,3488,976,4464,78.14
第10屆區域立法委員選舉新竹市,在各村(里),新竹市選舉區,　北區,福林里,1178,883,46,8,717,4,2836,51,2887,0,2887,812,3699,78.05
第10屆區域立法委員選舉新竹市,在各村(里),新竹市選舉區,　北區,境福里,1288,1163,55,14,923,7,3450,60,3510,0,3510,1013,4523,77.60
第10屆區域立法委員選舉新竹市,在各村(里),新竹市選舉區,　北區,士林里,392,534,21,3,340,1,1291,19,1310,0,1310,355,1665,78.68
第10屆區域立法委員選舉新竹市,在各村(里),新竹市選舉區,　北區,古賢里,176,296,12,4,153,0,641,12,653,0,653,170,823,79.34
第10屆區域立法委員選舉新竹市,在各村(里),新竹市選舉區,　北區,南寮里,1389,1487,54,26,961,6,3923,61,3984,0,3984,1487,5471,72.82
第10屆區域立法委員選舉新竹市,在各村(里),新竹市選舉區,　北區,康樂里,712,783,35,9,558,4,2101,33,2134,0,2134,630,2764,77.21
第10屆區域立法委員選舉新竹市,在各村(里),新竹市選舉區,　北區,中寮里,810,855,41,12,700,6,2424,44,2468,1,2469,834,3303,74.72
第10屆區域立法委員選舉新竹市,在各村(里),新竹市選舉區,　北區,海濱里,930,974,40,8,720,10,2682,36,2718,0,2718,973,3691,73.64
第10屆區域立法委員選舉新竹市,在各村(里),新竹市選舉區,　北區,港北里,371,530,27,5,281,0,1214,23,1237,0,1237,429,1666,74.25
第10屆區域立法委員選舉新竹市,在各村(里),新竹市選舉區,　北區,舊港里,144,156,14,2,85,0,401,7,408,0,408,151,559,72.99
第10屆區域立法委員選舉新竹市,在各村(里),新竹市選舉區,　香山區,頂埔里,1125,1132,79,18,1189,5,3548,31,3579,0,3579,1183,4762,75.16
第10屆區域立法委員選舉新竹市,在各村(里),新竹市選舉區,　香山區,頂福里,1085,1017,57,20,905,6,3090,39,3129,0,3129,926,4055,77.16
第10屆區域立法委員選舉新竹市,在各村(里),新竹市選舉區,　香山區,中埔里,754,811,45,5,552,5,2172,20,2192,0,2192,609,2801,78.26
第10屆區域立法委員選舉新竹市,在各村(里),新竹市選舉區,　香山區,牛埔里,1103,1038,52,5,855,20,3073,45,3118,0,3118,1250,4368,71.38
第10屆區域立法委員選舉新竹市,在各村(里),新竹市選舉區,　香山區,埔前里,695,939,43,10,668,13,2368,28,2396,0,2396,660,3056,78.40
第10屆區域立法委員選舉新竹市,在各村(里),新竹市選舉區,　香山區,樹下里,382,764,31,10,393,2,1582,18,1600,1,1601,458,2059,77.71
第10屆區域立法委員選舉新竹市,在各村(里),新竹市選舉區,　香山區,浸水里,453,758,49,5,465,1,1731,27,1758,0,1758,517,2275,77.27
第10屆區域立法委員選舉新竹市,在各村(里),新竹市選舉區,　香山區,虎林里,528,623,35,3,421,1,1611,17,1628,0,1628,530,2158,75.44
第10屆區域立法委員選舉新竹市,在各村(里),新竹市選舉區,　香山區,虎山里,1198,1539,96,9,857,9,3708,63,3771,3,3774,1321,5095,74.01
第10屆區域立法委員選舉新竹市,在各村(里),新竹市選舉區,　香山區,港南里,533,863,29,7,427,4,1863,35,1898,0,1898,593,2491,76.19
第10屆區域立法委員選舉新竹市,在各村(里),新竹市選舉區,　香山區,東香里,1126,850,62,11,822,9,2880,51,2931,0,2931,823,3754,78.08
第10屆區域立法委員選舉新竹市,在各村(里),新竹市選舉區,　香山區,香村里,987,810,38,9,619,6,2469,45,2514,0,2514,830,3344,75.18
第10屆區域立法委員選舉新竹市,在各村(里),新竹市選舉區,　香山區,香山里,980,1081,57,13,886,10,3027,43,3070,0,3070,977,4047,75.86
第10屆區域立法委員選舉新竹市,在各村(里),新竹市選舉區,　香山區,大庄里,556,827,66,12,525,8,1994,25,2019,0,2019,617,2636,76.59
第10屆區域立法委員選舉新竹市,在各村(里),新竹市選舉區,　香山區,美山里,243,312,9,5,206,0,775,10,785,0,785,302,1087,72.22
第10屆區域立法委員選舉新竹市,在各村(里),新竹市選舉區,　香山區,朝山里,500,629,41,4,334,6,1514,20,1534,0,1534,480,2014,76.17
第10屆區域立法委員選舉新竹市,在各村(里),新竹市選舉區,　香山區,海山里,603,569,44,5,394,9,1624,27,1651,0,1651,542,2193,75.28
第10屆區域立法委員選舉新竹市,在各村(里),新竹市選舉區,　香山區,鹽水里,311,417,19,4,256,3,1010,19,1029,0,1029,324,1353,76.05
第10屆區域立法委員選舉新竹市,在各村(里),新竹市選舉區,　香山區,內湖里,1068,1111,44,11,672,5,2911,53,2964,0,2964,1133,4097,72.35
第10屆區域立法委員選舉新竹市,在各村(里),新竹市選舉區,　香山區,南港里,128,296,12,3,110,2,551,6,557,0,557,191,748,74.47
第10屆區域立法委員選舉新竹市,在各村(里),新竹市選舉區,　香山區,中隘里,475,349,43,3,312,5,1187,28,1215,0,1215,497,1712,70.97
第10屆區域立法委員選舉新竹市,在各村(里),新竹市選舉區,　香山區,南隘里,217,179,14,5,136,0,551,13,564,0,564,174,738,76.42
第10屆區域立法委員選舉新竹市,在各村(里),新竹市選舉區,　香山區,大湖里,206,322,8,3,111,1,651,11,662,0,662,191,853,77.61
第10屆區域立法委員選舉新竹市,在各村(里),新竹市選舉區,　香山區,茄苳里,220,266,9,2,113,2,612,8,620,0,620,243,863,71.84
