Header1,Header2,By,Region,Village,Place,(1) 蔡適應 民主進步黨,(2) 宋瑋莉 中國國民黨,(3) 張耿輝 無,(4) 楊石城 國會政黨聯盟,有效票數A A=1+2+...+N,無效票數B,投票數C C=A+B,已領未投票數 D D=E-C,發出票數E E=C+D,用餘票數F,選舉人數G G=E+F,投票率H H=C÷G
第10屆區域立法委員選舉基隆市,在各投開票所,基隆市選舉區,　中正區,長潭里,1,221,98,13,9,341,9,350,0,350,93,443,79.01
第10屆區域立法委員選舉基隆市,在各投開票所,基隆市選舉區,　中正區,砂子里,2,462,263,42,58,825,15,840,0,840,329,1169,71.86
第10屆區域立法委員選舉基隆市,在各投開票所,基隆市選舉區,　中正區,砂子里,3,290,204,23,39,556,8,564,0,564,248,812,69.46
第10屆區域立法委員選舉基隆市,在各投開票所,基隆市選舉區,　中正區,砂子里,4,410,366,20,53,849,18,867,0,867,429,1296,66.90
第10屆區域立法委員選舉基隆市,在各投開票所,基隆市選舉區,　中正區,砂子里,5,381,366,23,51,821,20,841,0,841,430,1271,66.17
第10屆區域立法委員選舉基隆市,在各投開票所,基隆市選舉區,　中正區,八斗里,6,691,239,31,50,1011,14,1025,0,1025,376,1401,73.16
第10屆區域立法委員選舉基隆市,在各投開票所,基隆市選舉區,　中正區,碧砂里,7,463,236,27,52,778,11,789,0,789,345,1134,69.58
第10屆區域立法委員選舉基隆市,在各投開票所,基隆市選舉區,　中正區,新富里,8,451,338,38,68,895,9,904,0,904,324,1228,73.62
第10屆區域立法委員選舉基隆市,在各投開票所,基隆市選舉區,　中正區,新富里,9,466,403,42,78,989,13,1002,0,1002,366,1368,73.25
第10屆區域立法委員選舉基隆市,在各投開票所,基隆市選舉區,　中正區,新富里,10,169,115,15,15,314,6,320,0,320,183,503,63.62
第10屆區域立法委員選舉基隆市,在各投開票所,基隆市選舉區,　中正區,新富里,11,330,235,33,46,644,8,652,0,652,393,1045,62.39
第10屆區域立法委員選舉基隆市,在各投開票所,基隆市選舉區,　中正區,新豐里,12,441,362,41,62,906,14,920,0,920,404,1324,69.49
第10屆區域立法委員選舉基隆市,在各投開票所,基隆市選舉區,　中正區,新豐里,13,422,384,35,68,909,12,921,0,921,363,1284,71.73
第10屆區域立法委員選舉基隆市,在各投開票所,基隆市選舉區,　中正區,新豐里,14,334,286,21,62,703,12,715,0,715,271,986,72.52
第10屆區域立法委員選舉基隆市,在各投開票所,基隆市選舉區,　中正區,新豐里,15,261,291,30,30,612,8,620,0,620,218,838,73.99
第10屆區域立法委員選舉基隆市,在各投開票所,基隆市選舉區,　中正區,新豐里,16,228,197,10,53,488,8,496,0,496,203,699,70.96
第10屆區域立法委員選舉基隆市,在各投開票所,基隆市選舉區,　中正區,平寮里,17,433,285,37,64,819,8,827,0,827,370,1197,69.09
第10屆區域立法委員選舉基隆市,在各投開票所,基隆市選舉區,　中正區,社寮里,18,330,229,38,68,665,8,673,0,673,276,949,70.92
第10屆區域立法委員選舉基隆市,在各投開票所,基隆市選舉區,　中正區,社寮里,19,301,135,23,27,486,7,493,0,493,179,672,73.36
第10屆區域立法委員選舉基隆市,在各投開票所,基隆市選舉區,　中正區,和憲里,20,199,214,21,38,472,4,476,0,476,221,697,68.29
第10屆區域立法委員選舉基隆市,在各投開票所,基隆市選舉區,　中正區,海濱里,21,237,249,19,26,531,7,538,0,538,204,742,72.51
第10屆區域立法委員選舉基隆市,在各投開票所,基隆市選舉區,　中正區,正濱里,22,312,270,23,40,645,10,655,0,655,257,912,71.82
第10屆區域立法委員選舉基隆市,在各投開票所,基隆市選舉區,　中正區,中正里,23,588,427,49,75,1139,21,1160,0,1160,450,1610,72.05
第10屆區域立法委員選舉基隆市,在各投開票所,基隆市選舉區,　中正區,中濱里,24,387,373,32,57,849,14,863,0,863,295,1158,74.53
第10屆區域立法委員選舉基隆市,在各投開票所,基隆市選舉區,　中正區,建國里,25,296,371,37,53,757,8,765,0,765,289,1054,72.58
第10屆區域立法委員選舉基隆市,在各投開票所,基隆市選舉區,　中正區,建國里,26,210,243,20,32,505,10,515,0,515,189,704,73.15
第10屆區域立法委員選舉基隆市,在各投開票所,基隆市選舉區,　中正區,砂灣里,27,327,337,22,73,759,17,776,0,776,299,1075,72.19
第10屆區域立法委員選舉基隆市,在各投開票所,基隆市選舉區,　中正區,砂灣里,28,195,285,16,44,540,10,550,0,550,250,800,68.75
第10屆區域立法委員選舉基隆市,在各投開票所,基隆市選舉區,　中正區,真砂里,29,461,392,35,63,951,15,966,0,966,302,1268,76.18
第10屆區域立法委員選舉基隆市,在各投開票所,基隆市選舉區,　中正區,正砂里,30,416,365,15,66,862,14,876,0,876,288,1164,75.26
第10屆區域立法委員選舉基隆市,在各投開票所,基隆市選舉區,　中正區,正砂里,31,294,373,20,63,750,14,764,0,764,272,1036,73.75
第10屆區域立法委員選舉基隆市,在各投開票所,基隆市選舉區,　中正區,中砂里,32,444,365,38,47,894,18,912,0,912,583,1495,61.00
第10屆區域立法委員選舉基隆市,在各投開票所,基隆市選舉區,　中正區,入船里,33,258,223,16,47,544,14,558,0,558,199,757,73.71
第10屆區域立法委員選舉基隆市,在各投開票所,基隆市選舉區,　中正區,正船里,34,414,387,17,76,894,18,912,0,912,302,1214,75.12
第10屆區域立法委員選舉基隆市,在各投開票所,基隆市選舉區,　中正區,中船里,35,384,310,28,80,802,17,819,0,819,307,1126,72.74
第10屆區域立法委員選舉基隆市,在各投開票所,基隆市選舉區,　中正區,港通里,36,462,287,38,59,846,24,870,0,870,274,1144,76.05
第10屆區域立法委員選舉基隆市,在各投開票所,基隆市選舉區,　中正區,義重里,37,345,272,28,83,728,17,745,0,745,252,997,74.72
第10屆區域立法委員選舉基隆市,在各投開票所,基隆市選舉區,　中正區,正義里,38,420,323,34,62,839,16,855,0,855,318,1173,72.89
第10屆區域立法委員選舉基隆市,在各投開票所,基隆市選舉區,　中正區,信義里,39,306,235,21,60,622,11,633,0,633,233,866,73.09
第10屆區域立法委員選舉基隆市,在各投開票所,基隆市選舉區,　中正區,德義里,40,262,167,17,36,482,10,492,0,492,177,669,73.54
第10屆區域立法委員選舉基隆市,在各投開票所,基隆市選舉區,　七堵區,長興里,234,368,251,212,46,877,22,899,0,899,285,1184,75.93
第10屆區域立法委員選舉基隆市,在各投開票所,基隆市選舉區,　七堵區,長興里,235,311,299,174,48,832,6,838,0,838,311,1149,72.93
第10屆區域立法委員選舉基隆市,在各投開票所,基隆市選舉區,　七堵區,長興里,236,334,303,176,40,853,14,867,0,867,308,1175,73.79
第10屆區域立法委員選舉基隆市,在各投開票所,基隆市選舉區,　七堵區,正光里,237,364,232,196,31,823,6,829,0,829,244,1073,77.26
第10屆區域立法委員選舉基隆市,在各投開票所,基隆市選舉區,　七堵區,正光里,238,348,325,169,32,874,9,883,0,883,434,1317,67.05
第10屆區域立法委員選舉基隆市,在各投開票所,基隆市選舉區,　七堵區,正明里,239,298,229,159,30,716,4,720,0,720,222,942,76.43
第10屆區域立法委員選舉基隆市,在各投開票所,基隆市選舉區,　七堵區,正明里,240,307,197,147,18,669,14,683,0,683,210,893,76.48
第10屆區域立法委員選舉基隆市,在各投開票所,基隆市選舉區,　七堵區,富民里,241,325,212,228,36,801,6,807,0,807,248,1055,76.49
第10屆區域立法委員選舉基隆市,在各投開票所,基隆市選舉區,　七堵區,富民里,242,319,317,251,32,919,24,943,0,943,266,1209,78.00
第10屆區域立法委員選舉基隆市,在各投開票所,基隆市選舉區,　七堵區,富民里,243,254,321,197,42,814,16,830,0,830,297,1127,73.65
第10屆區域立法委員選舉基隆市,在各投開票所,基隆市選舉區,　七堵區,永平里,244,293,235,141,28,697,6,703,0,703,207,910,77.25
第10屆區域立法委員選舉基隆市,在各投開票所,基隆市選舉區,　七堵區,永平里,245,282,249,127,43,701,5,706,0,706,202,908,77.75
第10屆區域立法委員選舉基隆市,在各投開票所,基隆市選舉區,　七堵區,永安里,246,352,284,194,45,875,18,893,0,893,257,1150,77.65
第10屆區域立法委員選舉基隆市,在各投開票所,基隆市選舉區,　七堵區,永安里,247,306,238,133,22,699,7,706,0,706,254,960,73.54
第10屆區域立法委員選舉基隆市,在各投開票所,基隆市選舉區,　七堵區,八德里,248,83,55,43,13,194,3,197,0,197,77,274,71.90
第10屆區域立法委員選舉基隆市,在各投開票所,基隆市選舉區,　七堵區,八德里,249,349,225,225,33,832,4,836,3,839,328,1167,71.64
第10屆區域立法委員選舉基隆市,在各投開票所,基隆市選舉區,　七堵區,自強里,250,348,242,153,41,784,9,793,0,793,298,1091,72.69
第10屆區域立法委員選舉基隆市,在各投開票所,基隆市選舉區,　七堵區,泰安里,251,348,239,223,42,852,19,871,0,871,308,1179,73.88
第10屆區域立法委員選舉基隆市,在各投開票所,基隆市選舉區,　七堵區,泰安里,252,524,359,222,57,1162,13,1175,0,1175,435,1610,72.98
第10屆區域立法委員選舉基隆市,在各投開票所,基隆市選舉區,　七堵區,泰安里,253,322,243,279,37,881,18,899,0,899,337,1236,72.73
第10屆區域立法委員選舉基隆市,在各投開票所,基隆市選舉區,　七堵區,六堵里,254,273,210,159,28,670,12,682,0,682,254,936,72.86
第10屆區域立法委員選舉基隆市,在各投開票所,基隆市選舉區,　七堵區,六堵里,255,460,289,185,37,971,14,985,0,985,266,1251,78.74
第10屆區域立法委員選舉基隆市,在各投開票所,基隆市選舉區,　七堵區,堵南里,256,331,173,169,19,692,11,703,0,703,271,974,72.18
第10屆區域立法委員選舉基隆市,在各投開票所,基隆市選舉區,　七堵區,堵南里,257,291,173,112,20,596,14,610,0,610,292,902,67.63
第10屆區域立法委員選舉基隆市,在各投開票所,基隆市選舉區,　七堵區,長安里,258,360,198,96,14,668,9,677,0,677,278,955,70.89
第10屆區域立法委員選舉基隆市,在各投開票所,基隆市選舉區,　七堵區,長安里,259,348,244,143,22,757,15,772,0,772,291,1063,72.62
第10屆區域立法委員選舉基隆市,在各投開票所,基隆市選舉區,　七堵區,堵北里,260,616,343,249,36,1244,16,1260,0,1260,425,1685,74.78
第10屆區域立法委員選舉基隆市,在各投開票所,基隆市選舉區,　七堵區,堵北里,261,599,309,273,32,1213,20,1233,0,1233,413,1646,74.91
第10屆區域立法委員選舉基隆市,在各投開票所,基隆市選舉區,　七堵區,百福里,262,495,269,193,28,985,14,999,0,999,385,1384,72.18
第10屆區域立法委員選舉基隆市,在各投開票所,基隆市選舉區,　七堵區,百福里,263,512,270,184,34,1000,25,1025,1,1026,355,1381,74.22
第10屆區域立法委員選舉基隆市,在各投開票所,基隆市選舉區,　七堵區,百福里,264,502,242,198,42,984,9,993,0,993,343,1336,74.33
第10屆區域立法委員選舉基隆市,在各投開票所,基隆市選舉區,　七堵區,百福里,265,519,346,196,34,1095,16,1111,0,1111,354,1465,75.84
第10屆區域立法委員選舉基隆市,在各投開票所,基隆市選舉區,　七堵區,實踐里,266,469,232,183,26,910,10,920,0,920,367,1287,71.48
第10屆區域立法委員選舉基隆市,在各投開票所,基隆市選舉區,　七堵區,實踐里,267,329,178,168,27,702,13,715,0,715,260,975,73.33
第10屆區域立法委員選舉基隆市,在各投開票所,基隆市選舉區,　七堵區,實踐里,268,426,253,202,39,920,18,938,0,938,341,1279,73.34
第10屆區域立法委員選舉基隆市,在各投開票所,基隆市選舉區,　七堵區,瑪南里,269,148,81,58,13,300,5,305,0,305,95,400,76.25
第10屆區域立法委員選舉基隆市,在各投開票所,基隆市選舉區,　七堵區,瑪東里,270,100,50,75,10,235,2,237,0,237,89,326,72.70
第10屆區域立法委員選舉基隆市,在各投開票所,基隆市選舉區,　七堵區,瑪西里,271,108,80,47,15,250,3,253,0,253,81,334,75.75
第10屆區域立法委員選舉基隆市,在各投開票所,基隆市選舉區,　七堵區,友一里,272,269,266,141,15,691,16,707,0,707,212,919,76.93
第10屆區域立法委員選舉基隆市,在各投開票所,基隆市選舉區,　七堵區,友一里,273,249,314,114,6,683,12,695,0,695,226,921,75.46
第10屆區域立法委員選舉基隆市,在各投開票所,基隆市選舉區,　七堵區,友二里,274,164,98,64,2,328,5,333,0,333,101,434,76.73
第10屆區域立法委員選舉基隆市,在各投開票所,基隆市選舉區,　暖暖區,八西里,204,484,352,45,87,968,13,981,0,981,385,1366,71.82
第10屆區域立法委員選舉基隆市,在各投開票所,基隆市選舉區,　暖暖區,八中里,205,159,100,25,14,298,6,304,0,304,126,430,70.70
第10屆區域立法委員選舉基隆市,在各投開票所,基隆市選舉區,　暖暖區,八堵里,206,243,175,18,31,467,9,476,0,476,154,630,75.56
第10屆區域立法委員選舉基隆市,在各投開票所,基隆市選舉區,　暖暖區,八南里,207,255,172,42,35,504,8,512,0,512,205,717,71.41
第10屆區域立法委員選舉基隆市,在各投開票所,基隆市選舉區,　暖暖區,過港里,208,305,359,31,52,747,12,759,0,759,267,1026,73.98
第10屆區域立法委員選舉基隆市,在各投開票所,基隆市選舉區,　暖暖區,過港里,209,378,380,55,57,870,18,888,0,888,303,1191,74.56
第10屆區域立法委員選舉基隆市,在各投開票所,基隆市選舉區,　暖暖區,過港里,210,451,327,56,79,913,18,931,0,931,364,1295,71.89
第10屆區域立法委員選舉基隆市,在各投開票所,基隆市選舉區,　暖暖區,暖暖里,211,536,425,52,65,1078,25,1103,0,1103,314,1417,77.84
第10屆區域立法委員選舉基隆市,在各投開票所,基隆市選舉區,　暖暖區,暖暖里,212,398,286,39,46,769,17,786,0,786,308,1094,71.85
第10屆區域立法委員選舉基隆市,在各投開票所,基隆市選舉區,　暖暖區,暖同里,213,388,305,39,44,776,10,786,0,786,292,1078,72.91
第10屆區域立法委員選舉基隆市,在各投開票所,基隆市選舉區,　暖暖區,暖同里,214,413,388,60,51,912,11,923,0,923,465,1388,66.50
第10屆區域立法委員選舉基隆市,在各投開票所,基隆市選舉區,　暖暖區,暖東里,215,157,92,9,22,280,2,282,3,285,116,401,70.32
第10屆區域立法委員選舉基隆市,在各投開票所,基隆市選舉區,　暖暖區,暖西里,216,517,360,60,65,1002,25,1027,0,1027,327,1354,75.85
第10屆區域立法委員選舉基隆市,在各投開票所,基隆市選舉區,　暖暖區,暖西里,217,404,259,57,32,752,17,769,0,769,222,991,77.60
第10屆區域立法委員選舉基隆市,在各投開票所,基隆市選舉區,　暖暖區,暖西里,218,398,288,32,50,768,12,780,0,780,260,1040,75.00
第10屆區域立法委員選舉基隆市,在各投開票所,基隆市選舉區,　暖暖區,暖西里,219,356,297,40,58,751,10,761,0,761,296,1057,72.00
第10屆區域立法委員選舉基隆市,在各投開票所,基隆市選舉區,　暖暖區,碇內里,220,437,381,41,55,914,13,927,0,927,301,1228,75.49
第10屆區域立法委員選舉基隆市,在各投開票所,基隆市選舉區,　暖暖區,碇內里,221,389,431,58,72,950,15,965,0,965,338,1303,74.06
第10屆區域立法委員選舉基隆市,在各投開票所,基隆市選舉區,　暖暖區,碇和里,222,188,482,13,35,718,10,728,4,732,203,935,77.86
第10屆區域立法委員選舉基隆市,在各投開票所,基隆市選舉區,　暖暖區,碇和里,223,308,285,36,48,677,11,688,0,688,236,924,74.46
第10屆區域立法委員選舉基隆市,在各投開票所,基隆市選舉區,　暖暖區,碇和里,224,321,262,26,51,660,13,673,0,673,226,899,74.86
第10屆區域立法委員選舉基隆市,在各投開票所,基隆市選舉區,　暖暖區,碇祥里,225,401,309,45,53,808,12,820,4,824,297,1121,73.15
第10屆區域立法委員選舉基隆市,在各投開票所,基隆市選舉區,　暖暖區,碇祥里,226,355,284,26,32,697,11,708,0,708,361,1069,66.23
第10屆區域立法委員選舉基隆市,在各投開票所,基隆市選舉區,　暖暖區,碇祥里,227,387,326,45,67,825,13,838,0,838,268,1106,75.77
第10屆區域立法委員選舉基隆市,在各投開票所,基隆市選舉區,　暖暖區,碇祥里,228,409,383,39,48,879,10,889,0,889,328,1217,73.05
第10屆區域立法委員選舉基隆市,在各投開票所,基隆市選舉區,　暖暖區,碇祥里,229,281,250,17,30,578,8,586,0,586,285,871,67.28
第10屆區域立法委員選舉基隆市,在各投開票所,基隆市選舉區,　暖暖區,碇安里,230,464,364,43,63,934,21,955,0,955,298,1253,76.22
第10屆區域立法委員選舉基隆市,在各投開票所,基隆市選舉區,　暖暖區,碇安里,231,400,322,35,55,812,13,825,0,825,305,1130,73.01
第10屆區域立法委員選舉基隆市,在各投開票所,基隆市選舉區,　暖暖區,碇安里,232,347,290,38,26,701,12,713,0,713,235,948,75.21
第10屆區域立法委員選舉基隆市,在各投開票所,基隆市選舉區,　暖暖區,碇安里,233,488,371,44,66,969,7,976,0,976,316,1292,75.54
第10屆區域立法委員選舉基隆市,在各投開票所,基隆市選舉區,　仁愛區,林泉里,79,290,204,16,44,554,10,564,0,564,296,860,65.58
第10屆區域立法委員選舉基隆市,在各投開票所,基隆市選舉區,　仁愛區,林泉里,80,324,210,17,71,622,6,628,0,628,205,833,75.39
第10屆區域立法委員選舉基隆市,在各投開票所,基隆市選舉區,　仁愛區,花崗里,81,399,292,14,63,768,7,775,0,775,240,1015,76.35
第10屆區域立法委員選舉基隆市,在各投開票所,基隆市選舉區,　仁愛區,虹橋里,82,316,262,21,76,675,14,689,0,689,263,952,72.37
第10屆區域立法委員選舉基隆市,在各投開票所,基隆市選舉區,　仁愛區,虹橋里,83,185,163,13,39,400,7,407,0,407,132,539,75.51
第10屆區域立法委員選舉基隆市,在各投開票所,基隆市選舉區,　仁愛區,水錦里,84,555,472,46,101,1174,20,1194,0,1194,470,1664,71.75
第10屆區域立法委員選舉基隆市,在各投開票所,基隆市選舉區,　仁愛區,智仁里,85,450,348,22,69,889,10,899,0,899,306,1205,74.61
第10屆區域立法委員選舉基隆市,在各投開票所,基隆市選舉區,　仁愛區,智仁里,86,359,282,31,80,752,7,759,0,759,295,1054,72.01
第10屆區域立法委員選舉基隆市,在各投開票所,基隆市選舉區,　仁愛區,和明里,87,303,176,16,44,539,12,551,1,552,184,736,74.86
第10屆區域立法委員選舉基隆市,在各投開票所,基隆市選舉區,　仁愛區,和明里,88,330,248,22,53,653,9,662,0,662,212,874,75.74
第10屆區域立法委員選舉基隆市,在各投開票所,基隆市選舉區,　仁愛區,忠勇里,89,343,226,14,73,656,6,662,0,662,230,892,74.22
第10屆區域立法委員選舉基隆市,在各投開票所,基隆市選舉區,　仁愛區,玉田里,90,397,234,20,54,705,7,712,0,712,236,948,75.11
第10屆區域立法委員選舉基隆市,在各投開票所,基隆市選舉區,　仁愛區,仁德里,91,357,225,14,44,640,9,649,0,649,208,857,75.73
第10屆區域立法委員選舉基隆市,在各投開票所,基隆市選舉區,　仁愛區,博愛里,92,405,276,20,74,775,17,792,0,792,217,1009,78.49
第10屆區域立法委員選舉基隆市,在各投開票所,基隆市選舉區,　仁愛區,博愛里,93,154,114,9,29,306,6,312,0,312,106,418,74.64
第10屆區域立法委員選舉基隆市,在各投開票所,基隆市選舉區,　仁愛區,福仁里,94,303,165,20,59,547,12,559,0,559,178,737,75.85
第10屆區域立法委員選舉基隆市,在各投開票所,基隆市選舉區,　仁愛區,誠仁里,95,356,221,27,75,679,9,688,0,688,229,917,75.03
第10屆區域立法委員選舉基隆市,在各投開票所,基隆市選舉區,　仁愛區,吉仁里,96,460,304,43,116,923,15,938,0,938,348,1286,72.94
第10屆區域立法委員選舉基隆市,在各投開票所,基隆市選舉區,　仁愛區,吉仁里,97,416,300,19,101,836,15,851,0,851,410,1261,67.49
第10屆區域立法委員選舉基隆市,在各投開票所,基隆市選舉區,　仁愛區,育仁里,98,290,140,26,56,512,6,518,0,518,212,730,70.96
第10屆區域立法委員選舉基隆市,在各投開票所,基隆市選舉區,　仁愛區,英仁里,99,244,144,10,58,456,3,459,0,459,160,619,74.15
第10屆區域立法委員選舉基隆市,在各投開票所,基隆市選舉區,　仁愛區,英仁里,100,213,157,20,48,438,4,442,0,442,192,634,69.72
第10屆區域立法委員選舉基隆市,在各投開票所,基隆市選舉區,　仁愛區,龍門里,101,321,157,16,61,555,8,563,0,563,191,754,74.67
第10屆區域立法委員選舉基隆市,在各投開票所,基隆市選舉區,　仁愛區,德厚里,102,535,472,45,169,1221,21,1242,0,1242,419,1661,74.77
第10屆區域立法委員選舉基隆市,在各投開票所,基隆市選舉區,　仁愛區,曲水里,103,311,182,19,51,563,10,573,0,573,225,798,71.80
第10屆區域立法委員選舉基隆市,在各投開票所,基隆市選舉區,　仁愛區,崇文里,104,308,235,13,73,629,10,639,0,639,191,830,76.99
第10屆區域立法委員選舉基隆市,在各投開票所,基隆市選舉區,　仁愛區,文安里,105,301,203,11,71,586,8,594,0,594,230,824,72.09
第10屆區域立法委員選舉基隆市,在各投開票所,基隆市選舉區,　仁愛區,兆連里,106,215,239,8,46,508,5,513,0,513,159,672,76.34
第10屆區域立法委員選舉基隆市,在各投開票所,基隆市選舉區,　仁愛區,獅球里,107,315,262,23,76,676,13,689,0,689,264,953,72.30
第10屆區域立法委員選舉基隆市,在各投開票所,基隆市選舉區,　仁愛區,書院里,108,350,252,26,80,708,21,729,0,729,284,1013,71.96
第10屆區域立法委員選舉基隆市,在各投開票所,基隆市選舉區,　仁愛區,朝棟里,109,369,348,28,80,825,21,846,0,846,359,1205,70.21
第10屆區域立法委員選舉基隆市,在各投開票所,基隆市選舉區,　仁愛區,朝棟里,110,386,554,33,127,1100,16,1116,0,1116,312,1428,78.15
第10屆區域立法委員選舉基隆市,在各投開票所,基隆市選舉區,　仁愛區,光華里,111,414,281,30,73,798,12,810,0,810,495,1305,62.07
第10屆區域立法委員選舉基隆市,在各投開票所,基隆市選舉區,　仁愛區,光華里,112,407,326,30,84,847,16,863,0,863,240,1103,78.24
第10屆區域立法委員選舉基隆市,在各投開票所,基隆市選舉區,　仁愛區,明德里,113,238,185,20,55,498,6,504,0,504,180,684,73.68
第10屆區域立法委員選舉基隆市,在各投開票所,基隆市選舉區,　仁愛區,同風里,114,238,130,14,37,419,11,430,0,430,127,557,77.20
第10屆區域立法委員選舉基隆市,在各投開票所,基隆市選舉區,　仁愛區,文昌里,115,341,160,15,34,550,11,561,0,561,176,737,76.12
第10屆區域立法委員選舉基隆市,在各投開票所,基隆市選舉區,　仁愛區,新店里,116,215,172,13,27,427,7,434,0,434,148,582,74.57
第10屆區域立法委員選舉基隆市,在各投開票所,基隆市選舉區,　中山區,新建里,117,249,214,14,83,560,10,570,0,570,215,785,72.61
第10屆區域立法委員選舉基隆市,在各投開票所,基隆市選舉區,　中山區,安民里,118,340,326,21,102,789,7,796,0,796,213,1009,78.89
第10屆區域立法委員選舉基隆市,在各投開票所,基隆市選舉區,　中山區,安平里,119,217,188,13,135,553,5,558,0,558,180,738,75.61
第10屆區域立法委員選舉基隆市,在各投開票所,基隆市選舉區,　中山區,中山里,120,308,223,15,133,679,16,695,0,695,242,937,74.17
第10屆區域立法委員選舉基隆市,在各投開票所,基隆市選舉區,　中山區,民治里,121,225,252,11,95,583,9,592,0,592,174,766,77.28
第10屆區域立法委員選舉基隆市,在各投開票所,基隆市選舉區,　中山區,中興里,122,313,404,18,183,918,10,928,0,928,294,1222,75.94
第10屆區域立法委員選舉基隆市,在各投開票所,基隆市選舉區,　中山區,仁正里,123,170,219,19,134,542,6,548,0,548,201,749,73.16
第10屆區域立法委員選舉基隆市,在各投開票所,基隆市選舉區,　中山區,健民里,124,302,280,18,202,802,8,810,0,810,314,1124,72.06
第10屆區域立法委員選舉基隆市,在各投開票所,基隆市選舉區,　中山區,通化里,125,231,318,22,114,685,10,695,0,695,261,956,72.70
第10屆區域立法委員選舉基隆市,在各投開票所,基隆市選舉區,　中山區,居仁里,126,286,343,24,204,857,23,880,0,880,386,1266,69.51
第10屆區域立法委員選舉基隆市,在各投開票所,基隆市選舉區,　中山區,通明里,127,219,195,17,135,566,8,574,0,574,217,791,72.57
第10屆區域立法委員選舉基隆市,在各投開票所,基隆市選舉區,　中山區,通明里,128,304,227,15,111,657,8,665,0,665,228,893,74.47
第10屆區域立法委員選舉基隆市,在各投開票所,基隆市選舉區,　中山區,和平里,129,120,161,1,39,321,6,327,0,327,111,438,74.66
第10屆區域立法委員選舉基隆市,在各投開票所,基隆市選舉區,　中山區,仙洞里,130,150,147,13,80,390,5,395,0,395,155,550,71.82
第10屆區域立法委員選舉基隆市,在各投開票所,基隆市選舉區,　中山區,太白里,131,218,261,12,86,577,14,591,0,591,248,839,70.44
第10屆區域立法委員選舉基隆市,在各投開票所,基隆市選舉區,　中山區,協和里,132,411,385,31,194,1021,15,1036,0,1036,463,1499,69.11
第10屆區域立法委員選舉基隆市,在各投開票所,基隆市選舉區,　中山區,文化里,133,309,237,11,137,694,11,705,0,705,529,1234,57.13
第10屆區域立法委員選舉基隆市,在各投開票所,基隆市選舉區,　中山區,德安里,134,561,510,33,213,1317,20,1337,2,1339,507,1846,72.43
第10屆區域立法委員選舉基隆市,在各投開票所,基隆市選舉區,　中山區,德安里,135,544,453,37,287,1321,18,1339,0,1339,484,1823,73.45
第10屆區域立法委員選舉基隆市,在各投開票所,基隆市選舉區,　中山區,德和里,136,374,356,10,91,831,11,842,0,842,167,1009,83.45
第10屆區域立法委員選舉基隆市,在各投開票所,基隆市選舉區,　中山區,德和里,137,435,389,27,186,1037,13,1050,0,1050,355,1405,74.73
第10屆區域立法委員選舉基隆市,在各投開票所,基隆市選舉區,　中山區,德和里,138,446,526,30,145,1147,17,1164,0,1164,289,1453,80.11
第10屆區域立法委員選舉基隆市,在各投開票所,基隆市選舉區,　中山區,德和里,139,353,431,21,148,953,14,967,0,967,326,1293,74.79
第10屆區域立法委員選舉基隆市,在各投開票所,基隆市選舉區,　中山區,中和里,140,360,370,14,151,895,11,906,0,906,317,1223,74.08
第10屆區域立法委員選舉基隆市,在各投開票所,基隆市選舉區,　中山區,中和里,141,251,253,23,85,612,4,616,0,616,205,821,75.03
第10屆區域立法委員選舉基隆市,在各投開票所,基隆市選舉區,　中山區,中和里,142,317,397,28,149,891,13,904,0,904,355,1259,71.80
第10屆區域立法委員選舉基隆市,在各投開票所,基隆市選舉區,　中山區,中和里,143,332,347,21,144,844,7,851,0,851,383,1234,68.96
第10屆區域立法委員選舉基隆市,在各投開票所,基隆市選舉區,　中山區,中和里,144,214,220,5,108,547,7,554,0,554,174,728,76.10
第10屆區域立法委員選舉基隆市,在各投開票所,基隆市選舉區,　中山區,和慶里,145,422,372,32,211,1037,15,1052,0,1052,451,1503,69.99
第10屆區域立法委員選舉基隆市,在各投開票所,基隆市選舉區,　中山區,和慶里,146,411,396,27,215,1049,20,1069,0,1069,421,1490,71.74
第10屆區域立法委員選舉基隆市,在各投開票所,基隆市選舉區,　中山區,和慶里,147,459,440,36,186,1121,15,1136,0,1136,452,1588,71.54
第10屆區域立法委員選舉基隆市,在各投開票所,基隆市選舉區,　中山區,和慶里,148,463,430,26,177,1096,15,1111,0,1111,451,1562,71.13
第10屆區域立法委員選舉基隆市,在各投開票所,基隆市選舉區,　中山區,西康里,149,489,377,32,188,1086,12,1098,0,1098,467,1565,70.16
第10屆區域立法委員選舉基隆市,在各投開票所,基隆市選舉區,　中山區,西定里,150,288,220,16,101,625,7,632,0,632,262,894,70.69
第10屆區域立法委員選舉基隆市,在各投開票所,基隆市選舉區,　中山區,西華里,151,284,234,10,88,616,5,621,0,621,201,822,75.55
第10屆區域立法委員選舉基隆市,在各投開票所,基隆市選舉區,　中山區,西榮里,152,239,158,9,77,483,7,490,0,490,186,676,72.49
第10屆區域立法委員選舉基隆市,在各投開票所,基隆市選舉區,　安樂區,新西里,153,436,313,31,132,912,18,930,0,930,384,1314,70.78
第10屆區域立法委員選舉基隆市,在各投開票所,基隆市選舉區,　安樂區,西川里,154,338,314,22,126,800,10,810,0,810,355,1165,69.53
第10屆區域立法委員選舉基隆市,在各投開票所,基隆市選舉區,　安樂區,定國里,155,337,268,17,82,704,11,715,0,715,277,992,72.08
第10屆區域立法委員選舉基隆市,在各投開票所,基隆市選舉區,　安樂區,定邦里,156,367,284,23,70,744,10,754,0,754,219,973,77.49
第10屆區域立法委員選舉基隆市,在各投開票所,基隆市選舉區,　安樂區,慈仁里,157,366,195,17,67,645,8,653,0,653,223,876,74.54
第10屆區域立法委員選舉基隆市,在各投開票所,基隆市選舉區,　安樂區,干城里,158,431,387,32,106,956,7,963,0,963,387,1350,71.33
第10屆區域立法委員選舉基隆市,在各投開票所,基隆市選舉區,　安樂區,干城里,159,202,134,19,43,398,4,402,0,402,217,619,64.94
第10屆區域立法委員選舉基隆市,在各投開票所,基隆市選舉區,　安樂區,永康里,160,529,333,31,120,1013,10,1023,0,1023,412,1435,71.29
第10屆區域立法委員選舉基隆市,在各投開票所,基隆市選舉區,　安樂區,永康里,161,170,100,9,33,312,7,319,0,319,132,451,70.73
第10屆區域立法委員選舉基隆市,在各投開票所,基隆市選舉區,　安樂區,安和里,162,334,207,25,65,631,5,636,0,636,184,820,77.56
第10屆區域立法委員選舉基隆市,在各投開票所,基隆市選舉區,　安樂區,樂一里,163,204,128,20,54,406,4,410,0,410,143,553,74.14
第10屆區域立法委員選舉基隆市,在各投開票所,基隆市選舉區,　安樂區,嘉仁里,164,731,380,32,137,1280,23,1303,0,1303,505,1808,72.07
第10屆區域立法委員選舉基隆市,在各投開票所,基隆市選舉區,　安樂區,嘉仁里,165,494,320,32,129,975,12,987,0,987,319,1306,75.57
第10屆區域立法委員選舉基隆市,在各投開票所,基隆市選舉區,　安樂區,三民里,166,397,374,34,41,846,18,864,0,864,287,1151,75.07
第10屆區域立法委員選舉基隆市,在各投開票所,基隆市選舉區,　安樂區,三民里,167,462,356,30,74,922,6,928,0,928,361,1289,71.99
第10屆區域立法委員選舉基隆市,在各投開票所,基隆市選舉區,　安樂區,壯觀里,168,615,423,46,77,1161,17,1178,0,1178,335,1513,77.86
第10屆區域立法委員選舉基隆市,在各投開票所,基隆市選舉區,　安樂區,壯觀里,169,700,459,54,60,1273,11,1284,0,1284,395,1679,76.47
第10屆區域立法委員選舉基隆市,在各投開票所,基隆市選舉區,　安樂區,壯觀里,170,252,255,14,25,546,7,553,0,553,166,719,76.91
第10屆區域立法委員選舉基隆市,在各投開票所,基隆市選舉區,　安樂區,四維里,171,582,469,42,100,1193,28,1221,0,1221,335,1556,78.47
第10屆區域立法委員選舉基隆市,在各投開票所,基隆市選舉區,　安樂區,四維里,172,606,489,38,107,1240,16,1256,0,1256,370,1626,77.24
第10屆區域立法委員選舉基隆市,在各投開票所,基隆市選舉區,　安樂區,四維里,173,522,400,41,87,1050,16,1066,0,1066,312,1378,77.36
第10屆區域立法委員選舉基隆市,在各投開票所,基隆市選舉區,　安樂區,五福里,174,645,466,56,77,1244,19,1263,0,1263,442,1705,74.08
第10屆區域立法委員選舉基隆市,在各投開票所,基隆市選舉區,　安樂區,五福里,175,582,503,48,96,1229,20,1249,0,1249,369,1618,77.19
第10屆區域立法委員選舉基隆市,在各投開票所,基隆市選舉區,　安樂區,六合里,176,567,477,42,86,1172,17,1189,0,1189,381,1570,75.73
第10屆區域立法委員選舉基隆市,在各投開票所,基隆市選舉區,　安樂區,六合里,177,409,365,24,72,870,15,885,0,885,229,1114,79.44
第10屆區域立法委員選舉基隆市,在各投開票所,基隆市選舉區,　安樂區,六合里,178,428,356,31,65,880,14,894,0,894,232,1126,79.40
第10屆區域立法委員選舉基隆市,在各投開票所,基隆市選舉區,　安樂區,七賢里,179,469,355,29,61,914,19,933,0,933,312,1245,74.94
第10屆區域立法委員選舉基隆市,在各投開票所,基隆市選舉區,　安樂區,七賢里,180,440,321,21,83,865,10,875,0,875,286,1161,75.37
第10屆區域立法委員選舉基隆市,在各投開票所,基隆市選舉區,　安樂區,長樂里,181,599,603,48,74,1324,20,1344,0,1344,337,1681,79.95
第10屆區域立法委員選舉基隆市,在各投開票所,基隆市選舉區,　安樂區,長樂里,182,247,235,11,29,522,13,535,0,535,131,666,80.33
第10屆區域立法委員選舉基隆市,在各投開票所,基隆市選舉區,　安樂區,長樂里,183,347,231,31,35,644,11,655,0,655,175,830,78.92
第10屆區域立法委員選舉基隆市,在各投開票所,基隆市選舉區,　安樂區,鶯歌里,184,438,354,34,40,866,14,880,0,880,617,1497,58.78
第10屆區域立法委員選舉基隆市,在各投開票所,基隆市選舉區,　安樂區,鶯歌里,185,507,392,22,61,982,19,1001,0,1001,361,1362,73.49
第10屆區域立法委員選舉基隆市,在各投開票所,基隆市選舉區,　安樂區,鶯安里,186,561,480,30,85,1156,21,1177,0,1177,320,1497,78.62
第10屆區域立法委員選舉基隆市,在各投開票所,基隆市選舉區,　安樂區,鶯安里,187,501,395,35,71,1002,16,1018,0,1018,325,1343,75.80
第10屆區域立法委員選舉基隆市,在各投開票所,基隆市選舉區,　安樂區,鶯安里,188,530,610,51,64,1255,16,1271,0,1271,415,1686,75.39
第10屆區域立法委員選舉基隆市,在各投開票所,基隆市選舉區,　安樂區,興寮里,189,533,432,39,128,1132,20,1152,0,1152,438,1590,72.45
第10屆區域立法委員選舉基隆市,在各投開票所,基隆市選舉區,　安樂區,興寮里,190,402,286,19,58,765,9,774,0,774,260,1034,74.85
第10屆區域立法委員選舉基隆市,在各投開票所,基隆市選舉區,　安樂區,興寮里,191,725,441,28,106,1300,20,1320,0,1320,520,1840,71.74
第10屆區域立法委員選舉基隆市,在各投開票所,基隆市選舉區,　安樂區,外寮里,192,678,489,50,96,1313,17,1330,0,1330,478,1808,73.56
第10屆區域立法委員選舉基隆市,在各投開票所,基隆市選舉區,　安樂區,外寮里,193,685,445,32,102,1264,19,1283,0,1283,526,1809,70.92
第10屆區域立法委員選舉基隆市,在各投開票所,基隆市選舉區,　安樂區,新崙里,194,817,520,49,111,1497,22,1519,0,1519,541,2060,73.74
第10屆區域立法委員選舉基隆市,在各投開票所,基隆市選舉區,　安樂區,新崙里,195,637,424,53,87,1201,24,1225,0,1225,481,1706,71.81
第10屆區域立法委員選舉基隆市,在各投開票所,基隆市選舉區,　安樂區,武崙里,196,555,350,33,73,1011,25,1036,0,1036,396,1432,72.35
第10屆區域立法委員選舉基隆市,在各投開票所,基隆市選舉區,　安樂區,武崙里,197,812,551,46,96,1505,20,1525,0,1525,447,1972,77.33
第10屆區域立法委員選舉基隆市,在各投開票所,基隆市選舉區,　安樂區,武崙里,198,446,345,23,55,869,6,875,0,875,238,1113,78.62
第10屆區域立法委員選舉基隆市,在各投開票所,基隆市選舉區,　安樂區,中崙里,199,650,416,39,75,1180,19,1199,0,1199,407,1606,74.66
第10屆區域立法委員選舉基隆市,在各投開票所,基隆市選舉區,　安樂區,內寮里,200,429,295,43,64,831,19,850,0,850,333,1183,71.85
第10屆區域立法委員選舉基隆市,在各投開票所,基隆市選舉區,　安樂區,內寮里,201,413,407,36,64,920,12,932,0,932,363,1295,71.97
第10屆區域立法委員選舉基隆市,在各投開票所,基隆市選舉區,　安樂區,內寮里,202,524,334,27,63,948,17,965,0,965,362,1327,72.72
第10屆區域立法委員選舉基隆市,在各投開票所,基隆市選舉區,　安樂區,內寮里,203,489,302,19,60,870,10,880,0,880,317,1197,73.52
第10屆區域立法委員選舉基隆市,在各投開票所,基隆市選舉區,　信義區,仁壽里,41,385,318,37,40,780,11,791,0,791,236,1027,77.02
第10屆區域立法委員選舉基隆市,在各投開票所,基隆市選舉區,　信義區,仁義里,42,393,444,28,72,937,12,949,0,949,231,1180,80.42
第10屆區域立法委員選舉基隆市,在各投開票所,基隆市選舉區,　信義區,義昭里,43,396,376,34,46,852,13,865,8,873,276,1149,75.28
第10屆區域立法委員選舉基隆市,在各投開票所,基隆市選舉區,　信義區,義幸里,44,382,396,21,56,855,15,870,0,870,239,1109,78.45
第10屆區域立法委員選舉基隆市,在各投開票所,基隆市選舉區,　信義區,義幸里,45,387,394,30,48,859,11,870,0,870,276,1146,75.92
第10屆區域立法委員選舉基隆市,在各投開票所,基隆市選舉區,　信義區,義民里,46,264,220,12,40,536,6,542,0,542,157,699,77.54
第10屆區域立法委員選舉基隆市,在各投開票所,基隆市選舉區,　信義區,義和里,47,391,394,28,66,879,14,893,0,893,555,1448,61.67
第10屆區域立法委員選舉基隆市,在各投開票所,基隆市選舉區,　信義區,智慧里,48,252,205,17,51,525,18,543,0,543,158,701,77.46
第10屆區域立法委員選舉基隆市,在各投開票所,基隆市選舉區,　信義區,智誠里,49,549,377,33,91,1050,14,1064,0,1064,414,1478,71.99
第10屆區域立法委員選舉基隆市,在各投開票所,基隆市選舉區,　信義區,禮儀里,50,538,504,35,100,1177,13,1190,0,1190,364,1554,76.58
第10屆區域立法委員選舉基隆市,在各投開票所,基隆市選舉區,　信義區,禮東里,51,486,494,39,79,1098,20,1118,0,1118,340,1458,76.68
第10屆區域立法委員選舉基隆市,在各投開票所,基隆市選舉區,　信義區,信綠里,52,340,333,12,45,730,9,739,0,739,249,988,74.80
第10屆區域立法委員選舉基隆市,在各投開票所,基隆市選舉區,　信義區,信綠里,53,360,295,33,54,742,11,753,0,753,249,1002,75.15
第10屆區域立法委員選舉基隆市,在各投開票所,基隆市選舉區,　信義區,東信里,54,232,229,6,49,516,7,523,0,523,167,690,75.80
第10屆區域立法委員選舉基隆市,在各投開票所,基隆市選舉區,　信義區,東信里,55,264,349,16,41,670,15,685,0,685,237,922,74.30
第10屆區域立法委員選舉基隆市,在各投開票所,基隆市選舉區,　信義區,東信里,56,376,391,39,57,863,7,870,0,870,228,1098,79.23
第10屆區域立法委員選舉基隆市,在各投開票所,基隆市選舉區,　信義區,東信里,57,452,406,23,89,970,22,992,0,992,290,1282,77.38
第10屆區域立法委員選舉基隆市,在各投開票所,基隆市選舉區,　信義區,東光里,58,299,341,24,39,703,11,714,0,714,250,964,74.07
第10屆區域立法委員選舉基隆市,在各投開票所,基隆市選舉區,　信義區,東光里,59,274,215,36,42,567,3,570,0,570,164,734,77.66
第10屆區域立法委員選舉基隆市,在各投開票所,基隆市選舉區,　信義區,東明里,60,425,439,21,74,959,11,970,0,970,316,1286,75.43
第10屆區域立法委員選舉基隆市,在各投開票所,基隆市選舉區,　信義區,東明里,61,425,452,38,66,981,12,993,0,993,349,1342,73.99
第10屆區域立法委員選舉基隆市,在各投開票所,基隆市選舉區,　信義區,東明里,62,258,268,21,37,584,5,589,0,589,172,761,77.40
第10屆區域立法委員選舉基隆市,在各投開票所,基隆市選舉區,　信義區,東安里,63,492,444,36,71,1043,11,1054,0,1054,360,1414,74.54
第10屆區域立法委員選舉基隆市,在各投開票所,基隆市選舉區,　信義區,東安里,64,419,424,29,72,944,17,961,0,961,322,1283,74.90
第10屆區域立法委員選舉基隆市,在各投開票所,基隆市選舉區,　信義區,孝賢里,65,309,294,16,42,661,14,675,0,675,205,880,76.70
第10屆區域立法委員選舉基隆市,在各投開票所,基隆市選舉區,　信義區,孝賢里,66,360,302,37,63,762,16,778,0,778,227,1005,77.41
第10屆區域立法委員選舉基隆市,在各投開票所,基隆市選舉區,　信義區,孝賢里,67,491,497,42,70,1100,15,1115,0,1115,306,1421,78.47
第10屆區域立法委員選舉基隆市,在各投開票所,基隆市選舉區,　信義區,孝忠里,68,478,459,20,49,1006,13,1019,0,1019,281,1300,78.38
第10屆區域立法委員選舉基隆市,在各投開票所,基隆市選舉區,　信義區,孝忠里,69,534,435,34,88,1091,15,1106,0,1106,232,1338,82.66
第10屆區域立法委員選舉基隆市,在各投開票所,基隆市選舉區,　信義區,孝忠里,70,449,314,24,66,853,10,863,0,863,367,1230,70.16
第10屆區域立法委員選舉基隆市,在各投開票所,基隆市選舉區,　信義區,孝忠里,71,468,402,30,85,985,13,998,1,999,366,1365,73.11
第10屆區域立法委員選舉基隆市,在各投開票所,基隆市選舉區,　信義區,孝忠里,72,540,439,41,87,1107,11,1118,0,1118,413,1531,73.02
第10屆區域立法委員選舉基隆市,在各投開票所,基隆市選舉區,　信義區,孝德里,73,457,366,34,105,962,15,977,0,977,435,1412,69.19
第10屆區域立法委員選舉基隆市,在各投開票所,基隆市選舉區,　信義區,孝德里,74,345,296,16,55,712,5,717,0,717,260,977,73.39
第10屆區域立法委員選舉基隆市,在各投開票所,基隆市選舉區,　信義區,孝深里,75,284,201,15,40,540,4,544,0,544,130,674,80.71
第10屆區域立法委員選舉基隆市,在各投開票所,基隆市選舉區,　信義區,孝深里,76,516,381,52,95,1044,11,1055,0,1055,502,1557,67.76
第10屆區域立法委員選舉基隆市,在各投開票所,基隆市選舉區,　信義區,孝深里,77,523,436,44,108,1111,19,1130,0,1130,544,1674,67.50
第10屆區域立法委員選舉基隆市,在各投開票所,基隆市選舉區,　信義區,孝岡里,78,501,333,35,67,936,13,949,0,949,314,1263,75.14
